Timestamp,Object Color,Center X,Center Y,Bounding Box Width,Bounding Box Height,Target X,Target Y,Actual X,Actual Y,Error X,Error Y,Success,Elapsed Time
2025-01-07 18:49:44,segienamKuning,833,564,121,99,132,6,128,2,4,4,True,0.490999223240448
2025-01-07 18:49:44,segienamKuning,709,654,121,102,38,7,36,3,2,4,False,0.21163980961016288
2025-01-07 18:49:45,Kuning,833,564,tensor(121.3934),tensor(99.4872),43,77,45,75,2,2,True,0.0010042190551757812
2025-01-07 18:49:45,segienamKuning,810,590,115,105,144,68,144,68,0,0,True,0.31450521319391855
2025-01-07 18:49:45,persegiKuning,810,591,116,106,195,57,193,60,2,3,True,0.43063442749170766
2025-01-07 18:49:45,Fail to pick,810,591,0,0,0,0,0,0,0,0,False,0
2025-01-07 18:49:46,segienamKuning,824,563,124,103,80,77,78,76,2,1,True,0.12854483511266107
2025-01-07 18:49:46,Kuning,824,563,tensor(124.8848),tensor(103.1507),43,76,47,79,4,3,True,0.0004978179931640625
2025-01-07 18:49:46,segienamKuning,830,561,116,103,40,28,36,31,4,3,True,0.3483442236218531
2025-01-07 18:49:46,Fail to pick,830,561,0,0,0,0,0,0,0,0,False,0
2025-01-07 18:49:46,segienamKuning,832,563,114,105,60,87,63,90,3,3,True,0.31537752638306094
2025-01-07 18:49:46,Fail to pick,832,563,0,0,0,0,0,0,0,0,False,0
2025-01-07 18:49:47,segienamKuning,826,565,115,103,42,39,39,35,3,4,True,0.359856636835857
2025-01-07 18:49:47,Fail to pick,826,565,0,0,0,0,0,0,0,0,False,0
2025-01-07 18:49:47,segienamKuning,822,564,118,99,116,49,119,45,3,4,False,0.19712429351535016
2025-01-07 18:49:47,Fail to pick,822,564,0,0,0,0,0,0,0,0,False,0
2025-01-07 18:49:47,segienamKuning,826,566,113,104,81,91,77,95,4,4,True,0.4536342215940399
2025-01-07 18:49:47,segienamKuning,837,658,133,94,71,22,69,20,2,2,True,0.45644066241389414
2025-01-07 18:49:47,Fail to pick,826,566,0,0,0,0,0,0,0,0,False,0
2025-01-07 18:49:47,segienamKuning,824,565,114,101,98,59,96,54,2,5,True,0.43774093464205877
2025-01-07 18:49:47,Fail to pick,824,565,0,0,0,0,0,0,0,0,False,0
2025-01-07 18:49:49,segienamKuning,831,560,121,104,12,64,12,65,0,1,True,0.49711088470498654
2025-01-07 18:49:49,Fail to pick,831,560,0,0,0,0,0,0,0,0,False,0
2025-01-07 18:49:49,segienamKuning,827,565,115,103,43,17,38,21,5,4,True,0.43884235672576566
2025-01-07 18:49:49,Fail to pick,827,565,0,0,0,0,0,0,0,0,False,0
2025-01-07 18:49:49,segienamKuning,827,565,115,103,40,7,35,4,5,3,True,0.3887395471105761
2025-01-07 18:49:49,Fail to pick,827,565,0,0,0,0,0,0,0,0,False,0
2025-01-07 18:49:50,segienamKuning,770,373,128,104,62,64,60,66,2,2,True,0.43820521713709637
2025-01-07 18:49:50,Kuning,770,373,tensor(128.6204),tensor(104.1962),96,71,99,75,3,4,True,0.0
2025-01-07 18:49:51,segienamKuning,766,368,115,101,22,63,20,58,2,5,True,0.19454275561677623
2025-01-07 18:49:51,Fail to pick,766,368,0,0,0,0,0,0,0,0,False,0
2025-01-07 18:49:51,segienamKuning,775,363,117,115,157,22,159,17,2,5,True,0.3897158751325128
2025-01-07 18:49:51,Fail to pick,775,363,0,0,0,0,0,0,0,0,False,0
2025-01-07 18:49:52,segienamKuning,778,370,117,106,49,60,50,62,1,2,True,0.22046011803591506
2025-01-07 18:49:52,Fail to pick,778,370,0,0,0,0,0,0,0,0,False,0
2025-01-07 18:49:52,segienamKuning,774,372,125,103,191,15,187,11,4,4,True,0.2359030603329032
2025-01-07 18:49:52,Fail to pick,774,372,0,0,0,0,0,0,0,0,False,0
2025-01-07 18:49:52,segienamKuning,774,372,125,103,102,62,99,59,3,3,True,0.4316013554017858
2025-01-07 18:49:52,Fail to pick,774,372,0,0,0,0,0,0,0,0,False,0
2025-01-07 18:49:52,segienamKuning,778,367,116,104,80,18,84,13,4,5,True,0.17168357938196604
2025-01-07 18:49:52,Fail to pick,778,367,0,0,0,0,0,0,0,0,False,0
2025-01-07 18:49:53,segienamKuning,781,362,119,106,91,89,87,91,4,2,True,0.35664657124219123
2025-01-07 18:49:53,Fail to pick,781,362,0,0,0,0,0,0,0,0,False,0
2025-01-07 18:49:53,segienamKuning,776,368,113,104,41,6,41,9,0,3,True,0.22596133463248735
2025-01-07 18:49:53,Fail to pick,776,368,0,0,0,0,0,0,0,0,False,0
2025-01-07 18:49:53,segienamKuning,771,368,122,101,96,31,97,29,1,2,True,0.31898133728488826
2025-01-07 18:49:53,Fail to pick,771,368,0,0,0,0,0,0,0,0,False,0
2025-01-07 18:49:56,persegiKuning,765,363,117,145,159,98,160,99,1,1,True,0.3771021743410953
2025-01-07 18:49:56,Fail to pick,765,363,0,0,0,0,0,0,0,0,False,0
2025-01-07 18:49:56,segienamKuning,782,362,116,107,29,59,28,56,1,3,True,0.16254577529736217
2025-01-07 18:49:56,segienamKuning,782,362,116,107,82,24,81,19,1,5,True,0.48280088481125316
2025-01-07 18:49:56,Fail to pick,782,362,0,0,0,0,0,0,0,0,False,0
2025-01-07 18:49:57,segienamKuning,773,358,111,116,182,72,183,67,1,5,True,0.18967806353032227
2025-01-07 18:49:57,Fail to pick,773,358,0,0,0,0,0,0,0,0,False,0
2025-01-07 18:49:57,segienamKuning,776,369,113,106,175,34,175,31,0,3,True,0.23353299071004316
2025-01-07 18:49:57,segienamKuning,774,370,117,103,15,63,16,59,1,4,False,0.4525663363942175
2025-01-07 18:49:57,Fail to pick,774,370,0,0,0,0,0,0,0,0,False,0
2025-01-07 18:49:57,segienamKuning,761,368,116,100,105,21,107,21,2,0,True,0.2747240241448816
2025-01-07 18:49:57,segienamKuning,760,374,114,99,169,33,171,28,2,5,True,0.21254365653600937
2025-01-07 18:49:57,Fail to pick,760,374,0,0,0,0,0,0,0,0,False,0
2025-01-07 18:49:58,segienamKuning,772,369,114,100,154,20,152,20,2,0,True,0.3437185635625789
2025-01-07 18:49:58,segienamKuning,767,367,119,102,12,40,14,36,2,4,True,0.47695897008392063
2025-01-07 18:49:58,Fail to pick,767,367,0,0,0,0,0,0,0,0,False,0
2025-01-07 18:49:58,segienamKuning,763,369,116,100,155,60,153,62,2,2,True,0.2420614607500026
2025-01-07 18:49:58,Fail to pick,763,369,0,0,0,0,0,0,0,0,False,0
2025-01-07 18:49:58,segienamKuning,767,385,116,105,192,66,192,69,0,3,True,0.3224502978202515
2025-01-07 18:49:59,segienamKuning,774,366,107,101,178,35,179,36,1,1,True,0.2513330930159968
2025-01-07 18:53:31,segienamKuning,835,568,119,113,10,14,5,9,5,5,True,0.41761925343440054
2025-01-07 18:53:31,Kuning,835,568,tensor(119.7875),tensor(113.2615),42,77,39,72,3,5,True,0.0007772445678710938
2025-01-07 18:53:31,segienamKuning,840,556,131,116,43,22,40,21,3,1,True,0.24564106519705564
2025-01-07 18:53:32,segienamKuning,794,536,127,120,184,39,179,37,5,2,True,0.28611151904002585
2025-01-07 18:53:32,segienamKuning,802,528,123,117,48,19,46,14,2,5,True,0.4659444954852525
2025-01-07 18:53:32,Fail to pick,802,528,0,0,0,0,0,0,0,0,False,0
2025-01-07 18:53:32,segienamKuning,800,545,128,116,144,39,143,39,1,0,True,0.30285201535219697
2025-01-07 18:53:32,segienamKuning,829,561,130,113,35,8,32,7,3,1,True,0.36704595729894196
2025-01-07 18:53:32,segienamKuning,825,562,131,111,67,36,66,32,1,4,True,0.44307973515551347
2025-01-07 18:53:32,Fail to pick,825,562,0,0,0,0,0,0,0,0,False,0
2025-01-07 18:53:32,segienamKuning,825,559,129,111,129,46,125,47,4,1,True,0.2663864525417372
2025-01-07 18:53:32,Fail to pick,825,559,0,0,0,0,0,0,0,0,False,0
2025-01-07 18:53:32,segienamKuning,829,561,128,111,83,37,78,41,5,4,True,0.22164972753473133
2025-01-07 18:53:32,Fail to pick,829,561,0,0,0,0,0,0,0,0,False,0
2025-01-07 18:53:32,segienamKuning,788,532,135,123,51,36,53,37,2,1,False,0.46253165875376745
2025-01-07 18:53:32,persegiKuning,789,533,134,123,75,36,77,38,2,2,True,0.37467431498823345
2025-01-07 18:53:32,Fail to pick,789,533,0,0,0,0,0,0,0,0,False,0
2025-01-07 18:53:32,segienamKuning,787,533,133,123,33,60,36,56,3,4,True,0.2147392110106118
2025-01-07 18:53:32,Kuning,787,533,tensor(133.6373),tensor(123.0547),51,72,55,72,4,0,True,0.0
2025-01-07 18:53:32,Fail to pick,787,533,0,0,0,0,0,0,0,0,False,0
2025-01-07 18:53:33,segienamKuning,825,560,129,106,5,82,0,81,5,1,True,0.11404964357253378
2025-01-07 18:53:33,segienamKuning,826,556,126,108,188,49,187,53,1,4,True,0.30428474296887875
2025-01-07 18:53:33,Fail to pick,826,556,0,0,0,0,0,0,0,0,False,0
2025-01-07 18:53:33,segienamKuning,791,538,129,123,54,66,49,61,5,5,True,0.14358647029552657
2025-01-07 18:53:33,segienamKuning,820,564,132,110,46,75,45,70,1,5,True,0.36616350810238485
2025-01-07 18:53:33,segienamKuning,782,534,126,123,132,14,136,16,4,2,True,0.46696321735099955
2025-01-07 18:53:33,segienamKuning,833,554,120,113,81,91,79,87,2,4,True,0.4227306817914217
2025-01-07 18:53:33,segienamKuning,831,558,116,109,169,26,165,24,4,2,True,0.36048564004864314
2025-01-07 18:53:33,Fail to pick,831,558,0,0,0,0,0,0,0,0,False,0
2025-01-07 18:53:33,segienamKuning,821,560,121,114,131,64,130,63,1,1,True,0.38093995356364496
2025-01-07 18:53:33,segienamKuning,828,556,123,108,154,53,151,53,3,0,True,0.1523529166254739
2025-01-07 18:53:33,Fail to pick,828,556,0,0,0,0,0,0,0,0,False,0
2025-01-07 18:53:33,segienamKuning,791,540,124,116,197,87,201,85,4,2,True,0.30660557980791125
2025-01-07 18:53:34,segienamKuning,786,538,129,122,65,36,60,33,5,3,True,0.11444392298114314
2025-01-07 18:53:34,Fail to pick,786,538,0,0,0,0,0,0,0,0,False,0
2025-01-07 18:53:34,segienamKuning,825,558,121,106,107,37,110,39,3,2,True,0.34811003660285117
2025-01-07 18:53:34,segienamKuning,828,555,122,109,127,19,128,19,1,0,True,0.22708606211101096
2025-01-07 18:53:34,Fail to pick,828,555,0,0,0,0,0,0,0,0,False,0
2025-01-07 18:53:34,segienamKuning,826,559,122,106,41,27,41,30,0,3,True,0.40014857727651854
2025-01-07 18:53:34,Fail to pick,826,559,0,0,0,0,0,0,0,0,False,0
2025-01-07 18:53:34,segienamKuning,828,555,123,108,154,87,155,88,1,1,True,0.31145842551517894
2025-01-07 18:53:34,Fail to pick,828,555,0,0,0,0,0,0,0,0,False,0
2025-01-07 18:53:34,segienamKuning,834,560,121,109,185,61,189,56,4,5,True,0.4219265741235071
2025-01-07 18:53:34,Fail to pick,834,560,0,0,0,0,0,0,0,0,False,0
2025-01-07 18:53:34,segienamKuning,794,534,125,118,197,2,197,-3,0,5,True,0.11031978726511392
2025-01-07 18:53:34,segienamKuning,833,564,120,109,91,39,95,42,4,3,True,0.40052224768173816
2025-01-07 18:53:35,segienamKuning,828,561,124,111,176,69,179,73,3,4,False,0.3819367632197498
2025-01-07 18:53:35,Fail to pick,828,561,0,0,0,0,0,0,0,0,False,0
2025-01-07 18:53:35,segienamKuning,827,561,127,108,121,37,116,35,5,2,True,0.37934167738566127
2025-01-07 18:53:35,Fail to pick,827,561,0,0,0,0,0,0,0,0,False,0
2025-01-07 18:53:35,segienamKuning,785,539,130,121,103,46,106,41,3,5,True,0.4859590703737874
2025-01-07 18:53:35,segienamKuning,792,538,130,117,81,99,78,103,3,4,True,0.17812402662333288
2025-01-07 18:53:35,Fail to pick,792,538,0,0,0,0,0,0,0,0,False,0
2025-01-07 18:53:35,segienamKuning,827,563,127,111,127,54,127,53,0,1,True,0.4741177739397806
2025-01-07 18:53:35,segienamKuning,786,543,128,121,163,73,167,76,4,3,True,0.34467724571236613
2025-01-07 18:53:35,segienamKuning,830,562,120,112,155,6,150,3,5,3,True,0.4417038859331197
2025-01-07 18:53:35,segienamKuning,826,559,123,108,153,39,152,43,1,4,True,0.31420927570982027
2025-01-07 18:53:35,Fail to pick,826,559,0,0,0,0,0,0,0,0,False,0
2025-01-07 18:53:36,segienamKuning,798,539,126,119,156,73,154,68,2,5,True,0.2764475663759651
2025-01-07 18:53:36,segienamKuning,824,565,124,115,5,65,8,69,3,4,True,0.33839161825464736
2025-01-07 18:53:36,segienamKuning,829,567,122,116,40,6,38,9,2,3,False,0.3469283433190774
2025-01-07 18:53:36,Fail to pick,829,567,0,0,0,0,0,0,0,0,False,0
2025-01-07 18:53:36,segienamKuning,835,565,120,112,123,12,120,8,3,4,True,0.42584306975718367
2025-01-07 18:53:36,Fail to pick,835,565,0,0,0,0,0,0,0,0,False,0
2025-01-07 18:53:36,segienamKuning,829,567,124,113,75,38,75,42,0,4,True,0.16191308701917984
2025-01-07 18:53:36,Fail to pick,829,567,0,0,0,0,0,0,0,0,False,0
2025-01-07 18:53:36,segienamKuning,831,567,120,108,182,44,178,39,4,5,True,0.13809156379437623
2025-01-07 18:53:36,Fail to pick,831,567,0,0,0,0,0,0,0,0,False,0
2025-01-07 18:53:36,segienamKuning,837,565,121,110,54,82,50,77,4,5,True,0.272641708698433
2025-01-07 18:53:36,Fail to pick,837,565,0,0,0,0,0,0,0,0,False,0
2025-01-07 18:53:36,segienamKuning,829,566,125,111,91,45,94,48,3,3,True,0.2934124775116943
2025-01-07 18:53:36,Fail to pick,829,566,0,0,0,0,0,0,0,0,False,0
2025-01-07 18:53:36,segienamKuning,795,540,128,118,149,75,149,71,0,4,True,0.3686720391449956
2025-01-07 18:53:36,segienamKuning,829,564,123,111,165,20,163,23,2,3,False,0.42834407184301637
2025-01-07 18:53:38,segienamKuning,858,405,118,118,82,0,83,-2,1,2,True,0.4793006242228057
2025-01-07 18:53:38,Kuning,858,405,tensor(118.8212),tensor(118.6654),87,79,91,81,4,2,True,0.0004994869232177734
2025-01-07 18:53:38,segienamKuning,860,407,122,121,135,0,135,-1,0,1,True,0.23881180177308425
2025-01-07 18:53:38,Fail to pick,860,407,0,0,0,0,0,0,0,0,False,0
2025-01-07 18:53:38,segienamKuning,861,409,120,116,199,7,200,5,1,2,False,0.2304327119236052
2025-01-07 18:53:38,Fail to pick,861,409,0,0,0,0,0,0,0,0,False,0
2025-01-07 18:53:38,segienamKuning,860,409,119,115,85,3,81,0,4,3,True,0.2964039007066449
2025-01-07 18:53:38,Fail to pick,860,409,0,0,0,0,0,0,0,0,False,0
2025-01-07 18:53:38,segienamKuning,870,403,118,115,137,10,137,5,0,5,False,0.3398447027469598
2025-01-07 18:53:38,segienamKuning,861,405,121,119,102,11,98,10,4,1,True,0.24969031855292279
2025-01-07 18:53:38,Fail to pick,861,405,0,0,0,0,0,0,0,0,False,0
2025-01-07 18:53:38,segienamKuning,862,409,122,117,68,92,66,88,2,4,True,0.1584932506920772
2025-01-07 18:53:38,Fail to pick,862,409,0,0,0,0,0,0,0,0,False,0
2025-01-07 18:53:38,segienamKuning,862,409,116,118,109,94,106,96,3,2,True,0.1577069456341066
2025-01-07 18:53:39,Fail to pick,862,409,0,0,0,0,0,0,0,0,False,0
2025-01-07 18:53:39,segienamKuning,825,363,128,130,95,40,93,37,2,3,True,0.13016393442565766
2025-01-07 18:53:39,segienamKuning,867,406,120,119,104,83,105,78,1,5,True,0.31810675338390504
2025-01-07 18:53:39,Kuning,867,406,tensor(120.6248),tensor(119.7871),87,80,84,75,3,5,True,0.0005028247833251953
2025-01-07 18:53:39,segienamKuning,869,406,117,117,11,31,11,34,0,3,True,0.16253748082889968
2025-01-07 18:53:39,Fail to pick,869,406,0,0,0,0,0,0,0,0,False,0
2025-01-07 18:53:39,segienamKuning,862,406,119,119,191,34,191,30,0,4,True,0.22735437119498894
2025-01-07 18:53:39,Fail to pick,862,406,0,0,0,0,0,0,0,0,False,0
2025-01-07 18:53:39,segienamKuning,861,407,120,117,25,79,27,80,2,1,True,0.35074945245378464
2025-01-07 18:53:39,Fail to pick,861,407,0,0,0,0,0,0,0,0,False,0
2025-01-07 18:53:39,segienamKuning,862,406,122,123,125,12,124,10,1,2,True,0.14161109746794193
2025-01-07 18:53:39,Fail to pick,862,406,0,0,0,0,0,0,0,0,False,0
2025-01-07 18:53:39,segienamKuning,862,407,120,114,36,49,38,51,2,2,True,0.2050260469092168
2025-01-07 18:53:39,Fail to pick,862,407,0,0,0,0,0,0,0,0,False,0
2025-01-07 18:53:39,segienamKuning,866,405,119,120,1,68,0,69,1,1,True,0.41989145781209514
2025-01-07 18:53:39,Fail to pick,866,405,0,0,0,0,0,0,0,0,False,0
2025-01-07 18:53:40,segienamKuning,868,402,123,118,122,97,125,100,3,3,True,0.1288780674844242
2025-01-07 18:53:40,Fail to pick,868,402,0,0,0,0,0,0,0,0,False,0
2025-01-07 18:53:40,segienamKuning,861,411,121,119,191,73,186,77,5,4,True,0.43101266349893463
2025-01-07 18:53:40,Fail to pick,861,411,0,0,0,0,0,0,0,0,False,0
2025-01-07 18:53:40,segienamKuning,863,410,121,115,27,68,29,66,2,2,True,0.4345516943719564
2025-01-07 18:53:40,Fail to pick,863,410,0,0,0,0,0,0,0,0,False,0
2025-01-07 18:53:40,segienamKuning,866,410,120,116,18,52,17,51,1,1,True,0.38364219473963923
2025-01-07 18:53:40,Fail to pick,866,410,0,0,0,0,0,0,0,0,False,0
2025-01-07 18:53:40,segienamKuning,869,411,119,114,176,20,177,23,1,3,True,0.29496515231232834
2025-01-07 18:53:40,Fail to pick,869,411,0,0,0,0,0,0,0,0,False,0
2025-01-07 18:53:40,segienamKuning,865,413,118,115,164,91,166,87,2,4,True,0.2980558929790089
2025-01-07 18:53:40,Fail to pick,865,413,0,0,0,0,0,0,0,0,False,0
2025-01-07 18:53:40,segienamKuning,867,412,119,115,147,30,149,26,2,4,True,0.46000303290472444
2025-01-07 18:53:40,Fail to pick,867,412,0,0,0,0,0,0,0,0,False,0
2025-01-07 18:53:40,segienamKuning,869,407,118,116,177,0,178,3,1,3,True,0.19904941014705724
2025-01-07 18:53:40,Fail to pick,869,407,0,0,0,0,0,0,0,0,False,0
2025-01-07 18:53:41,segienamKuning,823,373,124,126,14,10,12,7,2,3,True,0.19660052210888354
2025-01-07 18:53:41,segienamKuning,870,410,115,116,88,43,91,41,3,2,True,0.27107189041713375
2025-01-07 18:53:41,segienamKuning,864,410,120,119,91,15,91,17,0,2,True,0.33849440666957953
2025-01-07 18:53:41,Fail to pick,864,410,0,0,0,0,0,0,0,0,False,0
2025-01-07 18:53:41,segienamKuning,861,414,120,118,86,14,84,13,2,1,True,0.2590092019825738
2025-01-07 18:53:41,Fail to pick,861,414,0,0,0,0,0,0,0,0,False,0
2025-01-07 18:53:42,segienamKuning,833,361,120,124,13,35,15,39,2,4,True,0.16790425950668092
2025-01-07 18:53:42,Kuning,833,361,tensor(120.1168),tensor(124.1938),99,77,103,77,4,0,True,0.0004994869232177734
2025-01-07 18:53:42,segienamKuning,862,412,114,116,38,4,39,5,1,1,True,0.4300263633317315
2025-01-07 18:53:42,segienamKuning,870,414,117,121,191,60,190,61,1,1,True,0.18166491528985726
2025-01-07 18:53:42,Fail to pick,870,414,0,0,0,0,0,0,0,0,False,0
2025-01-07 18:53:43,segienamKuning,870,414,117,121,38,17,37,12,1,5,True,0.13472394903698623
2025-01-07 18:53:43,Fail to pick,870,414,0,0,0,0,0,0,0,0,False,0
2025-01-07 18:53:43,segienamKuning,869,412,120,121,62,71,58,73,4,2,True,0.30885810747400844
2025-01-07 18:53:43,Fail to pick,869,412,0,0,0,0,0,0,0,0,False,0
2025-01-07 18:53:43,segienamKuning,876,410,119,117,30,79,31,76,1,3,True,0.4610617066506547
2025-01-07 18:53:43,Fail to pick,876,410,0,0,0,0,0,0,0,0,False,0
2025-01-07 18:53:43,segienamKuning,870,417,118,116,170,56,172,56,2,0,True,0.3430017307273986
2025-01-07 18:53:43,Fail to pick,870,417,0,0,0,0,0,0,0,0,False,0
2025-01-07 18:53:43,segienamKuning,871,413,117,120,179,41,183,38,4,3,True,0.25137652283701756
2025-01-07 18:53:43,Fail to pick,871,413,0,0,0,0,0,0,0,0,False,0
2025-01-07 18:53:43,segienamKuning,876,415,117,116,7,84,10,83,3,1,True,0.1667042000447793
2025-01-07 18:53:43,Fail to pick,876,415,0,0,0,0,0,0,0,0,False,0
2025-01-07 18:53:44,segienamKuning,879,412,114,120,7,77,9,79,2,2,True,0.21494850340796942
2025-01-07 18:53:44,Fail to pick,879,412,0,0,0,0,0,0,0,0,False,0
2025-01-07 18:53:44,segienamKuning,880,416,109,118,56,18,56,21,0,3,True,0.43481031086943545
2025-01-07 18:53:44,Fail to pick,880,416,0,0,0,0,0,0,0,0,False,0
2025-01-07 18:53:49,segienamKuning,884,418,119,112,9,46,5,47,4,1,True,0.4048421235237716
2025-01-07 18:53:50,Fail to pick,884,418,0,0,0,0,0,0,0,0,False,0
2025-01-07 18:53:50,segienamKuning,860,407,127,132,158,54,157,56,1,2,True,0.4075143336743371
2025-01-07 18:53:50,persegiKuning,860,408,124,134,149,88,149,87,0,1,True,0.1482794567177984
2025-01-07 18:53:50,Fail to pick,860,408,0,0,0,0,0,0,0,0,False,0
2025-01-07 18:53:52,segienamKuning,859,404,120,118,148,32,146,28,2,4,True,0.19999810509946336
2025-01-07 18:53:52,Kuning,859,404,tensor(120.5135),tensor(118.3331),87,79,89,79,2,0,True,0.0004980564117431641
2025-01-07 18:53:53,Fail to pick,859,404,0,0,0,0,0,0,0,0,False,0
2025-01-07 18:53:53,segienamKuning,860,409,117,117,138,87,142,85,4,2,True,0.1981435370600403
2025-01-07 18:53:53,Fail to pick,860,409,0,0,0,0,0,0,0,0,False,0
2025-01-07 18:53:53,segienamKuning,859,408,118,116,0,47,-5,51,5,4,True,0.44612139295165065
2025-01-07 18:53:53,Fail to pick,859,408,0,0,0,0,0,0,0,0,False,0
2025-01-07 18:53:53,segienamKuning,860,407,117,119,31,18,35,14,4,4,True,0.3187724318660046
2025-01-07 18:53:53,Fail to pick,860,407,0,0,0,0,0,0,0,0,False,0
2025-01-07 18:53:53,segienamKuning,860,406,121,118,80,80,75,78,5,2,True,0.25971027893908916
2025-01-07 18:53:53,Fail to pick,860,406,0,0,0,0,0,0,0,0,False,0
2025-01-07 18:53:54,segienamKuning,816,371,122,121,151,83,146,87,5,4,True,0.1794990202182628
2025-01-07 18:53:54,segienamKuning,851,406,122,115,161,6,164,2,3,4,True,0.45941700547352604
2025-01-07 18:53:54,segienamKuning,868,399,122,120,198,58,196,53,2,5,True,0.1704125549593719
2025-01-07 18:53:54,segienamKuning,857,408,123,118,58,25,58,23,0,2,True,0.20735033300563074
2025-01-07 18:53:55,segienamKuning,861,407,122,120,163,4,161,3,2,1,True,0.2969493359003291
2025-01-07 18:53:55,Fail to pick,861,407,0,0,0,0,0,0,0,0,False,0
2025-01-07 18:53:55,segienamKuning,860,407,120,116,151,71,155,71,4,0,False,0.3309319004725588
2025-01-07 18:53:55,Fail to pick,860,407,0,0,0,0,0,0,0,0,False,0
2025-01-07 18:53:55,segienamKuning,856,412,119,114,120,0,120,-2,0,2,False,0.43719095726216595
2025-01-07 18:53:55,Fail to pick,856,412,0,0,0,0,0,0,0,0,False,0
2025-01-07 18:53:55,segienamKuning,856,407,121,117,53,53,52,50,1,3,False,0.12886796246731064
2025-01-07 18:53:55,Fail to pick,856,407,0,0,0,0,0,0,0,0,False,0
2025-01-07 18:53:55,segienamKuning,857,413,118,117,175,63,173,60,2,3,True,0.25916172073242016
2025-01-07 18:53:55,Fail to pick,857,413,0,0,0,0,0,0,0,0,False,0
2025-01-07 18:53:56,segienamKuning,860,405,121,117,78,68,75,63,3,5,False,0.21341788964923528
2025-01-07 18:53:56,Fail to pick,860,405,0,0,0,0,0,0,0,0,False,0
2025-01-07 18:53:56,segienamKuning,866,407,125,117,171,83,171,84,0,1,True,0.274375868505489
2025-01-07 18:53:56,Fail to pick,866,407,0,0,0,0,0,0,0,0,False,0
2025-01-07 18:53:56,segienamKuning,832,380,120,124,145,6,145,2,0,4,True,0.2870755949423731
2025-01-07 18:53:56,segienamKuning,856,412,120,118,198,75,198,78,0,3,True,0.36038323556216545
2025-01-07 18:53:57,segienamKuning,858,406,121,120,137,25,134,24,3,1,True,0.4627823893649704
2025-01-07 18:53:57,Fail to pick,858,406,0,0,0,0,0,0,0,0,False,0
2025-01-07 18:53:57,segienamKuning,860,408,120,118,135,55,131,58,4,3,True,0.42717609471553764
2025-01-07 18:53:57,Fail to pick,860,408,0,0,0,0,0,0,0,0,False,0
2025-01-07 18:53:57,segienamKuning,814,375,127,123,173,36,172,35,1,1,True,0.17114817278944097
2025-01-07 18:53:57,segienamKuning,860,404,119,117,119,4,116,2,3,2,False,0.30734424374691804
2025-01-07 18:53:57,segienamKuning,856,412,126,118,87,85,82,89,5,4,True,0.13962178185465846
2025-01-07 18:53:57,Fail to pick,856,412,0,0,0,0,0,0,0,0,False,0
2025-01-07 18:53:58,segienamKuning,860,410,120,115,99,82,98,77,1,5,True,0.2630143044409785
2025-01-07 18:53:58,Fail to pick,860,410,0,0,0,0,0,0,0,0,False,0
2025-01-07 18:53:58,segienamKuning,862,409,121,117,26,8,22,3,4,5,True,0.34694559227210775
2025-01-07 18:53:58,Fail to pick,862,409,0,0,0,0,0,0,0,0,False,0
2025-01-07 18:53:58,segienamKuning,855,413,122,116,174,45,178,48,4,3,True,0.18292888722410494
2025-01-07 18:53:58,Fail to pick,855,413,0,0,0,0,0,0,0,0,False,0
2025-01-07 18:53:59,segienamKuning,831,373,117,118,74,30,77,29,3,1,True,0.4811036981709196
2025-01-07 18:53:59,segienamKuning,853,413,120,114,44,63,44,65,0,2,True,0.31064958171613366
2025-01-07 18:53:59,segienamKuning,857,408,119,118,37,90,38,94,1,4,True,0.2084289380116532
2025-01-07 18:53:59,Fail to pick,857,408,0,0,0,0,0,0,0,0,False,0
2025-01-07 18:54:00,segienamKuning,857,411,122,117,89,94,86,93,3,1,True,0.25247180493732857
2025-01-07 18:54:00,Fail to pick,857,411,0,0,0,0,0,0,0,0,False,0
2025-01-07 18:54:00,segienamKuning,871,404,125,116,22,96,26,91,4,5,True,0.2378420075817218
2025-01-07 18:54:00,segienamKuning,856,411,123,117,190,96,190,100,0,4,True,0.4752956386366175
2025-01-07 18:54:00,segienamKuning,856,405,126,115,182,75,186,74,4,1,True,0.40416969791572777
2025-01-07 18:54:00,Fail to pick,856,405,0,0,0,0,0,0,0,0,False,0
2025-01-07 18:54:03,segienamKuning,858,416,122,121,87,41,82,43,5,2,False,0.39733452117906554
2025-01-07 18:54:03,segienamKuning,855,414,121,120,85,77,87,81,2,4,True,0.3688363144354494
2025-01-07 18:54:03,Fail to pick,855,414,0,0,0,0,0,0,0,0,False,0
2025-01-07 18:54:03,segienamKuning,855,408,122,121,164,59,159,56,5,3,True,0.3638209243145982
2025-01-07 18:54:03,Fail to pick,855,408,0,0,0,0,0,0,0,0,False,0
2025-01-07 18:54:03,segienamKuning,857,408,120,118,176,7,177,7,1,0,True,0.23568313531131882
2025-01-07 18:54:03,Fail to pick,857,408,0,0,0,0,0,0,0,0,False,0
2025-01-07 18:54:04,segienamKuning,858,406,117,119,14,84,10,83,4,1,False,0.1322019625647359
2025-01-07 18:54:04,Fail to pick,858,406,0,0,0,0,0,0,0,0,False,0
2025-01-07 18:54:04,segienamKuning,850,413,119,119,61,99,59,96,2,3,True,0.18498705701125445
2025-01-07 18:54:04,Fail to pick,850,413,0,0,0,0,0,0,0,0,False,0
2025-01-07 18:54:04,segienamKuning,853,414,125,119,159,79,160,74,1,5,True,0.3267003506203637
2025-01-07 18:54:04,Fail to pick,853,414,0,0,0,0,0,0,0,0,False,0
2025-01-07 18:54:04,segienamKuning,845,422,124,121,178,96,175,99,3,3,True,0.3219898114325477
2025-01-07 18:54:04,Fail to pick,845,422,0,0,0,0,0,0,0,0,False,0
2025-01-07 18:54:05,segienamKuning,859,405,120,113,196,56,197,55,1,1,True,0.14835454162093195
2025-01-07 18:54:05,segienamKuning,858,414,121,119,190,76,190,71,0,5,True,0.39747229939209505
2025-01-07 18:54:05,Fail to pick,858,414,0,0,0,0,0,0,0,0,False,0
2025-01-07 18:54:05,segienamKuning,858,408,118,118,20,11,24,9,4,2,True,0.23020080238104806
2025-01-07 18:54:05,Fail to pick,858,408,0,0,0,0,0,0,0,0,False,0
2025-01-07 18:54:05,segienamKuning,861,408,118,118,4,48,4,48,0,0,True,0.4237579637453056
2025-01-07 18:54:05,Fail to pick,861,408,0,0,0,0,0,0,0,0,False,0
2025-01-07 18:54:06,segienamKuning,849,412,123,116,20,44,24,42,4,2,True,0.4061482657590415
2025-01-07 18:54:06,segienamKuning,846,418,127,117,182,68,180,64,2,4,True,0.4244201673458824
2025-01-07 18:54:06,Fail to pick,846,418,0,0,0,0,0,0,0,0,False,0
2025-01-07 18:54:06,segienamKuning,854,415,117,117,16,1,20,4,4,3,False,0.24967274193266895
2025-01-07 18:54:06,Fail to pick,854,415,0,0,0,0,0,0,0,0,False,0
2025-01-07 18:54:07,segienamKuning,853,423,128,119,7,80,2,83,5,3,True,0.10796217784372364
2025-01-07 18:54:07,Fail to pick,853,423,0,0,0,0,0,0,0,0,False,0
2025-01-07 18:54:07,segienamKuning,849,417,125,113,195,59,194,54,1,5,True,0.1384378867203284
2025-01-07 18:54:07,Fail to pick,849,417,0,0,0,0,0,0,0,0,False,0
2025-01-07 18:54:10,segienamKuning,850,394,125,117,5,26,2,21,3,5,True,0.38270892575998394
2025-01-07 18:54:10,segienamKuning,859,409,116,118,51,15,49,12,2,3,True,0.13643498513215221
2025-01-07 18:54:10,segienamKuning,861,406,120,118,180,85,177,89,3,4,False,0.4828282789430225
2025-01-07 18:54:10,Fail to pick,861,406,0,0,0,0,0,0,0,0,False,0
2025-01-07 18:54:21,segienamKuning,771,673,119,89,14,92,13,95,1,3,True,0.4748029961957525
2025-01-07 18:54:21,lingkaranKuning,772,672,115,93,103,69,106,73,3,4,True,0.36671756571702807
2025-01-07 18:54:21,Kuning,771,673,tensor(119.2134),tensor(89.4782),13,71,14,74,1,3,True,0.0
2025-01-07 18:54:21,Fail to pick,772,672,0,0,0,0,0,0,0,0,False,0
2025-01-07 18:54:21,lingkaranKuning,774,674,114,91,194,12,192,7,2,5,True,0.4726011810734879
2025-01-07 18:54:21,persegiKuning,773,674,119,90,56,98,55,99,1,1,True,0.25532854680355466
2025-01-07 18:54:21,Fail to pick,774,674,0,0,0,0,0,0,0,0,False,0
2025-01-07 18:54:21,Fail to pick,773,674,0,0,0,0,0,0,0,0,False,0
2025-01-07 18:54:21,segienamKuning,774,674,120,90,116,95,120,90,4,5,True,0.47648418598222697
2025-01-07 18:54:21,Fail to pick,774,674,0,0,0,0,0,0,0,0,False,0
2025-01-07 18:54:21,lingkaranKuning,759,672,116,95,81,11,78,6,3,5,True,0.4749782278903575
2025-01-07 18:54:22,segienamKuning,807,681,109,77,95,97,92,101,3,4,True,0.24104471077800071
2025-01-07 18:54:22,lingkaranKuning,809,681,106,77,28,19,23,21,5,2,True,0.20613663345999977
2025-01-07 18:54:22,Fail to pick,809,681,0,0,0,0,0,0,0,0,False,0
2025-01-07 18:54:22,lingkaranKuning,808,680,111,78,55,69,57,69,2,0,False,0.12464867658504307
2025-01-07 18:54:22,segienamKuning,806,681,111,76,19,88,19,88,0,0,True,0.3897942749526865
2025-01-07 18:54:22,Fail to pick,808,680,0,0,0,0,0,0,0,0,False,0
2025-01-07 18:54:22,Fail to pick,806,681,0,0,0,0,0,0,0,0,False,0
2025-01-07 18:54:22,segienamKuning,768,673,122,93,132,17,128,15,4,2,True,0.12795844086458527
2025-01-07 18:54:22,Kuning,768,673,tensor(122.5048),tensor(93.7443),13,71,16,69,3,2,True,0.0004966259002685547
2025-01-07 18:54:22,lingkaranKuning,805,678,112,82,84,62,79,57,5,5,True,0.26362694046067603
2025-01-07 18:54:22,segienamKuning,804,679,114,80,0,89,-4,92,4,3,True,0.34259861450879436
2025-01-07 18:54:22,Fail to pick,804,679,0,0,0,0,0,0,0,0,False,0
2025-01-07 18:54:23,lingkaranKuning,753,672,113,95,102,98,101,94,1,4,True,0.15979411034007232
2025-01-07 18:54:23,segienamKuning,805,681,117,76,74,19,71,19,3,0,True,0.39980918289369416
2025-01-07 18:54:23,segienamKuning,799,682,113,75,183,47,187,51,4,4,True,0.2633873954834621
2025-01-07 18:54:23,lingkaranKuning,799,681,110,76,24,30,24,32,0,2,True,0.3499983887068317
2025-01-07 18:54:23,Fail to pick,799,682,0,0,0,0,0,0,0,0,False,0
2025-01-07 18:54:23,Fail to pick,799,681,0,0,0,0,0,0,0,0,False,0
2025-01-07 18:54:23,segienamKuning,806,680,115,78,35,13,37,10,2,3,True,0.26955208265236374
2025-01-07 18:54:23,Kuning,806,680,tensor(115.3391),tensor(78.3190),11,74,10,74,1,0,True,0.0
2025-01-07 18:54:23,Fail to pick,806,680,0,0,0,0,0,0,0,0,False,0
2025-01-07 18:54:24,lingkaranKuning,804,681,111,76,173,52,169,52,4,0,True,0.32583585138940224
2025-01-07 18:54:24,segienamKuning,804,682,114,75,185,72,186,72,1,0,True,0.26273787839302576
2025-01-07 18:54:24,Fail to pick,804,681,0,0,0,0,0,0,0,0,False,0
2025-01-07 18:54:24,Fail to pick,804,682,0,0,0,0,0,0,0,0,False,0
2025-01-07 18:54:24,segienamKuning,802,681,113,76,142,94,142,95,0,1,True,0.11017359613143181
2025-01-07 18:54:24,lingkaranKuning,803,681,109,77,7,16,2,18,5,2,False,0.1008182352248595
2025-01-07 18:54:24,Fail to pick,802,681,0,0,0,0,0,0,0,0,False,0
2025-01-07 18:54:24,Fail to pick,803,681,0,0,0,0,0,0,0,0,False,0
2025-01-07 18:54:24,segienamKuning,768,671,124,94,57,75,59,78,2,3,True,0.28995594602462516
2025-01-07 18:54:24,Kuning,768,671,tensor(124.3396),tensor(94.8948),13,71,14,73,1,2,True,0.0004942417144775391
2025-01-07 18:54:25,segienamKuning,805,681,114,77,13,63,15,66,2,3,True,0.13704960087187168
2025-01-07 18:54:25,lingkaranKuning,806,681,111,77,194,37,197,36,3,1,True,0.18273448824516816
2025-01-07 18:54:25,Fail to pick,806,681,0,0,0,0,0,0,0,0,False,0
2025-01-07 18:54:25,segienamKuning,809,682,110,74,103,97,105,93,2,4,True,0.38035205655742643
2025-01-07 18:54:25,Fail to pick,809,682,0,0,0,0,0,0,0,0,False,0
2025-01-07 18:54:25,lingkaranKuning,798,681,108,76,78,90,73,87,5,3,True,0.35821588535846915
2025-01-07 18:54:25,segienamKuning,798,682,113,75,42,64,37,62,5,2,True,0.45910516171305005
2025-01-07 18:54:25,Fail to pick,798,682,0,0,0,0,0,0,0,0,False,0
2025-01-07 18:54:26,lingkaranKuning,794,676,105,86,133,72,131,69,2,3,True,0.4277845707416216
2025-01-07 18:54:26,segienamKuning,794,676,111,86,39,41,39,41,0,0,True,0.3054361016057696
2025-01-07 18:54:26,Kuning,794,676,tensor(105.9793),tensor(86.9202),12,73,13,73,1,0,True,0.0005097389221191406
2025-01-07 18:54:26,Fail to pick,794,676,0,0,0,0,0,0,0,0,False,0
2025-01-07 18:54:26,Fail to pick,794,676,0,0,0,0,0,0,0,0,False,0
2025-01-07 18:54:26,lingkaranKuning,764,670,114,98,162,97,164,101,2,4,True,0.344237181369607
2025-01-07 18:54:26,persegiKuning,766,670,119,95,40,84,38,81,2,3,True,0.18288220370143793
2025-01-07 18:54:26,Fail to pick,766,670,0,0,0,0,0,0,0,0,False,0
2025-01-07 18:54:26,lingkaranKuning,759,670,115,99,73,60,70,55,3,5,True,0.33182188748458663
2025-01-07 18:54:26,Fail to pick,759,670,0,0,0,0,0,0,0,0,False,0
2025-01-07 18:54:26,lingkaranKuning,759,669,114,101,128,31,123,35,5,4,True,0.28561870559057057
2025-01-07 18:54:26,Fail to pick,759,669,0,0,0,0,0,0,0,0,False,0
2025-01-07 18:54:26,lingkaranKuning,804,681,113,77,14,27,14,23,0,4,True,0.13774884273071147
2025-01-07 18:54:26,segienamKuning,802,681,118,77,67,94,70,91,3,3,True,0.19054855252865888
2025-01-07 18:54:26,Fail to pick,802,681,0,0,0,0,0,0,0,0,False,0
2025-01-07 18:54:27,segienamKuning,763,673,119,92,140,59,138,62,2,3,True,0.36144566166104863
2025-01-07 18:54:27,lingkaranKuning,764,672,114,94,25,97,28,96,3,1,True,0.218728580789118
2025-01-07 18:54:27,Fail to pick,764,672,0,0,0,0,0,0,0,0,False,0
2025-01-07 18:54:27,segienamKuning,805,680,112,78,28,41,31,40,3,1,True,0.39482395587572994
2025-01-07 18:54:27,lingkaranKuning,805,680,110,79,112,13,115,16,3,3,True,0.40108722886023307
2025-01-07 18:54:27,Kuning,805,680,tensor(112.7762),tensor(78.6256),11,74,7,70,4,4,True,0.0
2025-01-07 18:54:27,Fail to pick,805,680,0,0,0,0,0,0,0,0,False,0
2025-01-07 18:54:27,segienamKuning,765,670,124,97,101,42,102,41,1,1,True,0.2493775028273106
2025-01-07 18:54:27,segienamKuning,808,680,110,78,5,61,9,65,4,4,False,0.2353771014392476
2025-01-07 18:54:27,lingkaranKuning,807,680,109,79,23,7,22,10,1,3,False,0.42145019192448385
2025-01-07 18:54:27,Fail to pick,807,680,0,0,0,0,0,0,0,0,False,0
2025-01-07 18:54:28,lingkaranKuning,806,680,122,78,34,22,30,26,4,4,True,0.20048846144332635
2025-01-07 18:54:28,segienamKuning,805,680,124,78,35,71,37,70,2,1,True,0.4258756190421501
2025-01-07 18:54:28,Fail to pick,806,680,0,0,0,0,0,0,0,0,False,0
2025-01-07 18:54:28,Fail to pick,805,680,0,0,0,0,0,0,0,0,False,0
2025-01-07 18:54:28,lingkaranKuning,806,678,116,83,173,39,177,39,4,0,True,0.3815299075332834
2025-01-07 18:54:28,segienamKuning,804,678,115,82,130,22,132,24,2,2,True,0.27614149375489233
2025-01-07 18:54:28,Kuning,806,678,tensor(116.0159),tensor(83.1638),11,74,10,72,1,2,True,0.0
2025-01-07 18:54:28,Fail to pick,806,678,0,0,0,0,0,0,0,0,False,0
2025-01-07 18:54:28,Fail to pick,804,678,0,0,0,0,0,0,0,0,False,0
2025-01-07 18:54:28,segienamKuning,761,665,132,102,75,53,74,51,1,2,True,0.19426156659009863
2025-01-07 18:54:28,lingkaranKuning,799,678,115,82,43,5,44,2,1,3,True,0.4515416199609419
2025-01-07 18:54:28,segienamKuning,801,679,119,81,97,17,96,16,1,1,True,0.1753761768316381
2025-01-07 18:54:28,Fail to pick,801,679,0,0,0,0,0,0,0,0,False,0
2025-01-07 18:54:29,segienamKuning,758,665,133,102,68,15,71,15,3,0,True,0.2774136665211061
2025-01-07 18:54:29,segienamKuning,784,672,127,91,74,80,69,79,5,1,True,0.2632743516109255
2025-01-07 18:54:29,lingkaranKuning,782,671,120,95,192,38,192,35,0,3,True,0.2727706188334088
2025-01-07 18:54:29,Fail to pick,782,671,0,0,0,0,0,0,0,0,False,0
2025-01-07 18:54:29,lingkaranKuning,792,675,111,87,106,85,109,87,3,2,True,0.20871274935702533
2025-01-07 18:54:29,segienamKuning,792,676,115,86,103,79,101,77,2,2,True,0.42960613081103494
2025-01-07 18:54:29,Fail to pick,792,676,0,0,0,0,0,0,0,0,False,0
2025-01-07 18:54:29,segienamKuning,776,673,115,91,170,68,171,71,1,3,True,0.4162862585289694
2025-01-07 18:54:29,lingkaranKuning,776,672,113,94,102,87,97,87,5,0,True,0.29572074039025675
2025-01-07 18:54:29,Fail to pick,776,672,0,0,0,0,0,0,0,0,False,0
2025-01-07 18:54:29,segienamKuning,768,668,120,95,14,77,11,77,3,0,True,0.2849699411181652
2025-01-07 18:54:29,lingkaranKuning,767,669,115,99,1,76,4,76,3,0,True,0.3472878537083939
2025-01-07 18:54:29,Fail to pick,768,668,0,0,0,0,0,0,0,0,False,0
2025-01-07 18:54:29,Fail to pick,767,669,0,0,0,0,0,0,0,0,False,0
2025-01-07 18:54:29,lingkaranKuning,775,673,111,92,128,97,131,94,3,3,True,0.4397409439806177
2025-01-07 18:54:29,segienamKuning,775,674,114,88,91,43,91,39,0,4,True,0.2568908856654529
2025-01-07 18:54:29,Kuning,775,673,tensor(111.3466),tensor(92.2061),13,71,10,71,3,0,True,0.0
2025-01-07 18:54:29,Fail to pick,775,673,0,0,0,0,0,0,0,0,False,0
2025-01-07 18:54:29,Fail to pick,775,674,0,0,0,0,0,0,0,0,False,0
2025-01-07 18:54:30,segienamKuning,764,668,121,99,183,95,183,99,0,4,True,0.14944774711158582
2025-01-07 18:54:30,lingkaranKuning,769,670,116,98,159,25,160,29,1,4,True,0.492099145505285
2025-01-07 18:54:30,segienamKuning,767,671,123,95,151,41,154,36,3,5,False,0.1199203931728694
2025-01-07 18:54:30,Fail to pick,769,670,0,0,0,0,0,0,0,0,False,0
2025-01-07 18:54:30,Fail to pick,767,671,0,0,0,0,0,0,0,0,False,0
2025-01-07 18:54:30,segienamKuning,779,673,120,91,185,97,187,100,2,3,True,0.33371934730833736
2025-01-07 18:54:30,lingkaranKuning,780,672,117,95,197,48,196,44,1,4,True,0.44305565448896367
2025-01-07 18:54:30,Fail to pick,780,672,0,0,0,0,0,0,0,0,False,0
2025-01-07 18:54:30,lingkaranKuning,776,671,117,96,103,48,104,47,1,1,True,0.20191546945640898
2025-01-07 18:54:30,segienamKuning,775,672,121,94,37,91,35,88,2,3,True,0.10278100151498251
2025-01-07 18:54:30,Fail to pick,776,671,0,0,0,0,0,0,0,0,False,0
2025-01-07 18:54:30,Fail to pick,775,672,0,0,0,0,0,0,0,0,False,0
2025-01-07 18:54:30,lingkaranKuning,767,670,118,98,69,27,70,27,1,0,True,0.2758240183650281
2025-01-07 18:54:30,segienamKuning,766,672,122,95,45,41,47,44,2,3,True,0.2835752415446925
2025-01-07 18:54:30,Fail to pick,767,670,0,0,0,0,0,0,0,0,False,0
2025-01-07 18:54:30,Fail to pick,766,672,0,0,0,0,0,0,0,0,False,0
2025-01-07 18:54:30,segienamKuning,767,667,123,102,20,43,21,45,1,2,True,0.13671980454108992
2025-01-07 18:54:30,Fail to pick,767,667,0,0,0,0,0,0,0,0,False,0
2025-01-07 18:54:30,segienamKuning,767,667,123,102,185,88,180,91,5,3,True,0.19943402835838922
2025-01-07 18:54:30,Fail to pick,767,667,0,0,0,0,0,0,0,0,False,0
2025-01-07 18:54:30,lingkaranKuning,808,678,112,82,133,24,133,23,0,1,True,0.14762132899495473
2025-01-07 18:54:30,segienamKuning,806,679,111,81,199,38,203,34,4,4,True,0.34682950757275344
2025-01-07 18:54:30,Fail to pick,806,679,0,0,0,0,0,0,0,0,False,0
2025-01-07 18:54:31,segienamKuning,773,674,118,89,180,18,183,13,3,5,True,0.3426943484914594
2025-01-07 18:54:31,lingkaranKuning,773,674,114,91,15,78,19,82,4,4,True,0.1574403778782458
2025-01-07 18:54:31,Fail to pick,773,674,0,0,0,0,0,0,0,0,False,0
2025-01-07 18:54:31,segienamKuning,768,668,131,98,194,63,191,64,3,1,True,0.28524151992720814
2025-01-07 18:54:31,Kuning,768,668,tensor(131.6205),tensor(98.9311),14,71,9,67,5,4,True,0.0
2025-01-07 18:54:31,Fail to pick,768,668,0,0,0,0,0,0,0,0,False,0
2025-01-07 18:54:31,segienamKuning,809,681,119,77,48,92,47,87,1,5,True,0.32464649383308025
2025-01-07 18:54:31,lingkaranKuning,805,681,112,77,44,72,41,76,3,4,False,0.49232094983491925
2025-01-07 18:54:31,segienamKuning,804,681,114,77,187,68,186,67,1,1,True,0.33592134185031663
2025-01-07 18:54:31,Fail to pick,805,681,0,0,0,0,0,0,0,0,False,0
2025-01-07 18:54:31,Fail to pick,804,681,0,0,0,0,0,0,0,0,False,0
2025-01-07 18:54:31,segienamKuning,768,671,127,97,61,12,65,12,4,0,False,0.27553075793167486
2025-01-07 18:54:31,lingkaranKuning,769,670,119,99,143,8,143,4,0,4,True,0.4814528177709161
2025-01-07 18:54:31,Fail to pick,769,670,0,0,0,0,0,0,0,0,False,0
2025-01-07 18:54:31,segienamKuning,810,679,119,81,5,84,1,82,4,2,True,0.16594245940516872
2025-01-07 18:54:31,lingkaranKuning,811,679,114,81,97,50,98,48,1,2,True,0.2572729814561272
2025-01-07 18:54:31,Fail to pick,811,679,0,0,0,0,0,0,0,0,False,0
2025-01-07 18:54:31,lingkaranKuning,756,669,117,101,187,59,186,57,1,2,False,0.1458684466608666
2025-01-07 18:54:32,segienamKuning,769,668,125,97,160,48,155,46,5,2,True,0.4974483302173991
2025-01-07 18:54:32,lingkaranKuning,811,677,117,85,94,36,95,35,1,1,False,0.24984922421844527
2025-01-07 18:54:32,segienamKuning,810,677,120,82,44,2,42,3,2,1,True,0.18512586225905606
2025-01-07 18:54:32,Fail to pick,810,677,0,0,0,0,0,0,0,0,False,0
2025-01-07 18:54:32,lingkaranKuning,804,678,112,83,24,8,20,12,4,4,True,0.2830396709739815
2025-01-07 18:54:32,segienamKuning,807,678,118,82,83,21,78,17,5,4,True,0.4574164262627606
2025-01-07 18:54:32,Kuning,804,678,tensor(112.2740),tensor(83.3514),11,74,6,73,5,1,True,0.0004982948303222656
2025-01-07 18:54:32,Fail to pick,804,678,0,0,0,0,0,0,0,0,False,0
2025-01-07 18:54:32,Fail to pick,807,678,0,0,0,0,0,0,0,0,False,0
2025-01-07 18:54:32,lingkaranKuning,759,671,117,97,89,10,90,14,1,4,True,0.3724894122708384
2025-01-07 18:54:32,segienamKuning,759,672,123,95,66,21,61,22,5,1,True,0.11207690109784557
2025-01-07 18:54:32,Fail to pick,759,672,0,0,0,0,0,0,0,0,False,0
2025-01-07 18:54:33,segienamKuning,762,667,122,100,19,40,21,39,2,1,True,0.4952948630474482
2025-01-07 18:54:33,Fail to pick,762,667,0,0,0,0,0,0,0,0,False,0
2025-01-07 19:04:24,persegiKuning,866,643,116,143,97,25,99,28,2,3,True,0.47856282574521025
2025-01-07 19:04:24,Kuning,866,643,tensor(116.3450),tensor(143.9973),21,80,17,84,4,4,True,0.0005347728729248047
2025-01-07 19:04:24,persegiKuning,812,621,115,120,191,88,192,92,1,4,True,0.1812546596369277
2025-01-07 19:04:24,lingkaranKuning,813,620,112,120,25,34,20,34,5,0,True,0.28053305841713083
2025-01-07 19:04:24,segienamKuning,811,622,115,121,64,27,66,30,2,3,True,0.20271491043120068
2025-01-07 19:04:24,Fail to pick,813,620,0,0,0,0,0,0,0,0,False,0
2025-01-07 19:04:24,Fail to pick,811,622,0,0,0,0,0,0,0,0,False,0
2025-01-07 19:04:24,segienamKuning,820,627,126,121,174,1,172,1,2,0,True,0.45779438649628157
2025-01-07 19:04:24,lingkaranKuning,821,627,118,121,91,96,89,96,2,0,True,0.24409851165239332
2025-01-07 19:04:24,Fail to pick,820,627,0,0,0,0,0,0,0,0,False,0
2025-01-07 19:04:24,Fail to pick,821,627,0,0,0,0,0,0,0,0,False,0
2025-01-07 19:04:24,persegiKuning,815,622,115,131,183,93,183,97,0,4,True,0.3598850500802012
2025-01-07 19:04:24,Fail to pick,815,622,0,0,0,0,0,0,0,0,False,0
2025-01-07 19:04:24,persegiKuning,815,623,118,130,87,2,84,-1,3,3,True,0.35056350821899884
2025-01-07 19:04:24,Fail to pick,815,623,0,0,0,0,0,0,0,0,False,0
2025-01-07 19:04:25,segienamKuning,823,619,114,124,181,25,177,26,4,1,True,0.36189086817317107
2025-01-07 19:04:25,lingkaranKuning,824,617,110,122,168,99,164,100,4,1,True,0.1380708193009982
2025-01-07 19:04:25,persegiKuning,823,620,115,125,14,82,10,80,4,2,False,0.19422458568432344
2025-01-07 19:04:25,Fail to pick,823,619,0,0,0,0,0,0,0,0,False,0
2025-01-07 19:04:25,Fail to pick,824,617,0,0,0,0,0,0,0,0,False,0
2025-01-07 19:04:25,Fail to pick,823,620,0,0,0,0,0,0,0,0,False,0
2025-01-07 19:04:25,lingkaranKuning,823,627,114,121,155,99,154,97,1,2,True,0.23004386926646314
2025-01-07 19:04:25,segienamKuning,822,625,119,119,4,18,3,14,1,4,True,0.278539855834091
2025-01-07 19:04:25,Fail to pick,823,627,0,0,0,0,0,0,0,0,False,0
2025-01-07 19:04:25,Fail to pick,822,625,0,0,0,0,0,0,0,0,False,0
2025-01-07 19:04:25,persegiKuning,819,621,115,125,114,49,117,53,3,4,True,0.17246089379990087
2025-01-07 19:04:25,Kuning,819,621,tensor(115.7012),tensor(125.8784),27,75,22,76,5,1,True,0.0004971027374267578
2025-01-07 19:04:25,Fail to pick,819,621,0,0,0,0,0,0,0,0,False,0
2025-01-07 19:04:25,persegiKuning,818,622,118,120,110,23,114,18,4,5,True,0.45311526486296605
2025-01-07 19:04:25,lingkaranKuning,820,620,113,118,35,11,33,13,2,2,True,0.19303123496717808
2025-01-07 19:04:25,Fail to pick,818,622,0,0,0,0,0,0,0,0,False,0
2025-01-07 19:04:25,Fail to pick,820,620,0,0,0,0,0,0,0,0,False,0
2025-01-07 19:04:25,persegiKuning,798,627,116,121,120,83,116,85,4,2,True,0.4367819532964897
2025-01-07 19:04:25,persegiKuning,801,632,123,120,63,48,63,45,0,3,False,0.22752528057969307
2025-01-07 19:04:25,segienamKuning,800,633,125,120,136,75,140,76,4,1,True,0.16158552936751513
2025-01-07 19:04:25,lingkaranKuning,800,632,117,122,90,79,86,77,4,2,True,0.19221755291933698
2025-01-07 19:04:25,Fail to pick,801,632,0,0,0,0,0,0,0,0,False,0
2025-01-07 19:04:25,Fail to pick,800,633,0,0,0,0,0,0,0,0,False,0
2025-01-07 19:04:25,Fail to pick,800,632,0,0,0,0,0,0,0,0,False,0
2025-01-07 19:04:25,persegiKuning,822,622,113,125,126,17,122,18,4,1,True,0.34151709553412146
2025-01-07 19:04:25,lingkaranKuning,824,619,109,120,36,67,39,64,3,3,True,0.4253296516671189
2025-01-07 19:04:25,Fail to pick,824,619,0,0,0,0,0,0,0,0,False,0
2025-01-07 19:04:25,segienamKuning,822,623,117,121,147,18,142,21,5,3,True,0.16111511534218584
2025-01-07 19:04:25,lingkaranKuning,824,621,111,119,154,61,154,58,0,3,True,0.16027299162713504
2025-01-07 19:04:25,persegiKuning,822,623,117,120,6,19,6,16,0,3,True,0.1372679009109743
2025-01-07 19:04:25,Fail to pick,822,623,0,0,0,0,0,0,0,0,False,0
2025-01-07 19:04:25,Fail to pick,824,621,0,0,0,0,0,0,0,0,False,0
2025-01-07 19:04:25,Fail to pick,822,623,0,0,0,0,0,0,0,0,False,0
2025-01-07 19:04:26,persegiKuning,826,624,115,126,144,31,143,35,1,4,True,0.37686172602137047
2025-01-07 19:04:26,segienamKuning,824,625,116,128,180,82,182,78,2,4,True,0.46548848419263
2025-01-07 19:04:26,Fail to pick,826,624,0,0,0,0,0,0,0,0,False,0
2025-01-07 19:04:26,Fail to pick,824,625,0,0,0,0,0,0,0,0,False,0
2025-01-07 19:04:26,segienamKuning,801,620,117,133,26,37,23,32,3,5,True,0.2608210299489846
2025-01-07 19:04:26,persegiKuning,801,619,117,132,4,50,5,47,1,3,False,0.30197072498579847
2025-01-07 19:04:26,Fail to pick,801,619,0,0,0,0,0,0,0,0,False,0
2025-01-07 19:04:26,lingkaranKuning,818,627,113,122,85,41,82,41,3,0,True,0.30168382269578253
2025-01-07 19:04:26,segienamKuning,816,627,117,124,99,57,100,61,1,4,False,0.42338226744679097
2025-01-07 19:04:26,Kuning,818,627,tensor(113.8982),tensor(122.8217),25,75,20,76,5,1,True,0.0
2025-01-07 19:04:26,Fail to pick,816,627,0,0,0,0,0,0,0,0,False,0
2025-01-07 19:04:26,segienamKuning,828,631,121,123,122,95,126,91,4,4,True,0.3900107526729484
2025-01-07 19:04:26,segienamKuning,820,623,116,117,164,11,166,10,2,1,True,0.42715203231341115
2025-01-07 19:04:26,lingkaranKuning,822,623,113,119,45,46,46,44,1,2,True,0.21356821653972335
2025-01-07 19:04:26,Fail to pick,820,623,0,0,0,0,0,0,0,0,False,0
2025-01-07 19:04:26,Fail to pick,822,623,0,0,0,0,0,0,0,0,False,0
2025-01-07 19:04:26,lingkaranKuning,822,624,114,113,104,46,103,43,1,3,True,0.21854066789400137
2025-01-07 19:04:26,segienamKuning,821,624,118,111,80,52,80,54,0,2,True,0.1169862166257988
2025-01-07 19:04:26,Fail to pick,822,624,0,0,0,0,0,0,0,0,False,0
2025-01-07 19:04:26,Fail to pick,821,624,0,0,0,0,0,0,0,0,False,0
2025-01-07 19:04:26,lingkaranKuning,822,626,114,115,24,99,22,99,2,0,True,0.4212690404324734
2025-01-07 19:04:26,segienamKuning,820,627,121,113,104,39,101,35,3,4,True,0.16955640724643878
2025-01-07 19:04:26,Fail to pick,822,626,0,0,0,0,0,0,0,0,False,0
2025-01-07 19:04:26,Fail to pick,820,627,0,0,0,0,0,0,0,0,False,0
2025-01-07 19:04:26,lingkaranKuning,820,626,112,122,25,24,21,20,4,4,True,0.49486258193760657
2025-01-07 19:04:26,segienamKuning,819,624,114,117,36,98,31,98,5,0,True,0.17389432269971805
2025-01-07 19:04:26,persegiKuning,819,625,113,121,134,28,131,25,3,3,False,0.3088297716818447
2025-01-07 19:04:26,Fail to pick,820,626,0,0,0,0,0,0,0,0,False,0
2025-01-07 19:04:26,Fail to pick,819,624,0,0,0,0,0,0,0,0,False,0
2025-01-07 19:04:26,Fail to pick,819,625,0,0,0,0,0,0,0,0,False,0
2025-01-07 19:04:26,segienamKuning,820,627,125,118,149,13,152,13,3,0,True,0.2905502283085588
2025-01-07 19:04:26,lingkaranKuning,822,627,117,119,48,46,43,50,5,4,False,0.29171382455287165
2025-01-07 19:04:26,Fail to pick,820,627,0,0,0,0,0,0,0,0,False,0
2025-01-07 19:04:26,Fail to pick,822,627,0,0,0,0,0,0,0,0,False,0
2025-01-07 19:04:27,segienamKuning,814,626,119,114,173,5,175,8,2,3,True,0.2446685620648789
2025-01-07 19:04:27,lingkaranKuning,815,626,117,116,54,85,49,89,5,4,True,0.3877304792479024
2025-01-07 19:04:27,Fail to pick,814,626,0,0,0,0,0,0,0,0,False,0
2025-01-07 19:04:27,Fail to pick,815,626,0,0,0,0,0,0,0,0,False,0
2025-01-07 19:04:27,persegiKuning,813,623,116,116,36,69,34,71,2,2,True,0.2697831291074255
2025-01-07 19:04:27,lingkaranKuning,814,623,111,120,84,20,82,24,2,4,True,0.26354847195522446
2025-01-07 19:04:27,Fail to pick,813,623,0,0,0,0,0,0,0,0,False,0
2025-01-07 19:04:27,Fail to pick,814,623,0,0,0,0,0,0,0,0,False,0
2025-01-07 19:04:27,segienamKuning,830,630,121,113,149,48,146,52,3,4,True,0.3143736226850018
2025-01-07 19:04:27,lingkaranKuning,830,631,116,118,82,54,81,53,1,1,True,0.22299285286727116
2025-01-07 19:04:27,Kuning,830,630,tensor(121.0415),tensor(113.0314),25,76,27,71,2,5,True,0.0
2025-01-07 19:04:27,Fail to pick,830,631,0,0,0,0,0,0,0,0,False,0
2025-01-07 19:04:27,lingkaranKuning,802,633,114,115,9,77,5,79,4,2,True,0.1005130957539568
2025-01-07 19:04:27,lingkaranKuning,817,628,112,119,27,1,28,-4,1,5,True,0.384390200057695
2025-01-07 19:04:27,segienamKuning,815,629,115,116,198,19,194,17,4,2,True,0.406876582708507
2025-01-07 19:04:27,persegiKuning,816,628,116,114,111,8,112,12,1,4,True,0.38905564173309337
2025-01-07 19:04:27,Fail to pick,815,629,0,0,0,0,0,0,0,0,False,0
2025-01-07 19:04:27,Fail to pick,816,628,0,0,0,0,0,0,0,0,False,0
2025-01-07 19:04:27,lingkaranKuning,809,620,113,120,86,74,90,73,4,1,True,0.12961794130216014
2025-01-07 19:04:27,segienamKuning,809,621,115,119,38,30,36,32,2,2,True,0.2785372416943752
2025-01-07 19:04:27,persegiKuning,808,621,114,119,47,87,47,86,0,1,False,0.13433827745309945
2025-01-07 19:04:27,Fail to pick,809,620,0,0,0,0,0,0,0,0,False,0
2025-01-07 19:04:27,Fail to pick,809,621,0,0,0,0,0,0,0,0,False,0
2025-01-07 19:04:27,Fail to pick,808,621,0,0,0,0,0,0,0,0,False,0
2025-01-07 19:04:27,persegiKuning,808,623,117,113,117,71,118,66,1,5,True,0.32207667667554896
2025-01-07 19:04:27,lingkaranKuning,807,626,115,118,102,53,102,48,0,5,True,0.20962027704930297
2025-01-07 19:04:27,Fail to pick,808,623,0,0,0,0,0,0,0,0,False,0
2025-01-07 19:04:27,Fail to pick,807,626,0,0,0,0,0,0,0,0,False,0
2025-01-07 19:04:27,lingkaranKuning,811,622,112,115,193,52,193,54,0,2,True,0.4772052807823898
2025-01-07 19:04:27,segienamKuning,810,622,115,112,68,78,72,76,4,2,True,0.3111084545688695
2025-01-07 19:04:27,Fail to pick,811,622,0,0,0,0,0,0,0,0,False,0
2025-01-07 19:04:27,Fail to pick,810,622,0,0,0,0,0,0,0,0,False,0
2025-01-07 19:04:27,lingkaranKuning,806,626,113,119,50,44,46,45,4,1,True,0.34677233100665805
2025-01-07 19:04:27,persegiKuning,806,625,115,115,60,3,64,3,4,0,True,0.4718917952149535
2025-01-07 19:04:27,segienamKuning,805,625,115,117,13,1,15,0,2,1,False,0.163229795658262
2025-01-07 19:04:28,Fail to pick,806,626,0,0,0,0,0,0,0,0,False,0
2025-01-07 19:04:28,Fail to pick,806,625,0,0,0,0,0,0,0,0,False,0
2025-01-07 19:04:28,Fail to pick,805,625,0,0,0,0,0,0,0,0,False,0
2025-01-07 19:04:28,persegiKuning,808,621,112,112,121,8,118,9,3,1,True,0.2922969269397997
2025-01-07 19:04:28,lingkaranKuning,808,621,111,117,7,96,6,99,1,3,True,0.4514531237683266
2025-01-07 19:04:28,Fail to pick,808,621,0,0,0,0,0,0,0,0,False,0
2025-01-07 19:04:28,Fail to pick,808,621,0,0,0,0,0,0,0,0,False,0
2025-01-07 19:04:28,segienamKuning,811,623,119,114,150,36,148,35,2,1,True,0.47279138973816115
2025-01-07 19:04:28,Fail to pick,811,623,0,0,0,0,0,0,0,0,False,0
2025-01-07 19:04:28,persegiKuning,809,622,111,113,73,10,74,11,1,1,True,0.33343182312425146
2025-01-07 19:04:28,Kuning,809,622,tensor(111.4285),tensor(113.4250),27,74,30,78,3,4,True,0.0005056858062744141
2025-01-07 19:04:28,Fail to pick,809,622,0,0,0,0,0,0,0,0,False,0
2025-01-07 19:04:28,lingkaranKuning,806,624,117,117,117,66,113,66,4,0,True,0.2163169332603194
2025-01-07 19:04:28,segienamKuning,806,623,119,114,18,26,14,22,4,4,False,0.282142790308887
2025-01-07 19:04:28,Fail to pick,806,624,0,0,0,0,0,0,0,0,False,0
2025-01-07 19:04:28,Fail to pick,806,623,0,0,0,0,0,0,0,0,False,0
2025-01-07 19:04:28,segienamKuning,808,624,118,110,197,53,200,52,3,1,True,0.23535008703429297
2025-01-07 19:04:28,lingkaranKuning,810,624,114,112,184,82,184,85,0,3,True,0.2741622503412381
2025-01-07 19:04:28,Fail to pick,808,624,0,0,0,0,0,0,0,0,False,0
2025-01-07 19:04:28,Fail to pick,810,624,0,0,0,0,0,0,0,0,False,0
2025-01-07 19:04:28,lingkaranKuning,804,622,108,110,78,34,75,38,3,4,True,0.47355678821362013
2025-01-07 19:04:28,segienamKuning,805,621,110,107,153,67,156,63,3,4,False,0.4766696078171796
2025-01-07 19:04:28,Fail to pick,804,622,0,0,0,0,0,0,0,0,False,0
2025-01-07 19:04:28,Fail to pick,805,621,0,0,0,0,0,0,0,0,False,0
2025-01-07 19:04:28,lingkaranKuning,804,624,111,111,144,18,148,18,4,0,False,0.10342379537263874
2025-01-07 19:04:28,segienamKuning,805,624,115,109,109,53,104,48,5,5,True,0.3658331911602103
2025-01-07 19:04:28,Fail to pick,804,624,0,0,0,0,0,0,0,0,False,0
2025-01-07 19:04:28,Fail to pick,805,624,0,0,0,0,0,0,0,0,False,0
2025-01-07 19:04:28,segienamKuning,815,621,117,112,116,55,118,56,2,1,True,0.1834669241499407
2025-01-07 19:04:28,segienamKuning,818,622,117,112,56,39,60,41,4,2,True,0.3244442431707315
2025-01-07 19:04:28,Fail to pick,818,622,0,0,0,0,0,0,0,0,False,0
2025-01-07 19:04:29,persegiKuning,811,618,113,120,187,87,187,90,0,3,True,0.3321191486541624
2025-01-07 19:04:29,segienamKuning,811,619,112,122,177,77,180,79,3,2,True,0.2508462334518421
2025-01-07 19:04:29,Fail to pick,811,618,0,0,0,0,0,0,0,0,False,0
2025-01-07 19:04:29,Fail to pick,811,619,0,0,0,0,0,0,0,0,False,0
2025-01-07 19:04:29,segienamKuning,805,622,120,104,91,78,90,82,1,4,True,0.2839916642978151
2025-01-07 19:04:29,lingkaranKuning,807,622,116,108,62,83,65,82,3,1,True,0.34707679391560486
2025-01-07 19:04:29,Fail to pick,805,622,0,0,0,0,0,0,0,0,False,0
2025-01-07 19:04:29,Fail to pick,807,622,0,0,0,0,0,0,0,0,False,0
2025-01-07 19:04:44,segienamKuning,844,607,141,113,57,9,61,5,4,4,True,0.26216092896468646
2025-01-07 19:04:44,Kuning,844,607,tensor(141.6206),tensor(113.1177),31,78,32,75,1,3,True,0.0
2025-01-07 19:04:44,segienamKuning,806,614,168,126,74,18,76,19,2,1,False,0.45868766679287865
2025-01-07 19:04:46,segienamKuning,766,622,139,109,90,2,89,3,1,1,True,0.40757372899817024
2025-01-07 19:04:46,Kuning,766,622,tensor(139.6653),tensor(109.8331),27,70,27,69,0,1,True,0.0
2025-01-07 19:04:46,segienamKuning,771,621,142,109,148,50,151,51,3,1,True,0.15679439422948588
2025-01-07 19:04:46,Fail to pick,771,621,0,0,0,0,0,0,0,0,False,0
2025-01-07 19:04:46,segienamKuning,786,622,144,107,9,51,6,50,3,1,True,0.4846348029277804
2025-01-07 19:04:46,segienamKuning,788,624,148,104,132,17,128,12,4,5,True,0.2560262231526059
2025-01-07 19:04:46,Fail to pick,788,624,0,0,0,0,0,0,0,0,False,0
2025-01-07 19:04:46,segienamKuning,792,629,145,108,193,53,190,56,3,3,True,0.16279817274804814
2025-01-07 19:04:46,Fail to pick,792,629,0,0,0,0,0,0,0,0,False,0
2025-01-07 19:04:46,segienamKuning,796,630,141,111,40,76,41,80,1,4,True,0.10804927664763837
2025-01-07 19:04:46,Fail to pick,796,630,0,0,0,0,0,0,0,0,False,0
2025-01-07 19:04:47,segienamKuning,793,630,141,105,104,36,102,40,2,4,True,0.40065280325548946
2025-01-07 19:04:47,Fail to pick,793,630,0,0,0,0,0,0,0,0,False,0
2025-01-07 19:04:47,segienamKuning,802,636,141,106,104,77,107,74,3,3,True,0.40676719693482877
2025-01-07 19:04:47,Fail to pick,802,636,0,0,0,0,0,0,0,0,False,0
2025-01-07 19:04:47,segienamKuning,804,631,132,101,43,28,38,32,5,4,True,0.3442836917573736
2025-01-07 19:04:47,Kuning,804,631,tensor(132.6248),tensor(101.3314),24,74,23,71,1,3,True,0.0
2025-01-07 19:04:47,Fail to pick,804,631,0,0,0,0,0,0,0,0,False,0
2025-01-07 19:04:47,segienamKuning,803,632,134,100,93,61,89,59,4,2,True,0.424297032489921
2025-01-07 19:04:47,Fail to pick,803,632,0,0,0,0,0,0,0,0,False,0
2025-01-07 19:04:47,segienamKuning,799,628,139,104,130,77,130,76,0,1,True,0.23972238505964
2025-01-07 19:04:47,Fail to pick,799,628,0,0,0,0,0,0,0,0,False,0
2025-01-07 19:04:47,segienamKuning,801,634,138,101,88,25,91,20,3,5,True,0.15053376758408823
2025-01-07 19:04:47,Fail to pick,801,634,0,0,0,0,0,0,0,0,False,0
2025-01-07 19:04:47,segienamKuning,802,631,138,101,77,1,80,-2,3,3,True,0.4603898966679948
2025-01-07 19:04:47,Fail to pick,802,631,0,0,0,0,0,0,0,0,False,0
2025-01-07 19:04:47,segienamKuning,794,638,135,100,48,20,49,21,1,1,True,0.4167614067267086
2025-01-07 19:04:47,Fail to pick,794,638,0,0,0,0,0,0,0,0,False,0
2025-01-07 19:04:47,segienamKuning,811,631,140,105,17,90,20,90,3,0,True,0.3095874828757835
2025-01-07 19:04:48,segienamKuning,803,633,144,105,25,51,23,55,2,4,True,0.21613647580610387
2025-01-07 19:04:48,Fail to pick,803,633,0,0,0,0,0,0,0,0,False,0
2025-01-07 19:04:48,segienamKuning,797,633,137,102,187,34,184,36,3,2,True,0.17496498063028276
2025-01-07 19:04:48,Fail to pick,797,633,0,0,0,0,0,0,0,0,False,0
2025-01-07 19:04:48,segienamKuning,806,635,134,102,71,39,70,38,1,1,False,0.49369646761432595
2025-01-07 19:04:48,Fail to pick,806,635,0,0,0,0,0,0,0,0,False,0
2025-01-07 19:04:48,segienamKuning,800,633,134,100,69,11,66,7,3,4,True,0.36123818686450504
2025-01-07 19:04:48,Kuning,800,633,tensor(134.2314),tensor(100.4398),24,74,25,78,1,4,True,2.5033950805664062e-05
2025-01-07 19:04:48,Fail to pick,800,633,0,0,0,0,0,0,0,0,False,0
2025-01-07 19:04:48,segienamKuning,802,635,133,104,40,44,35,45,5,1,True,0.3673516529876454
2025-01-07 19:04:48,Fail to pick,802,635,0,0,0,0,0,0,0,0,False,0
2025-01-07 19:04:48,segienamKuning,802,635,133,104,179,60,180,59,1,1,True,0.46734795660585426
2025-01-07 19:04:48,Fail to pick,802,635,0,0,0,0,0,0,0,0,False,0
2025-01-07 19:04:48,segienamKuning,808,635,138,103,54,77,57,72,3,5,True,0.4766886009902648
2025-01-07 19:04:48,Fail to pick,808,635,0,0,0,0,0,0,0,0,False,0
2025-01-07 19:04:48,segienamKuning,809,631,140,103,182,23,185,24,3,1,True,0.25068686372698845
2025-01-07 19:04:48,Fail to pick,809,631,0,0,0,0,0,0,0,0,False,0
2025-01-07 19:04:48,segienamKuning,805,629,138,101,108,62,104,60,4,2,True,0.18702730600401174
2025-01-07 19:04:48,Fail to pick,805,629,0,0,0,0,0,0,0,0,False,0
2025-01-07 19:04:49,segienamKuning,812,628,139,106,32,4,35,-1,3,5,False,0.12110352751569456
2025-01-07 19:04:49,Fail to pick,812,628,0,0,0,0,0,0,0,0,False,0
2025-01-07 19:04:49,segienamKuning,811,637,136,102,41,24,45,28,4,4,False,0.19915578768175474
2025-01-07 19:04:49,Fail to pick,811,637,0,0,0,0,0,0,0,0,False,0
2025-01-07 19:04:49,segienamKuning,803,637,135,104,160,20,164,21,4,1,True,0.1978152324254414
2025-01-07 19:04:49,Fail to pick,803,637,0,0,0,0,0,0,0,0,False,0
2025-01-07 19:04:49,segienamKuning,808,634,139,101,121,36,117,40,4,4,False,0.31587458659853135
2025-01-07 19:04:49,Kuning,808,634,tensor(139.6724),tensor(101.3794),23,74,19,72,4,2,True,0.0
2025-01-07 19:04:49,Fail to pick,808,634,0,0,0,0,0,0,0,0,False,0
2025-01-07 19:04:49,segienamKuning,805,633,133,105,72,41,76,44,4,3,True,0.21171516575157825
2025-01-07 19:04:49,Fail to pick,805,633,0,0,0,0,0,0,0,0,False,0
2025-01-07 19:04:49,segienamKuning,806,634,132,104,133,29,133,26,0,3,True,0.1643016335053619
2025-01-07 19:04:49,Fail to pick,806,634,0,0,0,0,0,0,0,0,False,0
2025-01-07 19:04:49,segienamKuning,802,632,136,101,44,9,41,4,3,5,True,0.3744749050056023
2025-01-07 19:04:49,Fail to pick,802,632,0,0,0,0,0,0,0,0,False,0
2025-01-07 19:04:49,segienamKuning,802,633,136,105,58,99,58,102,0,3,True,0.49422610741413076
2025-01-07 19:04:49,Fail to pick,802,633,0,0,0,0,0,0,0,0,False,0
2025-01-07 19:04:50,segienamKuning,805,633,138,103,88,82,92,78,4,4,True,0.14854532869463186
2025-01-07 19:04:50,Fail to pick,805,633,0,0,0,0,0,0,0,0,False,0
2025-01-07 19:04:50,segienamKuning,802,637,135,106,8,3,12,6,4,3,True,0.3366580290356549
2025-01-07 19:04:50,Fail to pick,802,637,0,0,0,0,0,0,0,0,False,0
2025-01-07 19:04:50,segienamKuning,796,633,129,101,174,48,171,45,3,3,True,0.4109272946473509
2025-01-07 19:04:50,Fail to pick,796,633,0,0,0,0,0,0,0,0,False,0
2025-01-07 19:04:50,segienamKuning,799,632,135,102,83,71,84,72,1,1,True,0.16580562716699865
2025-01-07 19:04:50,Fail to pick,799,632,0,0,0,0,0,0,0,0,False,0
2025-01-07 19:04:50,segienamKuning,799,634,134,100,79,93,76,91,3,2,True,0.3983017620156971
2025-01-07 19:04:50,Kuning,799,634,tensor(134.3593),tensor(100.8687),23,73,25,69,2,4,True,0.0
2025-01-07 19:04:50,Fail to pick,799,634,0,0,0,0,0,0,0,0,False,0
2025-01-07 19:04:50,segienamKuning,801,631,136,103,74,90,69,87,5,3,True,0.4618970914652346
2025-01-07 19:04:50,Fail to pick,801,631,0,0,0,0,0,0,0,0,False,0
2025-01-07 19:04:50,segienamKuning,804,630,134,102,85,32,88,36,3,4,True,0.31791474287354604
2025-01-07 19:04:50,lingkaranKuning,798,631,118,105,91,50,86,49,5,1,True,0.2756470026239782
2025-01-07 19:04:50,Fail to pick,804,630,0,0,0,0,0,0,0,0,False,0
2025-01-07 19:04:50,Fail to pick,798,631,0,0,0,0,0,0,0,0,False,0
2025-01-07 19:04:50,segienamKuning,805,633,138,102,24,18,25,17,1,1,True,0.1845319065313388
2025-01-07 19:04:50,Fail to pick,805,633,0,0,0,0,0,0,0,0,False,0
2025-01-07 19:04:50,segienamKuning,803,637,139,104,133,31,130,27,3,4,True,0.44231309818421927
2025-01-07 19:04:50,Fail to pick,803,637,0,0,0,0,0,0,0,0,False,0
2025-01-07 19:04:51,segienamKuning,800,631,136,100,148,44,149,41,1,3,True,0.35940264009782386
2025-01-07 19:04:51,Fail to pick,800,631,0,0,0,0,0,0,0,0,False,0
2025-01-07 19:04:51,segienamKuning,800,634,135,99,137,68,141,71,4,3,True,0.32999487240753533
2025-01-07 19:04:51,Fail to pick,800,634,0,0,0,0,0,0,0,0,False,0
2025-01-07 19:04:51,segienamKuning,804,635,139,100,170,78,174,81,4,3,False,0.12096180433353397
2025-01-07 19:04:51,Fail to pick,804,635,0,0,0,0,0,0,0,0,False,0
2025-01-07 19:04:51,segienamKuning,805,631,140,104,6,29,4,29,2,0,True,0.10323232359509503
2025-01-07 19:04:51,Fail to pick,805,631,0,0,0,0,0,0,0,0,False,0
2025-01-07 19:04:51,segienamKuning,811,633,137,103,40,8,37,11,3,3,True,0.167753894698122
2025-01-07 19:04:51,Kuning,811,633,tensor(137.5973),tensor(103.1573),24,75,25,78,1,3,True,0.0
2025-01-07 19:04:51,Fail to pick,811,633,0,0,0,0,0,0,0,0,False,0
2025-01-07 19:04:51,segienamKuning,808,631,142,102,27,58,22,62,5,4,True,0.410668591909079
2025-01-07 19:04:51,Fail to pick,808,631,0,0,0,0,0,0,0,0,False,0
2025-01-07 19:04:51,segienamKuning,801,633,136,107,14,69,15,70,1,1,True,0.13889408528546704
2025-01-07 19:04:51,Fail to pick,801,633,0,0,0,0,0,0,0,0,False,0
2025-01-07 19:04:51,segienamKuning,801,633,136,107,134,65,130,68,4,3,True,0.40404232603940327
2025-01-07 19:04:51,Fail to pick,801,633,0,0,0,0,0,0,0,0,False,0
2025-01-07 19:04:52,segienamKuning,804,633,136,101,126,84,123,82,3,2,True,0.41725276212817
2025-01-07 19:04:52,Fail to pick,804,633,0,0,0,0,0,0,0,0,False,0
2025-01-07 19:04:52,segienamKuning,803,637,132,103,173,39,174,37,1,2,True,0.1925991576171077
2025-01-07 19:04:52,Fail to pick,803,637,0,0,0,0,0,0,0,0,False,0
2025-01-07 19:04:52,segienamKuning,808,640,135,113,152,59,151,61,1,2,False,0.16981863994434848
2025-01-07 19:04:52,Fail to pick,808,640,0,0,0,0,0,0,0,0,False,0
2025-01-07 19:04:52,segienamKuning,817,636,134,109,111,56,110,54,1,2,False,0.23500200302963023
2025-01-07 19:04:52,Fail to pick,817,636,0,0,0,0,0,0,0,0,False,0
2025-01-07 19:04:52,segienamKuning,824,639,143,118,74,84,72,80,2,4,False,0.25071196001747653
2025-01-07 19:04:52,Fail to pick,824,639,0,0,0,0,0,0,0,0,False,0
2025-01-07 19:04:52,segienamKuning,841,630,140,114,89,76,89,76,0,0,True,0.17035934887182697
2025-01-07 19:04:52,segienamKuning,835,634,138,111,188,32,185,29,3,3,True,0.3198947697007485
2025-01-07 19:04:52,Kuning,835,634,tensor(138.9182),tensor(111.9310),23,77,21,80,2,3,True,0.0
2025-01-07 19:04:52,Fail to pick,835,634,0,0,0,0,0,0,0,0,False,0
2025-01-07 19:04:52,segienamKuning,800,633,140,104,184,54,188,58,4,4,True,0.46438721841396824
2025-01-07 19:04:52,segienamKuning,807,632,134,103,98,51,99,51,1,0,True,0.2332520829345456
2025-01-07 19:04:52,Fail to pick,807,632,0,0,0,0,0,0,0,0,False,0
2025-01-07 19:04:52,segienamKuning,803,631,133,101,69,18,68,19,1,1,True,0.10588421521953256
2025-01-07 19:04:52,Fail to pick,803,631,0,0,0,0,0,0,0,0,False,0
2025-01-07 19:04:53,segienamKuning,802,633,136,100,158,83,161,79,3,4,True,0.1423897896700288
2025-01-07 19:04:53,Fail to pick,802,633,0,0,0,0,0,0,0,0,False,0
2025-01-07 19:04:53,segienamKuning,801,635,135,103,79,17,83,21,4,4,True,0.47888592951610054
2025-01-07 19:04:53,Fail to pick,801,635,0,0,0,0,0,0,0,0,False,0
2025-01-07 19:04:53,segienamKuning,816,634,141,105,106,93,103,92,3,1,True,0.2797747955859443
2025-01-07 19:04:53,segienamKuning,826,629,135,113,40,66,40,63,0,3,True,0.4591182843514613
2025-01-07 19:04:53,segienamKuning,814,634,140,109,6,48,2,43,4,5,True,0.22487732583032952
2025-01-07 19:04:53,segienamKuning,807,637,141,108,168,61,169,62,1,1,True,0.106268170253755
2025-01-07 19:04:53,Kuning,807,637,tensor(141.3270),tensor(108.4128),23,74,24,71,1,3,True,0.0
2025-01-07 19:04:53,Fail to pick,807,637,0,0,0,0,0,0,0,0,False,0
2025-01-07 19:04:53,segienamKuning,834,634,141,107,146,81,148,81,2,0,True,0.37335593251025745
2025-01-07 19:04:53,segienamKuning,820,641,139,113,151,96,147,95,4,1,True,0.4216480665493414
2025-01-07 19:04:54,segienamKuning,821,635,142,115,73,32,70,30,3,2,True,0.2151235537503264
2025-01-07 19:04:54,Fail to pick,821,635,0,0,0,0,0,0,0,0,False,0
2025-01-07 19:04:54,segienamKuning,840,631,143,116,177,97,176,94,1,3,True,0.22433311701310493
2025-01-07 19:04:54,segienamKuning,827,636,137,108,150,83,153,87,3,4,True,0.2482722395336177
2025-01-07 19:04:54,segienamKuning,821,638,139,108,113,85,112,83,1,2,True,0.21245883991976633
2025-01-07 19:04:54,Fail to pick,821,638,0,0,0,0,0,0,0,0,False,0
2025-01-07 19:04:54,segienamKuning,832,634,132,113,139,81,141,80,2,1,True,0.14465257100899598
2025-01-07 19:04:54,segienamKuning,822,636,132,114,120,3,123,6,3,3,True,0.44567675647152394
2025-01-07 19:04:54,segienamKuning,838,635,139,118,146,8,142,5,4,3,False,0.38546448295702096
2025-01-07 19:04:54,segienamKuning,820,641,135,111,140,10,139,6,1,4,True,0.10020851406085277
2025-01-07 19:04:54,Kuning,820,641,tensor(135.8032),tensor(111.2291),21,75,16,70,5,5,True,0.0
2025-01-07 19:04:54,segienamKuning,846,639,141,113,75,55,75,52,0,3,True,0.20028567240471773
2025-01-07 19:04:55,segienamKuning,841,644,141,115,162,54,162,54,0,0,True,0.28534266897756666
2025-01-07 19:04:55,Fail to pick,841,644,0,0,0,0,0,0,0,0,False,0
2025-01-07 19:04:55,segienamKuning,832,650,132,113,16,29,20,28,4,1,True,0.1640649133919878
2025-01-07 19:04:55,Fail to pick,832,650,0,0,0,0,0,0,0,0,False,0
2025-01-07 19:04:55,segienamKuning,775,632,136,106,37,13,40,17,3,4,True,0.39094902427116585
2025-01-07 19:04:55,segienamKuning,841,638,143,111,151,84,155,81,4,3,True,0.10596140736593154
2025-01-07 19:04:55,Kuning,841,638,tensor(143.1414),tensor(111.5894),22,77,18,73,4,4,True,0.0
2025-01-07 19:04:56,segienamKuning,834,633,133,109,11,3,7,-1,4,4,False,0.38671521866729464
2025-01-07 19:04:56,Fail to pick,834,633,0,0,0,0,0,0,0,0,False,0
2025-01-07 19:04:56,segienamKuning,812,639,134,111,122,35,118,39,4,4,True,0.3699826803677836
2025-01-07 19:04:56,segienamKuning,837,630,136,113,173,81,170,83,3,2,True,0.19552738502294975
2025-01-07 19:04:56,segienamKuning,830,628,130,112,164,36,159,39,5,3,True,0.18102218104387635
2025-01-07 19:04:56,Fail to pick,830,628,0,0,0,0,0,0,0,0,False,0
2025-01-07 19:04:57,segienamKuning,820,634,137,108,88,59,83,55,5,4,True,0.33826496070597245
2025-01-07 19:04:57,Kuning,820,634,tensor(137.4737),tensor(108.0274),23,75,21,77,2,2,True,0.0
2025-01-07 19:04:57,segienamKuning,826,639,132,111,45,40,41,37,4,3,True,0.12050715510804261
2025-01-07 19:04:57,Fail to pick,826,639,0,0,0,0,0,0,0,0,False,0
2025-01-07 19:04:57,segienamKuning,822,636,137,109,131,10,127,8,4,2,True,0.33222609771977063
2025-01-07 19:04:57,Fail to pick,822,636,0,0,0,0,0,0,0,0,False,0
2025-01-07 19:04:57,segienamKuning,846,629,137,107,61,18,63,21,2,3,True,0.109565736234691
2025-01-07 19:04:57,segienamKuning,811,636,132,110,151,25,153,21,2,4,True,0.2983481426494289
2025-01-07 19:04:58,segienamKuning,843,638,138,110,31,39,34,40,3,1,True,0.1892423928543937
2025-01-07 19:04:58,Kuning,843,638,tensor(138.4259),tensor(110.3973),22,78,19,75,3,3,True,0.0005009174346923828
2025-01-07 19:04:58,segienamKuning,839,636,134,109,178,24,177,25,1,1,True,0.2408458894263248
2025-01-07 19:04:58,Fail to pick,839,636,0,0,0,0,0,0,0,0,False,0
2025-01-07 19:04:58,segienamKuning,822,638,132,111,86,11,82,7,4,4,True,0.4201424529947718
2025-01-07 19:04:58,segienamKuning,824,637,136,112,13,98,15,95,2,3,True,0.20669755768433778
2025-01-07 19:04:58,Fail to pick,824,637,0,0,0,0,0,0,0,0,False,0
2025-01-07 19:04:58,segienamKuning,807,638,126,109,168,11,165,12,3,1,True,0.132160227247601
2025-01-07 19:04:59,segienamKuning,831,632,140,112,80,0,83,4,3,4,True,0.4923187303568082
2025-01-07 19:04:59,Kuning,831,632,tensor(140.9232),tensor(112.0298),24,76,21,74,3,2,True,0.0
2025-01-07 19:04:59,segienamKuning,810,641,139,106,134,13,136,17,2,4,True,0.383691294133241
2025-01-07 19:05:00,segienamKuning,811,634,135,108,148,1,145,2,3,1,False,0.4144492223899334
2025-01-07 19:05:00,Fail to pick,811,634,0,0,0,0,0,0,0,0,False,0
2025-01-07 19:05:00,segienamKuning,811,642,135,107,47,7,47,6,0,1,True,0.3031292814920783
2025-01-07 19:05:00,Kuning,811,642,tensor(135.0198),tensor(107.9796),21,75,17,77,4,2,True,0.0004992485046386719
2025-01-07 19:05:00,Fail to pick,811,642,0,0,0,0,0,0,0,0,False,0
2025-01-07 19:05:00,segienamKuning,808,637,137,104,193,92,193,90,0,2,True,0.25186453862466496
2025-01-07 19:05:00,Fail to pick,808,637,0,0,0,0,0,0,0,0,False,0
2025-01-07 19:05:00,segienamKuning,818,637,139,108,14,39,17,38,3,1,True,0.11754053227757577
2025-01-07 19:05:00,segienamKuning,810,640,134,104,48,1,43,2,5,1,True,0.3798360185982538
2025-01-07 19:05:00,Fail to pick,810,640,0,0,0,0,0,0,0,0,False,0
2025-01-07 19:05:01,segienamKuning,798,640,137,97,130,25,134,27,4,2,True,0.10647444309508401
2025-01-07 19:05:01,segienamKuning,797,638,131,99,146,25,147,22,1,3,True,0.21967206012680995
2025-01-07 19:05:01,Kuning,797,638,tensor(131.2421),tensor(99.0909),22,73,23,75,1,2,True,0.0004992485046386719
2025-01-07 19:05:01,Fail to pick,797,638,0,0,0,0,0,0,0,0,False,0
2025-01-07 19:05:01,segienamKuning,805,636,143,97,6,88,10,85,4,3,True,0.3867243337424773
2025-01-07 19:05:01,Fail to pick,805,636,0,0,0,0,0,0,0,0,False,0
2025-01-07 19:05:01,segienamKuning,803,637,138,101,17,2,20,5,3,3,True,0.32075246132109014
2025-01-07 19:05:01,Fail to pick,803,637,0,0,0,0,0,0,0,0,False,0
2025-01-07 19:05:01,segienamKuning,818,631,143,102,60,65,58,62,2,3,True,0.4438554006779972
2025-01-07 19:05:02,segienamKuning,802,636,145,104,3,89,6,85,3,4,True,0.4855695242014967
2025-01-07 19:05:02,segienamKuning,808,634,137,100,8,31,9,28,1,3,True,0.10762955386179773
2025-01-07 19:05:02,Kuning,808,634,tensor(137.0912),tensor(100.0244),23,74,24,73,1,1,True,0.0
2025-01-07 19:05:02,Fail to pick,808,634,0,0,0,0,0,0,0,0,False,0
2025-01-07 19:05:02,segienamKuning,799,634,131,103,14,94,9,92,5,2,False,0.2223926300986151
2025-01-07 19:05:02,Fail to pick,799,634,0,0,0,0,0,0,0,0,False,0
2025-01-07 19:05:02,segienamKuning,803,636,138,97,0,13,2,10,2,3,True,0.272076243410577
2025-01-07 19:05:02,Fail to pick,803,636,0,0,0,0,0,0,0,0,False,0
2025-01-07 19:05:03,segienamKuning,806,634,136,100,123,98,123,96,0,2,True,0.18252757920067522
2025-01-07 19:05:03,Fail to pick,806,634,0,0,0,0,0,0,0,0,False,0
2025-01-07 19:05:03,segienamKuning,801,636,138,101,183,49,180,44,3,5,True,0.1258526372263892
2025-01-07 19:05:03,Fail to pick,801,636,0,0,0,0,0,0,0,0,False,0
2025-01-07 19:05:03,segienamKuning,796,638,136,100,87,48,84,47,3,1,True,0.28031892145586534
2025-01-07 19:05:03,Kuning,796,638,tensor(136.2557),tensor(100.3886),22,73,17,69,5,4,True,0.0004978179931640625
2025-01-07 19:05:03,Fail to pick,796,638,0,0,0,0,0,0,0,0,False,0
2025-01-07 19:05:03,segienamKuning,816,630,141,104,171,68,170,70,1,2,True,0.16262900640763545
2025-01-07 19:05:04,segienamKuning,822,630,138,107,55,92,54,95,1,3,True,0.2506707624115647
2025-01-07 19:05:04,Fail to pick,822,630,0,0,0,0,0,0,0,0,False,0
2025-01-07 19:05:04,segienamKuning,818,628,124,104,189,97,191,97,2,0,True,0.10972564285495201
2025-01-07 19:05:04,Fail to pick,818,628,0,0,0,0,0,0,0,0,False,0
2025-01-07 19:05:04,segienamKuning,810,632,140,105,170,54,166,52,4,2,True,0.4926994440090673
2025-01-07 19:05:04,Fail to pick,810,632,0,0,0,0,0,0,0,0,False,0
2025-01-07 19:05:04,segienamKuning,815,627,135,104,186,8,190,6,4,2,True,0.46302838000318713
2025-01-07 19:05:04,Fail to pick,815,627,0,0,0,0,0,0,0,0,False,0
2025-01-07 19:05:05,segienamKuning,828,628,135,104,17,19,19,15,2,4,True,0.2958094042876608
2025-01-07 19:05:05,Kuning,828,628,tensor(135.4346),tensor(104.9243),25,76,26,74,1,2,True,0.000499725341796875
2025-01-07 19:05:05,segienamKuning,828,626,135,107,143,97,142,97,1,0,True,0.2144442314133336
2025-01-07 19:05:05,Fail to pick,828,626,0,0,0,0,0,0,0,0,False,0
2025-01-07 19:05:05,segienamKuning,834,628,140,103,173,93,169,89,4,4,True,0.3885995247374163
2025-01-07 19:05:05,Fail to pick,834,628,0,0,0,0,0,0,0,0,False,0
2025-01-07 19:05:05,segienamKuning,840,614,139,103,125,30,121,33,4,3,True,0.16440168356889723
2025-01-07 19:05:05,segienamKuning,837,623,140,110,102,22,99,23,3,1,True,0.33646649074847645
2025-01-07 19:05:06,Fail to pick,837,623,0,0,0,0,0,0,0,0,False,0
2025-01-07 19:05:06,segienamKuning,853,619,135,108,66,67,68,67,2,0,True,0.2185341496155485
2025-01-07 19:05:06,Kuning,853,619,tensor(135.4938),tensor(108.7958),28,78,26,80,2,2,True,0.0005223751068115234
2025-01-07 19:05:06,segienamKuning,834,629,136,111,116,90,114,86,2,4,True,0.4766290072651481
2025-01-07 19:05:06,segienamKuning,831,630,135,110,87,68,90,64,3,4,True,0.42545586390753853
2025-01-07 19:05:06,Fail to pick,831,630,0,0,0,0,0,0,0,0,False,0
2025-01-07 19:05:06,segienamKuning,837,622,138,113,130,75,132,75,2,0,True,0.13072462740304083
2025-01-07 19:05:06,Fail to pick,837,622,0,0,0,0,0,0,0,0,False,0
2025-01-07 19:05:07,segienamKuning,831,639,137,115,152,57,152,57,0,0,True,0.4112642216583673
2025-01-07 19:05:07,segienamKuning,850,617,140,107,12,3,11,0,1,3,True,0.15339137280374301
2025-01-07 19:05:07,segienamKuning,847,614,139,103,54,71,50,72,4,1,True,0.10532063496882285
2025-01-07 19:05:07,Kuning,847,614,tensor(139.1545),tensor(103.6047),29,78,24,78,5,0,True,0.0004985332489013672
2025-01-07 19:05:07,Fail to pick,847,614,0,0,0,0,0,0,0,0,False,0
2025-01-07 19:05:07,segienamKuning,852,621,140,110,191,3,189,1,2,2,False,0.18176032439064468
2025-01-07 19:05:07,Fail to pick,852,621,0,0,0,0,0,0,0,0,False,0
2025-01-07 19:05:08,segienamKuning,858,623,137,109,29,63,24,60,5,3,True,0.16914856165999903
2025-01-07 19:05:08,Fail to pick,858,623,0,0,0,0,0,0,0,0,False,0
2025-01-07 19:05:08,segienamKuning,853,616,134,105,170,79,168,80,2,1,True,0.2191691403217905
2025-01-07 19:05:08,Fail to pick,853,616,0,0,0,0,0,0,0,0,False,0
2025-01-07 19:05:08,segienamKuning,822,627,136,108,71,64,67,65,4,1,True,0.16363098121666014
2025-01-07 19:05:08,segienamKuning,809,626,137,112,3,36,1,31,2,5,True,0.3841659695929944
2025-01-07 19:05:08,Kuning,809,626,tensor(137.4342),tensor(112.3511),26,74,23,76,3,2,True,0.0
2025-01-07 19:05:09,segienamKuning,810,630,140,104,72,59,68,63,4,4,True,0.4413889729512235
2025-01-07 19:05:09,Fail to pick,810,630,0,0,0,0,0,0,0,0,False,0
2025-01-07 19:05:09,segienamKuning,820,624,123,100,197,52,192,49,5,3,True,0.12967956915791815
2025-01-07 19:05:09,segienamKuning,831,623,130,107,2,16,-2,15,4,1,True,0.48361167353129075
2025-01-07 19:05:09,segienamKuning,824,623,131,111,23,89,24,92,1,3,True,0.15233102880319405
2025-01-07 19:05:09,Fail to pick,824,623,0,0,0,0,0,0,0,0,False,0
2025-01-07 19:05:09,segienamKuning,835,624,141,110,121,26,122,28,1,2,True,0.255958890896131
2025-01-07 19:05:09,Kuning,835,624,tensor(141.6068),tensor(110.6363),26,77,24,77,2,0,True,0.0005004405975341797
2025-01-07 19:05:10,segienamKuning,820,630,139,107,113,77,113,80,0,3,True,0.2796824697727679
2025-01-07 19:05:10,segienamKuning,831,625,139,108,196,59,199,62,3,3,True,0.3716300513372357
2025-01-07 19:05:10,segienamKuning,816,629,137,102,105,59,107,62,2,3,False,0.2021875507473721
2025-01-07 19:05:10,segienamKuning,814,630,135,104,2,4,3,8,1,4,True,0.10895693638017563
2025-01-07 19:05:10,Fail to pick,814,630,0,0,0,0,0,0,0,0,False,0
2025-01-07 19:05:11,segienamKuning,819,631,140,106,22,48,20,52,2,4,True,0.13745553722466664
2025-01-07 19:05:11,Kuning,819,631,tensor(140.0256),tensor(106.1297),24,75,23,79,1,4,True,0.000499725341796875
2025-01-07 19:05:11,Fail to pick,819,631,0,0,0,0,0,0,0,0,False,0
2025-01-07 19:05:11,segienamKuning,822,629,132,118,153,94,148,97,5,3,True,0.2813706490798037
2025-01-07 19:05:11,Fail to pick,822,629,0,0,0,0,0,0,0,0,False,0
2025-01-07 19:10:01,segienamKuning,767,598,138,119,118,78,119,81,1,3,True,0.347965431024899
2025-01-07 19:10:01,Kuning,767,598,tensor(138.2289),tensor(119.1490),33,71,37,69,4,2,True,0.0006022453308105469
2025-01-07 19:10:01,persegiKuning,790,604,116,122,156,90,159,92,3,2,True,0.34897829780600464
2025-01-07 19:10:01,segienamKuning,782,604,136,130,171,86,167,87,4,1,True,0.17187890692805874
2025-01-07 19:10:01,Fail to pick,782,604,0,0,0,0,0,0,0,0,False,0
2025-01-07 19:10:02,persegiKuning,762,594,137,139,199,64,202,64,3,0,False,0.1956650676032942
2025-01-07 19:10:02,segienamKuning,765,596,126,127,108,85,103,83,5,2,True,0.486253683735666
2025-01-07 19:10:02,Fail to pick,765,596,0,0,0,0,0,0,0,0,False,0
2025-01-07 19:10:02,segienamKuning,765,596,126,127,154,41,156,45,2,4,True,0.2961289492443869
2025-01-07 19:10:02,Fail to pick,765,596,0,0,0,0,0,0,0,0,False,0
2025-01-07 19:10:02,segienamKuning,778,604,125,117,118,32,117,30,1,2,True,0.12110223223032045
2025-01-07 19:10:02,segienamKuning,775,603,122,123,77,90,75,89,2,1,True,0.3416128324187107
2025-01-07 19:10:02,Fail to pick,775,603,0,0,0,0,0,0,0,0,False,0
2025-01-07 19:10:02,segienamKuning,772,601,127,127,59,20,60,18,1,2,True,0.3004338595754319
2025-01-07 19:10:02,Fail to pick,772,601,0,0,0,0,0,0,0,0,False,0
2025-01-07 19:10:02,persegiKuning,752,596,121,127,175,19,175,19,0,0,True,0.2957335020385473
2025-01-07 19:10:02,segienamKuning,751,596,121,127,55,91,53,93,2,2,True,0.22005662615555943
2025-01-07 19:10:02,Fail to pick,751,596,0,0,0,0,0,0,0,0,False,0
2025-01-07 19:10:03,segienamKuning,772,608,119,122,6,27,2,27,4,0,True,0.42180056714483016
2025-01-07 19:10:03,Kuning,772,608,tensor(119.9628),tensor(122.8241),31,71,31,73,0,2,True,0.0
2025-01-07 19:10:03,lingkaranKuning,778,602,116,123,45,64,48,59,3,5,False,0.4120828174954224
2025-01-07 19:10:03,segienamKuning,778,601,118,120,169,74,173,76,4,2,True,0.4100552013203792
2025-01-07 19:10:03,persegiKuning,777,603,117,123,105,46,109,48,4,2,True,0.48144104400298005
2025-01-07 19:10:03,Fail to pick,778,602,0,0,0,0,0,0,0,0,False,0
2025-01-07 19:10:03,Fail to pick,778,601,0,0,0,0,0,0,0,0,False,0
2025-01-07 19:10:03,Fail to pick,777,603,0,0,0,0,0,0,0,0,False,0
2025-01-07 19:10:03,segienamKuning,783,605,117,112,46,42,46,40,0,2,True,0.10298079044082167
2025-01-07 19:10:03,lingkaranKuning,784,606,116,118,53,41,48,41,5,0,True,0.21034369301570488
2025-01-07 19:10:03,Fail to pick,783,605,0,0,0,0,0,0,0,0,False,0
2025-01-07 19:10:03,Fail to pick,784,606,0,0,0,0,0,0,0,0,False,0
2025-01-07 19:10:03,segienamKuning,760,597,142,131,24,94,22,89,2,5,True,0.1059529484092277
2025-01-07 19:10:03,persegiKuning,761,598,139,134,64,5,64,5,0,0,True,0.48536668376944025
2025-01-07 19:10:03,Fail to pick,761,598,0,0,0,0,0,0,0,0,False,0
2025-01-07 19:10:03,persegiKuning,779,606,117,114,95,39,95,38,0,1,True,0.42699508888454274
2025-01-07 19:10:03,lingkaranKuning,779,607,112,120,181,10,185,6,4,4,True,0.10011150112939632
2025-01-07 19:10:03,segienamKuning,779,607,116,115,40,72,43,75,3,3,True,0.46133244845292065
2025-01-07 19:10:03,Fail to pick,779,607,0,0,0,0,0,0,0,0,False,0
2025-01-07 19:10:03,Fail to pick,779,607,0,0,0,0,0,0,0,0,False,0
2025-01-07 19:10:03,persegiKuning,748,595,126,136,10,59,13,55,3,4,True,0.315760337710197
2025-01-07 19:10:03,persegiKuning,767,598,123,122,105,33,108,30,3,3,True,0.43261727021593555
2025-01-07 19:10:03,segienamKuning,788,611,124,121,164,10,159,14,5,4,True,0.27807869820688336
2025-01-07 19:10:03,persegiKuning,789,612,123,120,41,33,36,36,5,3,True,0.25234057931066106
2025-01-07 19:10:03,Fail to pick,789,612,0,0,0,0,0,0,0,0,False,0
2025-01-07 19:10:03,segienamKuning,802,620,119,115,143,55,146,52,3,3,True,0.300595415141514
2025-01-07 19:10:04,persegiKuning,806,619,115,112,4,53,3,54,1,1,True,0.4844600234751162
2025-01-07 19:10:04,segienamKuning,806,620,115,113,191,73,191,76,0,3,True,0.26860237496335665
2025-01-07 19:10:04,lingkaranKuning,805,619,111,116,89,79,92,77,3,2,True,0.278291116846354
2025-01-07 19:10:04,Fail to pick,806,619,0,0,0,0,0,0,0,0,False,0
2025-01-07 19:10:04,Fail to pick,806,620,0,0,0,0,0,0,0,0,False,0
2025-01-07 19:10:04,Fail to pick,805,619,0,0,0,0,0,0,0,0,False,0
2025-01-07 19:10:04,segienamKuning,764,599,122,122,156,3,158,0,2,3,True,0.4593744373947888
2025-01-07 19:10:04,lingkaranKuning,765,601,118,124,131,50,128,50,3,0,True,0.28749965482796724
2025-01-07 19:10:04,Kuning,764,599,tensor(122.3329),tensor(122.2780),33,70,35,67,2,3,True,0.0
2025-01-07 19:10:04,Fail to pick,765,601,0,0,0,0,0,0,0,0,False,0
2025-01-07 19:10:04,persegiKuning,805,619,120,115,197,91,192,93,5,2,True,0.22408416216121016
2025-01-07 19:10:04,segienamKuning,805,620,119,117,34,5,38,0,4,5,True,0.36217889367926415
2025-01-07 19:10:04,Fail to pick,805,620,0,0,0,0,0,0,0,0,False,0
2025-01-07 19:10:04,segienamKuning,804,621,115,115,189,39,190,42,1,3,True,0.4458517295326305
2025-01-07 19:10:04,Fail to pick,804,621,0,0,0,0,0,0,0,0,False,0
2025-01-07 19:10:04,segienamKuning,798,620,119,114,4,4,4,1,0,3,True,0.18423298916385134
2025-01-07 19:10:04,Fail to pick,798,620,0,0,0,0,0,0,0,0,False,0
2025-01-07 19:10:04,persegiKuning,806,621,114,112,145,17,146,17,1,0,True,0.33802936783775717
2025-01-07 19:10:04,Fail to pick,806,621,0,0,0,0,0,0,0,0,False,0
2025-01-07 19:10:04,segienamKuning,780,604,118,120,100,90,100,88,0,2,True,0.3988593797244169
2025-01-07 19:10:04,segienamKuning,763,595,129,123,52,80,50,79,2,1,False,0.18355548992207094
2025-01-07 19:10:05,persegiKuning,781,607,117,118,188,21,190,24,2,3,True,0.4883335784956878
2025-01-07 19:10:05,segienamKuning,781,606,117,115,140,90,141,94,1,4,True,0.47393266839162307
2025-01-07 19:10:05,Fail to pick,781,606,0,0,0,0,0,0,0,0,False,0
2025-01-07 19:10:05,segienamKuning,774,602,126,120,98,79,102,83,4,4,True,0.1587199771022846
2025-01-07 19:10:05,Fail to pick,774,602,0,0,0,0,0,0,0,0,False,0
2025-01-07 19:10:05,segienamKuning,774,602,126,120,162,4,166,6,4,2,True,0.40127025510281567
2025-01-07 19:10:05,Fail to pick,774,602,0,0,0,0,0,0,0,0,False,0
2025-01-07 19:10:05,segienamKuning,799,613,121,111,55,71,59,66,4,5,True,0.19881449224862796
2025-01-07 19:10:08,segienamKuning,694,659,129,108,114,69,110,71,4,2,True,0.4590360782232491
2025-01-07 19:10:08,Kuning,694,659,tensor(129.9889),tensor(108.2709),16,64,11,62,5,2,True,0.0
2025-01-07 19:10:08,segienamKuning,712,661,123,108,171,57,173,59,2,2,True,0.23319204316243383
2025-01-07 19:10:08,segienamKuning,717,668,121,102,195,3,194,2,1,1,True,0.10692601361892287
2025-01-07 19:10:08,Fail to pick,717,668,0,0,0,0,0,0,0,0,False,0
2025-01-07 19:10:08,segienamKuning,684,655,124,109,180,69,180,71,0,2,True,0.304742684967526
2025-01-07 19:10:08,segienamKuning,678,656,126,110,76,9,74,9,2,0,True,0.10285923746507263
2025-01-07 19:10:08,persegiKuning,680,656,125,111,122,16,126,11,4,5,True,0.2953604958024846
2025-01-07 19:10:08,Fail to pick,678,656,0,0,0,0,0,0,0,0,False,0
2025-01-07 19:10:08,Fail to pick,680,656,0,0,0,0,0,0,0,0,False,0
2025-01-07 19:10:09,segienamKuning,699,665,118,107,15,11,16,15,1,4,True,0.3416080402881619
2025-01-07 19:10:09,segienamKuning,711,666,118,105,68,50,67,52,1,2,False,0.414149346295131
2025-01-07 19:10:09,segienamKuning,715,668,120,103,99,83,94,87,5,4,True,0.21715225645534666
2025-01-07 19:10:09,lingkaranKuning,713,666,116,106,187,19,183,17,4,2,True,0.3878083785047851
2025-01-07 19:10:09,Fail to pick,715,668,0,0,0,0,0,0,0,0,False,0
2025-01-07 19:10:09,Fail to pick,713,666,0,0,0,0,0,0,0,0,False,0
2025-01-07 19:10:09,segienamKuning,709,667,116,103,36,62,37,57,1,5,True,0.30503584332054007
2025-01-07 19:10:09,Fail to pick,709,667,0,0,0,0,0,0,0,0,False,0
2025-01-07 19:10:09,segienamKuning,697,659,124,108,107,76,110,74,3,2,True,0.2273032739260663
2025-01-07 19:10:09,segienamKuning,714,661,119,108,28,17,25,21,3,4,True,0.17519040154884855
2025-01-07 19:10:09,lingkaranKuning,714,662,116,111,93,29,96,28,3,1,True,0.18455849008850067
2025-01-07 19:10:09,Fail to pick,714,662,0,0,0,0,0,0,0,0,False,0
2025-01-07 19:10:09,segienamKuning,714,660,122,109,197,38,199,40,2,2,True,0.34491870767155386
2025-01-07 19:10:09,Fail to pick,714,660,0,0,0,0,0,0,0,0,False,0
2025-01-07 19:10:09,segienamKuning,672,656,122,112,14,84,18,82,4,2,True,0.23772764333641658
2025-01-07 19:10:09,segienamKuning,686,659,121,108,169,18,166,16,3,2,True,0.3169047148097822
2025-01-07 19:10:10,segienamKuning,719,670,122,98,78,50,75,54,3,4,False,0.17150474714190572
2025-01-07 19:10:10,lingkaranKuning,721,670,117,99,70,99,66,96,4,3,True,0.47828857372089917
2025-01-07 19:10:10,Fail to pick,721,670,0,0,0,0,0,0,0,0,False,0
2025-01-07 19:10:10,segienamKuning,718,669,116,97,76,43,74,44,2,1,True,0.455170987687719
2025-01-07 19:10:10,lingkaranKuning,717,669,115,100,62,60,61,60,1,0,True,0.2946419333762905
2025-01-07 19:10:10,Kuning,718,669,tensor(116.8703),tensor(97.7131),14,66,18,66,4,0,True,0.0009968280792236328
2025-01-07 19:10:10,Fail to pick,718,669,0,0,0,0,0,0,0,0,False,0
2025-01-07 19:10:10,Fail to pick,717,669,0,0,0,0,0,0,0,0,False,0
2025-01-07 19:10:10,segienamKuning,684,660,119,108,45,41,41,42,4,1,True,0.23132494934327769
2025-01-07 19:10:10,segienamKuning,660,654,126,114,153,50,153,49,0,1,True,0.2333966127305485
2025-01-07 19:10:10,segienamKuning,687,659,122,109,153,30,157,29,4,1,True,0.44642559966481277
2025-01-07 19:10:10,segienamKuning,696,660,129,109,14,79,16,76,2,3,True,0.35004062082478926
2025-01-07 19:10:10,Fail to pick,696,660,0,0,0,0,0,0,0,0,False,0
2025-01-07 19:10:10,segienamKuning,696,660,129,109,191,44,191,39,0,5,True,0.23859008466350107
2025-01-07 19:10:10,Fail to pick,696,660,0,0,0,0,0,0,0,0,False,0
2025-01-07 19:10:10,segienamKuning,712,662,124,107,112,79,114,80,2,1,True,0.33498721726487757
2025-01-07 19:10:12,persegiKuning,670,266,120,167,37,24,38,19,1,5,True,0.18955575593077356
2025-01-07 19:10:12,Kuning,670,266,tensor(120.4223),tensor(167.7047),126,62,125,57,1,5,True,0.0004999637603759766
2025-01-07 19:10:12,persegiKuning,687,275,118,165,150,47,147,44,3,3,True,0.21321701662539674
2025-01-07 19:10:12,persegiKuning,683,271,140,166,38,46,34,44,4,2,True,0.463309286490614
2025-01-07 19:10:12,Fail to pick,683,271,0,0,0,0,0,0,0,0,False,0
2025-01-07 19:10:13,persegiKuning,706,293,118,137,76,86,77,86,1,0,True,0.3346476131231021
2025-01-07 19:10:13,persegiKuning,691,280,120,139,137,85,135,89,2,4,True,0.1800326857086686
2025-01-07 19:10:13,persegiKuning,691,283,126,146,143,35,147,39,4,4,True,0.48727944891106567
2025-01-07 19:10:13,Fail to pick,691,283,0,0,0,0,0,0,0,0,False,0
2025-01-07 19:10:13,persegiKuning,680,279,121,139,190,67,186,63,4,4,True,0.45473768081395327
2025-01-07 19:10:13,segienamKuning,680,279,121,138,16,86,13,87,3,1,True,0.2736084273118263
2025-01-07 19:10:13,Fail to pick,680,279,0,0,0,0,0,0,0,0,False,0
2025-01-07 19:10:13,persegiKuning,670,264,125,143,94,62,98,65,4,3,True,0.3069890548862032
2025-01-07 19:10:13,persegiKuning,693,280,134,139,32,40,33,38,1,2,True,0.4642611595913231
2025-01-07 19:10:13,persegiKuning,691,288,120,133,176,28,176,28,0,0,True,0.14940927235206725
2025-01-07 19:10:13,lingkaranKuning,689,283,115,125,181,57,179,52,2,5,True,0.46924752774297684
2025-01-07 19:10:13,Fail to pick,691,288,0,0,0,0,0,0,0,0,False,0
2025-01-07 19:10:13,Fail to pick,689,283,0,0,0,0,0,0,0,0,False,0
2025-01-07 19:10:13,segienamKuning,672,269,127,138,105,81,108,77,3,4,True,0.4123152432558077
2025-01-07 19:10:13,Kuning,672,269,tensor(127.8362),tensor(138.1676),125,62,126,60,1,2,True,0.0
2025-01-07 19:10:14,segienamKuning,697,287,121,131,99,37,96,33,3,4,True,0.11228338930976207
2025-01-07 19:10:14,persegiKuning,699,287,120,132,70,99,69,100,1,1,True,0.24854280148064298
2025-01-07 19:10:14,Fail to pick,699,287,0,0,0,0,0,0,0,0,False,0
2025-01-07 19:10:14,segienamKuning,693,288,127,137,3,46,1,49,2,3,True,0.1591534431282534
2025-01-07 19:10:14,persegiKuning,693,287,125,135,196,49,193,53,3,4,True,0.39899291964925
2025-01-07 19:10:14,Fail to pick,693,288,0,0,0,0,0,0,0,0,False,0
2025-01-07 19:10:14,Fail to pick,693,287,0,0,0,0,0,0,0,0,False,0
2025-01-07 19:10:14,persegiKuning,707,294,128,138,141,72,145,70,4,2,True,0.3247702776356001
2025-01-07 19:10:14,persegiKuning,692,288,125,137,24,6,23,7,1,1,True,0.2519165783238422
2025-01-07 19:10:17,persegiKuning,671,275,118,141,52,91,54,91,2,0,True,0.47464115585448097
2025-01-07 19:10:17,persegiKuning,679,288,114,139,111,15,108,12,3,3,True,0.18368662854021434
2025-01-07 19:10:17,persegiKuning,681,281,120,140,0,66,3,62,3,4,True,0.2128683114814236
2025-01-07 19:10:17,Fail to pick,681,281,0,0,0,0,0,0,0,0,False,0
2025-01-07 19:10:18,persegiKuning,692,285,120,142,99,53,98,55,1,2,True,0.38889915567168953
2025-01-07 19:10:18,persegiKuning,683,283,121,139,162,69,158,66,4,3,True,0.43069281805487825
2025-01-07 19:10:18,segienamKuning,682,281,122,136,1,85,0,80,1,5,True,0.13900118477103157
2025-01-07 19:10:18,Fail to pick,683,283,0,0,0,0,0,0,0,0,False,0
2025-01-07 19:10:18,Fail to pick,682,281,0,0,0,0,0,0,0,0,False,0
2025-01-07 19:10:18,persegiKuning,677,271,130,142,40,76,36,78,4,2,True,0.43461433301631713
2025-01-07 19:10:18,Kuning,677,271,tensor(130.5212),tensor(142.4413),124,62,125,59,1,3,True,0.0005059242248535156
2025-01-07 19:10:18,persegiKuning,685,283,127,139,38,82,35,77,3,5,True,0.3869696028226809
2025-01-07 19:10:18,segienamKuning,685,284,129,140,102,12,105,14,3,2,True,0.41461816547739994
2025-01-07 19:10:18,Fail to pick,685,284,0,0,0,0,0,0,0,0,False,0
2025-01-07 19:10:18,persegiKuning,678,274,134,143,67,16,62,16,5,0,True,0.3404606782198073
2025-01-07 19:10:18,persegiKuning,680,277,134,135,30,88,29,84,1,4,True,0.35280159541483913
2025-01-07 19:10:18,Fail to pick,680,277,0,0,0,0,0,0,0,0,False,0
2025-01-07 19:10:18,persegiKuning,691,293,129,135,4,3,1,-2,3,5,True,0.20350695782345457
2025-01-07 19:10:18,persegiKuning,682,280,128,138,12,13,13,11,1,2,True,0.28883186473481737
2025-01-07 19:10:18,persegiKuning,693,290,114,138,116,22,115,26,1,4,True,0.17430125933095747
2025-01-07 19:10:19,persegiKuning,686,290,121,141,168,24,166,19,2,5,False,0.2593264849687598
2025-01-07 19:10:19,Fail to pick,686,290,0,0,0,0,0,0,0,0,False,0
2025-01-07 19:10:19,persegiKuning,683,291,124,137,29,68,25,72,4,4,True,0.39554998526422025
2025-01-07 19:10:19,Fail to pick,683,291,0,0,0,0,0,0,0,0,False,0
2025-01-07 19:10:19,persegiKuning,691,290,131,141,24,86,22,87,2,1,True,0.3141404820894038
2025-01-07 19:10:19,segienamKuning,689,289,131,138,17,80,17,77,0,3,True,0.406534037076158
2025-01-07 19:10:19,Fail to pick,691,290,0,0,0,0,0,0,0,0,False,0
2025-01-07 19:10:19,Fail to pick,689,289,0,0,0,0,0,0,0,0,False,0
2025-01-07 19:10:19,persegiKuning,678,282,136,136,18,0,20,-2,2,2,True,0.10569909180087551
2025-01-07 19:10:19,Kuning,678,282,tensor(136.5635),tensor(136.9305),121,62,119,60,2,2,True,0.0
2025-01-07 19:10:19,persegiKuning,677,276,135,138,181,7,178,2,3,5,True,0.35015502536303655
2025-01-07 19:10:19,segienamKuning,675,274,136,137,148,65,151,62,3,3,True,0.35509338457680883
2025-01-07 19:10:19,Fail to pick,677,276,0,0,0,0,0,0,0,0,False,0
2025-01-07 19:10:19,Fail to pick,675,274,0,0,0,0,0,0,0,0,False,0
2025-01-07 19:10:19,segienamKuning,677,273,130,139,97,94,93,97,4,3,True,0.24318773379403436
2025-01-07 19:10:19,Fail to pick,677,273,0,0,0,0,0,0,0,0,False,0
2025-01-07 19:10:19,persegiKuning,685,290,120,134,60,70,59,73,1,3,True,0.20956145256968803
2025-01-07 19:10:20,persegiKuning,674,273,127,141,80,13,83,8,3,5,True,0.3577765591079083
2025-01-07 19:10:20,persegiKuning,697,291,115,140,86,83,81,80,5,3,True,0.45952604688033416
2025-01-07 19:10:20,persegiKuning,691,294,116,133,61,22,56,21,5,1,True,0.16868696137032982
2025-01-07 19:10:20,Fail to pick,691,294,0,0,0,0,0,0,0,0,False,0
2025-01-07 19:10:20,persegiKuning,682,281,116,137,56,26,55,23,1,3,True,0.3502423761655118
2025-01-07 19:10:20,persegiKuning,678,289,128,144,38,33,39,33,1,0,True,0.42462997245570844
2025-01-07 19:10:20,Fail to pick,678,289,0,0,0,0,0,0,0,0,False,0
2025-01-07 19:10:20,lingkaranKuning,682,281,114,128,166,65,163,66,3,1,True,0.30353861985012137
2025-01-07 19:10:20,persegiKuning,683,287,122,137,137,71,138,74,1,3,True,0.3641380380459188
2025-01-07 19:10:20,segienamKuning,681,287,122,138,58,78,55,77,3,1,True,0.23325609433099467
2025-01-07 19:10:20,Fail to pick,682,281,0,0,0,0,0,0,0,0,False,0
2025-01-07 19:10:20,Fail to pick,683,287,0,0,0,0,0,0,0,0,False,0
2025-01-07 19:10:20,Fail to pick,681,287,0,0,0,0,0,0,0,0,False,0
2025-01-07 19:10:20,persegiKuning,680,270,124,145,131,0,132,-4,1,4,True,0.31201919663719924
2025-01-07 19:10:20,Kuning,680,270,tensor(124.3627),tensor(145.0935),125,62,124,61,1,1,True,0.0
2025-01-07 19:10:20,persegiKuning,693,290,121,142,90,67,92,62,2,5,False,0.23277279782284294
2025-01-07 19:10:21,persegiKuning,674,277,123,137,196,55,194,50,2,5,True,0.20793430735806245
2025-01-07 19:10:21,persegiKuning,644,252,122,141,32,88,34,87,2,1,True,0.4418771041336528
2025-01-07 19:10:21,persegiKuning,692,294,117,137,160,60,163,56,3,4,False,0.23663687650604867
2025-01-07 19:10:21,persegiKuning,676,290,122,141,56,14,57,17,1,3,True,0.3747437111602764
2025-01-07 19:10:21,persegiKuning,664,270,123,139,132,48,129,50,3,2,True,0.3839866601285281
2025-01-07 19:10:21,persegiKuning,664,274,120,137,145,91,142,88,3,3,True,0.41690517982330866
2025-01-07 19:10:21,Fail to pick,664,274,0,0,0,0,0,0,0,0,False,0
2025-01-07 19:10:21,segienamKuning,682,287,128,140,97,47,99,43,2,4,True,0.10754552965429572
2025-01-07 19:10:21,persegiKuning,683,288,126,140,110,1,114,0,4,1,True,0.49082397161918945
2025-01-07 19:10:21,Fail to pick,683,288,0,0,0,0,0,0,0,0,False,0
2025-01-07 19:10:21,persegiKuning,685,280,119,138,20,91,17,87,3,4,True,0.10511096451643205
2025-01-07 19:10:21,Kuning,685,280,tensor(119.7686),tensor(138.5824),122,63,117,58,5,5,True,0.0
2025-01-07 19:10:21,Fail to pick,685,280,0,0,0,0,0,0,0,0,False,0
2025-01-07 19:10:21,persegiKuning,675,272,125,139,21,46,16,48,5,2,True,0.27872544994017134
2025-01-07 19:10:22,persegiKuning,686,285,127,145,178,45,176,47,2,2,True,0.3028669600319108
2025-01-07 19:10:22,persegiKuning,674,284,127,143,42,5,45,2,3,3,False,0.13602677823106882
2025-01-07 19:10:22,persegiKuning,679,285,121,140,126,99,125,103,1,4,True,0.4626693367360183
2025-01-07 19:10:22,Fail to pick,679,285,0,0,0,0,0,0,0,0,False,0
2025-01-07 19:10:22,persegiKuning,688,289,121,136,51,83,55,85,4,2,True,0.27460803676193035
2025-01-07 19:10:22,Fail to pick,688,289,0,0,0,0,0,0,0,0,False,0
2025-01-07 19:10:22,segienamKuning,683,291,130,132,90,16,91,18,1,2,True,0.3912802259308247
2025-01-07 19:10:22,persegiKuning,684,292,130,131,179,97,178,92,1,5,True,0.329269136037347
2025-01-07 19:10:22,Fail to pick,683,291,0,0,0,0,0,0,0,0,False,0
2025-01-07 19:10:22,Fail to pick,684,292,0,0,0,0,0,0,0,0,False,0
2025-01-07 19:10:22,persegiKuning,684,286,118,137,64,7,66,2,2,5,True,0.4150212932771903
2025-01-07 19:10:22,Fail to pick,684,286,0,0,0,0,0,0,0,0,False,0
2025-01-07 19:10:22,persegiKuning,660,265,134,149,155,28,156,30,1,2,True,0.12160146994807622
2025-01-07 19:10:22,persegiKuning,715,309,125,133,17,85,17,86,0,1,True,0.2969724997718136
2025-01-07 19:10:23,persegiKuning,718,306,119,131,171,16,172,15,1,1,True,0.24600791375442174
2025-01-07 19:10:23,Fail to pick,718,306,0,0,0,0,0,0,0,0,False,0
2025-01-07 19:10:23,persegiKuning,715,305,130,134,198,79,193,79,5,0,True,0.11056855060100511
2025-01-07 19:10:23,Fail to pick,715,305,0,0,0,0,0,0,0,0,False,0
2025-01-07 19:10:23,persegiKuning,717,306,132,139,91,2,93,2,2,0,True,0.43932799259256805
2025-01-07 19:10:23,Fail to pick,717,306,0,0,0,0,0,0,0,0,False,0
2025-01-07 19:10:23,persegiKuning,720,308,130,131,111,87,113,86,2,1,True,0.10996275715764417
2025-01-07 19:10:23,Fail to pick,720,308,0,0,0,0,0,0,0,0,False,0
2025-01-07 19:10:23,persegiKuning,718,309,127,130,105,95,105,99,0,4,True,0.261973899081043
2025-01-07 19:10:23,Fail to pick,718,309,0,0,0,0,0,0,0,0,False,0
2025-01-07 19:10:23,segienamKuning,715,314,123,144,32,4,36,8,4,4,True,0.32459047419621806
2025-01-07 19:10:23,Fail to pick,715,314,0,0,0,0,0,0,0,0,False,0
2025-01-07 19:10:23,persegiKuning,661,271,125,138,62,76,60,79,2,3,True,0.48320445393711253
2025-01-07 19:10:26,persegiKuning,666,216,137,151,30,69,34,72,4,3,True,0.24350529186945213
2025-01-07 19:10:26,Kuning,666,216,tensor(137.6642),tensor(151.9868),140,61,141,61,1,0,True,0.0
2025-01-07 19:10:26,persegiKuning,666,216,137,151,42,18,43,16,1,2,True,0.427656520303772
2025-01-07 19:10:26,Fail to pick,666,216,0,0,0,0,0,0,0,0,False,0
2025-01-07 19:10:26,persegiKuning,704,259,122,136,96,50,93,48,3,2,True,0.4968163029376381
2025-01-07 19:10:26,segienamKuning,712,254,127,144,161,40,157,41,4,1,True,0.1653391981792448
2025-01-07 19:10:26,persegiKuning,714,253,128,146,67,11,62,15,5,4,True,0.18718992573830603
2025-01-07 19:10:26,Fail to pick,712,254,0,0,0,0,0,0,0,0,False,0
2025-01-07 19:10:26,Fail to pick,714,253,0,0,0,0,0,0,0,0,False,0
2025-01-07 19:10:26,persegiKuning,660,231,126,163,72,68,68,65,4,3,True,0.39347272231083397
2025-01-07 19:10:39,persegiKuning,785,361,133,172,135,2,132,5,3,3,True,0.22096222519688358
2025-01-07 19:10:39,Kuning,785,361,tensor(133.3469),tensor(172.4156),99,72,100,73,1,1,True,0.0
2025-01-07 19:10:39,persegiKuning,798,368,127,145,94,65,96,60,2,5,True,0.11105931112629751
2025-01-07 19:10:39,persegiKuning,783,350,126,147,63,89,60,84,3,5,True,0.11586594627622447
2025-01-07 19:10:40,persegiKuning,814,382,131,137,154,66,155,61,1,5,True,0.4487742348063125
2025-01-07 19:10:40,persegiKuning,791,347,142,145,48,45,43,41,5,4,True,0.3444732230123272
2025-01-07 19:10:40,segienamKuning,847,412,127,130,155,5,155,4,0,1,True,0.29084658795647034
2025-01-07 19:10:40,segienamKuning,850,411,119,128,182,92,184,94,2,2,True,0.4456227934122482
2025-01-07 19:10:40,Fail to pick,850,411,0,0,0,0,0,0,0,0,False,0
2025-01-07 19:10:40,persegiKuning,808,366,118,134,154,81,153,79,1,2,True,0.48462544309146616
2025-01-07 19:10:40,persegiKuning,806,379,121,135,139,99,141,96,2,3,True,0.32600696410815944
2025-01-07 19:10:40,persegiKuning,787,354,126,145,143,59,142,55,1,4,True,0.32934743710400416
2025-01-07 19:10:40,segienamKuning,815,380,121,136,71,61,74,64,3,3,True,0.27734366448726666
2025-01-07 19:10:40,persegiKuning,816,381,121,139,159,89,157,85,2,4,True,0.2637699583321912
2025-01-07 19:10:40,Fail to pick,816,381,0,0,0,0,0,0,0,0,False,0
2025-01-07 19:10:41,persegiKuning,808,376,121,139,158,42,159,43,1,1,True,0.18633287331835235
2025-01-07 19:10:41,Kuning,808,376,tensor(121.2837),tensor(139.8188),95,74,92,78,3,4,True,0.0
2025-01-07 19:10:41,Fail to pick,808,376,0,0,0,0,0,0,0,0,False,0
2025-01-07 19:10:41,persegiKuning,788,359,128,139,119,40,115,39,4,1,True,0.48788186899075614
2025-01-07 19:10:41,segienamKuning,816,384,131,131,195,73,198,69,3,4,True,0.4342487826914001
2025-01-07 19:10:41,segienamKuning,809,368,128,141,199,9,198,4,1,5,False,0.21739311656327237
2025-01-07 19:10:41,persegiKuning,788,361,124,134,154,97,151,101,3,4,True,0.26638000185436167
2025-01-07 19:10:41,persegiKuning,781,358,116,136,94,30,93,32,1,2,True,0.2528736965748807
2025-01-07 19:10:41,Fail to pick,781,358,0,0,0,0,0,0,0,0,False,0
2025-01-07 19:10:41,persegiKuning,821,395,115,131,41,67,45,67,4,0,True,0.48913402645976845
2025-01-07 19:10:41,segienamKuning,796,361,123,139,120,96,123,100,3,4,True,0.46987751592229676
2025-01-07 19:10:41,persegiKuning,796,361,124,140,71,4,74,5,3,1,True,0.22893119189695021
2025-01-07 19:10:41,Fail to pick,796,361,0,0,0,0,0,0,0,0,False,0
2025-01-07 19:10:42,persegiKuning,799,369,128,138,175,75,172,76,3,1,True,0.20155739069569864
2025-01-07 19:10:42,Fail to pick,799,369,0,0,0,0,0,0,0,0,False,0
2025-01-07 19:10:42,persegiKuning,803,365,123,138,0,89,-3,89,3,0,True,0.23984857426776413
2025-01-07 19:10:42,Fail to pick,803,365,0,0,0,0,0,0,0,0,False,0
2025-01-07 19:10:42,persegiKuning,794,370,121,144,70,76,73,74,3,2,True,0.3166244674651474
2025-01-07 19:10:42,Fail to pick,794,370,0,0,0,0,0,0,0,0,False,0
2025-01-07 19:10:42,persegiKuning,793,367,123,139,38,35,36,32,2,3,True,0.1517946485157347
2025-01-07 19:10:42,Fail to pick,793,367,0,0,0,0,0,0,0,0,False,0
2025-01-07 19:10:42,persegiKuning,800,359,123,135,189,50,192,48,3,2,False,0.44542847877304736
2025-01-07 19:10:42,Fail to pick,800,359,0,0,0,0,0,0,0,0,False,0
2025-01-07 19:10:42,persegiKuning,841,406,117,131,54,98,58,101,4,3,True,0.42333725024667634
2025-01-07 19:10:42,segienamKuning,796,362,133,137,144,96,143,100,1,4,False,0.15369967764746473
2025-01-07 19:10:42,persegiKuning,795,362,133,137,123,59,120,54,3,5,True,0.15658801014606386
2025-01-07 19:10:42,Fail to pick,795,362,0,0,0,0,0,0,0,0,False,0
2025-01-07 19:10:42,persegiKuning,797,357,130,138,54,92,49,92,5,0,True,0.11072104431323204
2025-01-07 19:10:42,segienamKuning,796,357,133,138,89,92,92,88,3,4,False,0.37405125791728033
2025-01-07 19:10:42,Kuning,797,357,tensor(130.6277),tensor(138.0650),100,73,97,72,3,1,True,0.0
2025-01-07 19:10:42,Fail to pick,797,357,0,0,0,0,0,0,0,0,False,0
2025-01-07 19:10:42,Fail to pick,796,357,0,0,0,0,0,0,0,0,False,0
2025-01-07 19:10:43,persegiKuning,847,403,127,131,11,44,11,45,0,1,True,0.2362943025361123
2025-01-07 19:10:43,persegiKuning,804,359,128,140,80,59,80,60,0,1,True,0.1374870181293175
2025-01-07 19:10:43,persegiKuning,810,373,132,139,101,86,98,87,3,1,True,0.11632622277337648
2025-01-07 19:10:46,segienamKuning,982,418,110,125,103,15,103,18,0,3,True,0.49044551540818493
2025-01-07 19:10:46,persegiKuning,981,418,110,125,10,31,6,27,4,4,True,0.20061593228350827
2025-01-07 19:10:46,Kuning,982,418,tensor(110.0135),tensor(125.6237),83,90,82,90,1,0,True,0.0
2025-01-07 19:10:46,Fail to pick,981,418,0,0,0,0,0,0,0,0,False,0
2025-01-07 19:10:46,segienamKuning,988,421,111,124,32,61,30,62,2,1,True,0.4352144641356256
2025-01-07 19:10:46,Fail to pick,988,421,0,0,0,0,0,0,0,0,False,0
2025-01-07 19:10:46,segienamKuning,943,370,120,144,128,93,123,89,5,4,True,0.1942048110133029
2025-01-07 19:10:46,persegiKuning,943,370,122,144,29,1,28,2,1,1,True,0.3856913577775689
2025-01-07 19:10:46,Fail to pick,943,370,0,0,0,0,0,0,0,0,False,0
2025-01-07 19:10:46,segienamKuning,984,416,107,127,79,21,79,20,0,1,True,0.20336947241683845
2025-01-07 19:10:46,segienamKuning,980,422,107,122,177,54,179,57,2,3,True,0.40619835672510407
2025-01-07 19:10:46,persegiKuning,979,422,107,124,74,85,75,83,1,2,True,0.22208228891412
2025-01-07 19:10:46,Fail to pick,980,422,0,0,0,0,0,0,0,0,False,0
2025-01-07 19:10:46,Fail to pick,979,422,0,0,0,0,0,0,0,0,False,0
2025-01-07 19:10:46,segienamKuning,977,418,109,123,63,72,61,67,2,5,True,0.3006857723605635
2025-01-07 19:10:46,Fail to pick,977,418,0,0,0,0,0,0,0,0,False,0
2025-01-07 19:10:46,segienamKuning,946,384,108,137,65,7,66,6,1,1,True,0.41643522170197933
2025-01-07 19:10:46,segienamKuning,981,417,113,121,65,96,66,92,1,4,True,0.29208387952066983
2025-01-07 19:10:46,segienamKuning,952,397,111,132,120,46,120,48,0,2,True,0.13333404535218563
2025-01-07 19:10:47,segienamKuning,979,420,108,121,163,67,160,68,3,1,True,0.38104519934575454
2025-01-07 19:10:47,segienamKuning,946,388,111,133,154,69,151,66,3,3,True,0.32167967356055993
2025-01-07 19:10:47,segienamKuning,945,380,120,133,89,99,91,102,2,3,True,0.3767670161522957
2025-01-07 19:10:47,Kuning,945,380,tensor(120.9178),tensor(133.9937),94,87,97,85,3,2,True,0.0
2025-01-07 19:10:47,Fail to pick,945,380,0,0,0,0,0,0,0,0,False,0
2025-01-07 19:10:47,segienamKuning,948,395,119,132,0,61,0,64,0,3,False,0.15459062697556003
2025-01-07 19:10:47,segienamKuning,954,391,112,130,69,68,70,67,1,1,True,0.3294365891253447
2025-01-07 19:10:47,Fail to pick,954,391,0,0,0,0,0,0,0,0,False,0
2025-01-07 19:10:47,segienamKuning,957,400,116,130,46,11,49,15,3,4,True,0.10860212733842026
2025-01-07 19:10:47,Fail to pick,957,400,0,0,0,0,0,0,0,0,False,0
2025-01-07 19:10:47,segienamKuning,941,380,119,139,126,63,122,59,4,4,True,0.3825789370035193
2025-01-07 19:10:47,segienamKuning,954,380,150,151,174,40,176,36,2,4,True,0.35111296505516276
2025-01-07 19:10:48,segienamKuning,961,394,145,147,168,21,169,24,1,3,True,0.18773452153738712
2025-01-07 19:10:48,persegiKuning,973,418,114,141,151,13,146,10,5,3,True,0.2782128998390111
2025-01-07 19:10:48,segienamKuning,937,381,120,144,85,26,87,30,2,4,True,0.2861727514971487
2025-01-07 19:10:48,segienamKuning,948,383,117,145,44,44,41,43,3,1,True,0.481753958341548
2025-01-07 19:10:48,persegiKuning,979,408,109,135,136,55,139,50,3,5,True,0.4735568126029842
2025-01-07 19:10:48,segienamKuning,979,409,109,137,88,65,88,63,0,2,True,0.4335186152632642
2025-01-07 19:10:48,Fail to pick,979,409,0,0,0,0,0,0,0,0,False,0
2025-01-07 19:10:48,segienamKuning,957,396,116,136,98,2,101,1,3,1,False,0.2600564627824382
2025-01-07 19:10:48,persegiKuning,957,396,117,134,93,18,92,17,1,1,True,0.19678357874071162
2025-01-07 19:10:48,Kuning,957,396,tensor(116.5632),tensor(136.9887),90,88,89,92,1,4,True,0.0
2025-01-07 19:10:48,Fail to pick,957,396,0,0,0,0,0,0,0,0,False,0
2025-01-07 19:10:48,persegiKuning,965,391,122,158,120,72,120,71,0,1,True,0.42697244999237616
2025-01-07 19:10:48,Fail to pick,965,391,0,0,0,0,0,0,0,0,False,0
2025-01-07 19:10:48,segienamKuning,962,398,146,136,184,9,185,13,1,4,True,0.481537041042262
2025-01-07 19:10:48,Fail to pick,962,398,0,0,0,0,0,0,0,0,False,0
2025-01-07 19:10:49,segienamKuning,962,392,121,139,18,84,17,86,1,2,True,0.10703565512327229
2025-01-07 19:10:49,Fail to pick,962,392,0,0,0,0,0,0,0,0,False,0
2025-01-07 19:10:49,segienamKuning,959,400,117,144,13,89,16,92,3,3,True,0.16315503063729114
2025-01-07 19:10:49,Fail to pick,959,400,0,0,0,0,0,0,0,0,False,0
2025-01-07 19:10:49,segienamKuning,951,380,124,143,50,3,47,7,3,4,True,0.4947296988341414
2025-01-07 19:10:49,segienamKuning,945,367,127,155,2,79,0,81,2,2,True,0.1993641562479722
2025-01-07 19:10:49,segienamKuning,947,392,127,139,67,72,71,70,4,2,True,0.4128932274767265
2025-01-07 19:10:49,segienamKuning,960,407,111,135,24,20,27,18,3,2,True,0.32340282082862515
2025-01-07 19:10:49,segienamKuning,943,377,123,144,96,72,99,71,3,1,True,0.23817015901391822
2025-01-07 19:10:50,persegiKuning,961,392,108,151,10,48,13,45,3,3,True,0.2805996396524272
2025-01-07 19:10:50,segienamKuning,956,394,112,130,68,82,67,84,1,2,True,0.4485536628912731
2025-01-07 19:10:50,Fail to pick,956,394,0,0,0,0,0,0,0,0,False,0
2025-01-07 19:10:50,segienamKuning,976,415,123,130,181,65,182,62,1,3,True,0.33989101807417177
2025-01-07 19:10:50,segienamKuning,949,387,118,137,31,76,30,73,1,3,True,0.4113720252893187
2025-01-07 19:10:50,segienamKuning,957,402,111,127,19,52,14,53,5,1,True,0.3335230481659846
2025-01-07 19:10:50,segienamKuning,951,393,123,134,84,6,86,5,2,1,True,0.2883575620624318
2025-01-07 19:10:50,Fail to pick,951,393,0,0,0,0,0,0,0,0,False,0
2025-01-07 19:10:50,segienamKuning,976,417,116,125,28,63,29,66,1,3,True,0.43274421268890917
2025-01-07 19:10:50,segienamKuning,946,373,122,136,166,37,165,32,1,5,True,0.3067841041585482
2025-01-07 19:10:51,segienamKuning,948,373,119,136,172,38,176,42,4,4,True,0.4635261662626097
2025-01-07 19:10:51,Fail to pick,948,373,0,0,0,0,0,0,0,0,False,0
2025-01-07 19:10:51,persegiKuning,982,413,108,121,114,72,117,67,3,5,True,0.14154509772978502
2025-01-07 19:10:51,segienamKuning,982,413,107,122,71,71,75,70,4,1,True,0.20833774088198453
2025-01-07 19:10:51,Fail to pick,982,413,0,0,0,0,0,0,0,0,False,0
2025-01-07 19:10:51,segienamKuning,947,380,118,134,128,31,125,33,3,2,True,0.12872215921081534
2025-01-07 19:10:51,persegiKuning,947,379,116,133,34,60,35,64,1,4,True,0.17926312800986183
2025-01-07 19:10:51,Kuning,947,380,tensor(118.0574),tensor(134.4212),94,87,92,86,2,1,True,0.0005002021789550781
2025-01-07 19:10:51,Fail to pick,947,379,0,0,0,0,0,0,0,0,False,0
2025-01-07 19:10:56,persegiKuning,591,229,127,157,66,39,66,41,0,2,True,0.2735669351142238
2025-01-07 19:10:56,Kuning,591,229,tensor(127.6332),tensor(157.7873),136,54,133,55,3,1,True,0.0
2025-01-07 19:10:57,segienamKuning,595,240,134,159,95,86,90,87,5,1,True,0.27148934859206175
2025-01-07 19:10:57,persegiKuning,596,241,135,159,146,38,149,38,3,0,True,0.418747824991742
2025-01-07 19:10:57,Fail to pick,596,241,0,0,0,0,0,0,0,0,False,0
2025-01-07 19:10:57,persegiKuning,613,245,130,164,182,13,183,13,1,0,True,0.42312320843014894
2025-01-07 19:10:57,persegiKuning,625,219,129,157,190,85,186,86,4,1,True,0.22890385715634834
2025-01-07 19:10:57,persegiKuning,607,207,128,154,168,3,164,6,4,3,True,0.36826706906088547
2025-01-07 19:10:57,segienamKuning,583,181,136,154,61,3,63,-2,2,5,True,0.4850997379485956
2025-01-07 19:10:57,persegiKuning,584,181,134,153,98,46,95,44,3,2,True,0.38738553760373684
2025-01-07 19:10:57,Fail to pick,584,181,0,0,0,0,0,0,0,0,False,0
2025-01-07 19:10:57,segienamKuning,622,237,117,136,47,93,51,88,4,5,True,0.15590885828657708
2025-01-07 19:10:57,persegiKuning,623,238,118,139,105,15,105,10,0,5,True,0.3478317158413831
2025-01-07 19:10:57,Fail to pick,623,238,0,0,0,0,0,0,0,0,False,0
2025-01-07 19:10:58,persegiKuning,627,230,125,136,168,57,169,58,1,1,True,0.2060988093463592
2025-01-07 19:10:58,segienamKuning,626,231,127,138,140,79,135,82,5,3,True,0.28148374919646235
2025-01-07 19:10:58,Kuning,627,230,tensor(125.9926),tensor(136.9270),136,58,134,55,2,3,True,0.0
2025-01-07 19:10:58,Fail to pick,627,230,0,0,0,0,0,0,0,0,False,0
2025-01-07 19:10:58,Fail to pick,626,231,0,0,0,0,0,0,0,0,False,0
2025-01-07 19:10:58,segienamKuning,599,208,120,145,15,94,14,96,1,2,True,0.4428828820832347
2025-01-07 19:10:58,persegiKuning,601,209,122,143,193,49,194,50,1,1,True,0.1816918646417318
2025-01-07 19:10:58,Fail to pick,601,209,0,0,0,0,0,0,0,0,False,0
2025-01-07 19:10:58,segienamKuning,592,203,121,146,67,45,71,47,4,2,True,0.3952109963186513
2025-01-07 19:10:58,persegiKuning,592,204,121,145,86,51,90,54,4,3,True,0.15568282845731743
2025-01-07 19:10:58,Fail to pick,592,203,0,0,0,0,0,0,0,0,False,0
2025-01-07 19:10:58,Fail to pick,592,204,0,0,0,0,0,0,0,0,False,0
2025-01-07 19:10:58,segienamKuning,591,199,121,144,127,88,123,88,4,0,True,0.26033937618244696
2025-01-07 19:10:58,persegiKuning,591,199,121,144,62,92,66,96,4,4,True,0.2692836221853917
2025-01-07 19:10:58,Fail to pick,591,199,0,0,0,0,0,0,0,0,False,0
2025-01-07 19:10:58,Fail to pick,591,199,0,0,0,0,0,0,0,0,False,0
2025-01-07 19:10:58,segienamKuning,584,184,121,150,26,2,23,-1,3,3,True,0.1754940903344766
2025-01-07 19:10:58,segienamKuning,651,250,131,137,186,28,182,27,4,1,True,0.17150466033845263
2025-01-07 19:10:58,segienamKuning,656,252,132,133,174,80,172,84,2,4,False,0.15790004956976011
2025-01-07 19:10:58,Fail to pick,656,252,0,0,0,0,0,0,0,0,False,0
2025-01-07 19:10:58,segienamKuning,657,254,132,137,86,34,90,31,4,3,False,0.42392119641806414
2025-01-07 19:10:58,Fail to pick,657,254,0,0,0,0,0,0,0,0,False,0
2025-01-07 19:10:59,persegiKuning,655,252,122,134,83,47,79,50,4,3,True,0.4195368367928769
2025-01-07 19:10:59,Fail to pick,655,252,0,0,0,0,0,0,0,0,False,0
2025-01-07 19:10:59,segienamKuning,653,251,128,136,54,55,51,55,3,0,True,0.28519303501931037
2025-01-07 19:10:59,persegiKuning,655,252,128,137,33,37,31,39,2,2,True,0.36807039445747225
2025-01-07 19:10:59,Fail to pick,653,251,0,0,0,0,0,0,0,0,False,0
2025-01-07 19:10:59,Fail to pick,655,252,0,0,0,0,0,0,0,0,False,0
2025-01-07 19:10:59,segienamKuning,661,254,135,141,31,65,29,61,2,4,True,0.47073109877975305
2025-01-07 19:10:59,Kuning,661,254,tensor(135.9839),tensor(141.1451),129,61,132,59,3,2,True,0.00015592575073242188
2025-01-07 19:10:59,Fail to pick,661,254,0,0,0,0,0,0,0,0,False,0
2025-01-07 19:10:59,segienamKuning,607,203,133,144,162,26,166,27,4,1,True,0.28075251215036245
2025-01-07 19:10:59,segienamKuning,652,243,131,145,46,89,42,88,4,1,True,0.19212261017940457
2025-01-07 19:11:02,segienamKuning,650,180,137,141,101,35,96,37,5,2,True,0.3365462732567638
2025-01-07 19:11:02,segienamKuning,692,229,141,136,161,66,160,66,1,0,True,0.2792681467273173
2025-01-07 19:11:02,Kuning,692,229,tensor(141.9981),tensor(136.0565),136,64,138,67,2,3,True,0.0004980564117431641
2025-01-07 19:11:02,segienamKuning,654,191,129,144,56,80,53,75,3,5,True,0.3631294281163
2025-01-07 19:11:02,segienamKuning,693,221,127,138,103,60,104,59,1,1,False,0.29491810861501055
2025-01-07 19:11:02,segienamKuning,696,231,134,139,79,54,79,51,0,3,True,0.41972105431731477
2025-01-07 19:11:02,segienamKuning,696,231,134,139,83,29,83,25,0,4,True,0.4719643245339997
2025-01-07 19:11:02,Fail to pick,696,231,0,0,0,0,0,0,0,0,False,0
2025-01-07 19:11:02,segienamKuning,695,222,134,138,190,21,188,16,2,5,True,0.48789182630087546
2025-01-07 19:11:02,Fail to pick,695,222,0,0,0,0,0,0,0,0,False,0
2025-01-07 19:11:03,segienamKuning,704,231,131,139,89,89,87,92,2,3,True,0.22849086864609852
2025-01-07 19:11:03,persegiKuning,705,231,129,140,72,45,75,44,3,1,True,0.4063646812261318
2025-01-07 19:11:03,Fail to pick,704,231,0,0,0,0,0,0,0,0,False,0
2025-01-07 19:11:03,Fail to pick,705,231,0,0,0,0,0,0,0,0,False,0
2025-01-07 19:11:03,persegiKuning,698,222,125,131,199,16,201,18,2,2,True,0.10759499386000555
2025-01-07 19:11:03,Fail to pick,698,222,0,0,0,0,0,0,0,0,False,0
2025-01-07 19:11:03,persegiKuning,628,172,130,148,12,25,15,23,3,2,True,0.23880852086514004
2025-01-07 19:11:03,segienamKuning,689,222,130,134,25,37,25,38,0,1,True,0.1425248750370754
2025-01-07 19:11:03,Kuning,689,222,tensor(130.7089),tensor(134.3331),138,63,139,64,1,1,True,0.0
2025-01-07 19:11:03,segienamKuning,642,179,134,142,56,42,51,43,5,1,True,0.11238950214903305
2025-01-07 19:11:03,segienamKuning,693,225,129,133,105,53,107,57,2,4,True,0.45613118725004387
2025-01-07 19:11:03,segienamKuning,660,188,128,139,150,51,150,48,0,3,True,0.24840994908006353
2025-01-07 19:11:03,persegiKuning,649,184,132,138,60,99,59,97,1,2,True,0.27547521808881875
2025-01-07 19:11:04,segienamKuning,628,165,133,149,10,72,9,74,1,2,True,0.4391022584301648
2025-01-07 19:11:04,persegiKuning,629,165,132,149,91,4,94,2,3,2,True,0.3318637968405538
2025-01-07 19:11:04,Fail to pick,629,165,0,0,0,0,0,0,0,0,False,0
2025-01-07 19:11:04,persegiKuning,645,192,122,140,158,92,154,95,4,3,True,0.11970327099776656
2025-01-07 19:11:04,segienamKuning,645,192,121,142,64,63,68,63,4,0,True,0.3843410418760368
2025-01-07 19:11:04,Fail to pick,645,192,0,0,0,0,0,0,0,0,False,0
2025-01-07 19:11:04,segienamKuning,648,187,131,139,79,45,78,45,1,0,True,0.272388019287363
2025-01-07 19:11:04,Fail to pick,648,187,0,0,0,0,0,0,0,0,False,0
2025-01-07 19:11:04,segienamKuning,652,183,131,143,31,26,33,26,2,0,True,0.15955342239184855
2025-01-07 19:11:04,persegiKuning,654,183,131,142,138,43,135,42,3,1,False,0.26387670170357014
2025-01-07 19:11:04,Fail to pick,652,183,0,0,0,0,0,0,0,0,False,0
2025-01-07 19:11:04,Fail to pick,654,183,0,0,0,0,0,0,0,0,False,0
2025-01-07 19:11:04,segienamKuning,638,174,135,148,190,89,188,91,2,2,True,0.48007555749089026
2025-01-07 19:11:04,persegiKuning,639,174,134,148,28,16,24,11,4,5,True,0.16425115474774934
2025-01-07 19:11:04,Kuning,638,174,tensor(135.8674),tensor(148.9375),151,59,149,56,2,3,True,0.0
2025-01-07 19:11:04,Fail to pick,639,174,0,0,0,0,0,0,0,0,False,0
2025-01-07 19:11:04,segienamKuning,670,203,132,139,73,22,75,19,2,3,True,0.3732492539044885
2025-01-07 19:11:04,persegiKuning,671,203,131,140,181,99,178,98,3,1,True,0.28389966838543923
2025-01-07 19:11:04,Fail to pick,671,203,0,0,0,0,0,0,0,0,False,0
2025-01-07 19:11:04,segienamKuning,652,184,136,141,89,62,86,62,3,0,True,0.11399557832202865
2025-01-07 19:11:05,segienamKuning,656,187,135,139,56,37,57,36,1,1,True,0.3183511910891509
2025-01-07 19:11:05,Fail to pick,656,187,0,0,0,0,0,0,0,0,False,0
2025-01-07 19:11:05,segienamKuning,702,234,131,139,21,20,24,16,3,4,True,0.4027681520270593
2025-01-07 19:11:05,segienamKuning,702,234,131,139,36,98,34,93,2,5,True,0.4572888984269019
2025-01-07 19:11:05,Fail to pick,702,234,0,0,0,0,0,0,0,0,False,0
2025-01-07 19:11:05,segienamKuning,676,216,126,141,86,79,88,77,2,2,True,0.25113957277814747
2025-01-07 19:11:05,persegiKuning,637,177,125,143,158,69,159,67,1,2,True,0.19006669903404833
2025-01-07 19:11:05,segienamKuning,660,206,126,144,144,4,145,-1,1,5,True,0.18719261654620167
2025-01-07 19:11:05,segienamKuning,628,176,129,143,7,71,6,67,1,4,True,0.48180544511885204
2025-01-07 19:11:05,persegiKuning,628,175,126,143,79,64,83,67,4,3,True,0.31279703726184216
2025-01-07 19:11:05,Fail to pick,628,175,0,0,0,0,0,0,0,0,False,0
2025-01-07 19:11:05,segienamKuning,670,210,122,138,196,6,198,6,2,0,True,0.23810688426081855
2025-01-07 19:11:05,persegiKuning,670,210,120,138,199,63,201,59,2,4,True,0.4179578167604896
2025-01-07 19:11:05,Kuning,670,210,tensor(122.3256),tensor(138.2739),141,62,145,64,4,2,True,0.0004999637603759766
2025-01-07 19:11:05,Fail to pick,670,210,0,0,0,0,0,0,0,0,False,0
2025-01-07 19:11:05,segienamKuning,657,193,123,142,163,75,162,73,1,2,True,0.11051623493748589
2025-01-07 19:11:05,persegiKuning,656,194,123,141,191,33,193,33,2,0,False,0.211024536472445
2025-01-07 19:11:05,Fail to pick,656,194,0,0,0,0,0,0,0,0,False,0
2025-01-07 19:11:06,persegiKuning,622,167,129,145,193,40,190,39,3,1,True,0.42067913105599974
2025-01-07 19:11:06,segienamKuning,622,166,130,145,21,6,23,10,2,4,True,0.44265208489349084
2025-01-07 19:11:06,Fail to pick,622,166,0,0,0,0,0,0,0,0,False,0
2025-01-07 19:11:06,persegiKuning,677,207,130,139,98,76,97,77,1,1,True,0.2515202994475646
2025-01-07 19:11:06,persegiKuning,630,181,131,139,100,97,98,93,2,4,True,0.14130972837264735
2025-01-07 19:11:06,segienamKuning,631,183,131,139,103,83,102,85,1,2,True,0.4445986613838636
2025-01-07 19:11:06,Fail to pick,631,183,0,0,0,0,0,0,0,0,False,0
2025-01-07 19:11:06,segienamKuning,655,204,131,143,10,82,11,77,1,5,True,0.1871599796824778
2025-01-07 19:11:06,segienamKuning,630,164,131,146,54,80,49,75,5,5,True,0.35339069960400404
2025-01-07 19:11:06,persegiKuning,630,165,130,145,54,6,52,9,2,3,False,0.24391545095072165
2025-01-07 19:11:06,Fail to pick,630,165,0,0,0,0,0,0,0,0,False,0
2025-01-07 19:11:06,persegiKuning,637,177,129,143,142,41,145,40,3,1,True,0.15745468479236538
2025-01-07 19:11:06,segienamKuning,638,176,126,143,20,54,15,55,5,1,True,0.10665554774920559
2025-01-07 19:11:06,Fail to pick,638,176,0,0,0,0,0,0,0,0,False,0
2025-01-07 19:11:06,segienamKuning,703,232,128,134,135,40,130,39,5,1,True,0.2882030196064805
2025-01-07 19:11:06,Kuning,703,232,tensor(128.1633),tensor(134.1256),135,65,139,61,4,4,True,0.0
2025-01-07 19:11:06,persegiKuning,652,193,133,141,65,63,64,67,1,4,True,0.47013576322703254
2025-01-07 19:11:06,segienamKuning,653,194,133,142,148,61,147,56,1,5,True,0.36992765607139166
2025-01-07 19:11:06,Fail to pick,653,194,0,0,0,0,0,0,0,0,False,0
2025-01-07 19:11:07,segienamKuning,702,225,132,136,55,36,54,36,1,0,True,0.2827793799239171
2025-01-07 19:11:07,persegiKuning,695,228,127,134,33,93,31,88,2,5,True,0.35802659914391766
2025-01-07 19:11:07,segienamKuning,697,227,126,136,39,85,37,87,2,2,True,0.461299481045791
2025-01-07 19:11:07,Fail to pick,695,228,0,0,0,0,0,0,0,0,False,0
2025-01-07 19:11:07,Fail to pick,697,227,0,0,0,0,0,0,0,0,False,0
2025-01-07 19:11:07,segienamKuning,698,227,125,132,77,46,81,50,4,4,True,0.1408037130710389
2025-01-07 19:11:07,Fail to pick,698,227,0,0,0,0,0,0,0,0,False,0
2025-01-07 19:11:07,persegiKuning,694,235,128,140,70,65,73,61,3,4,True,0.21662242068213727
2025-01-07 19:11:07,Fail to pick,694,235,0,0,0,0,0,0,0,0,False,0
2025-01-07 19:11:07,segienamKuning,657,191,129,141,38,0,39,-3,1,3,True,0.3896030585799687
2025-01-07 19:11:07,segienamKuning,700,227,123,136,186,31,188,30,2,1,True,0.40527761960754105
2025-01-07 19:11:07,segienamKuning,685,218,126,136,45,47,47,44,2,3,True,0.3593904344088611
2025-01-07 19:11:07,persegiKuning,695,223,126,137,198,23,193,25,5,2,True,0.19003490833688186
2025-01-07 19:11:07,segienamKuning,695,222,130,137,80,39,78,43,2,4,True,0.3676724375255377
2025-01-07 19:11:07,Fail to pick,695,222,0,0,0,0,0,0,0,0,False,0
2025-01-07 19:11:10,persegiKuning,715,214,132,134,97,61,94,64,3,3,True,0.1401104174469858
2025-01-07 19:11:10,Kuning,715,214,tensor(132.3633),tensor(134.9100),140,66,139,63,1,3,True,0.0
2025-01-07 19:11:10,segienamKuning,721,217,148,135,29,43,28,47,1,4,True,0.21999225805761885
2025-01-07 19:11:10,Fail to pick,721,217,0,0,0,0,0,0,0,0,False,0
2025-01-07 19:11:10,segienamKuning,716,208,141,135,77,82,80,77,3,5,True,0.2646566291403766
2025-01-07 19:11:10,persegiKuning,719,210,138,138,116,85,116,86,0,1,True,0.4320744445726842
2025-01-07 19:11:10,Fail to pick,716,208,0,0,0,0,0,0,0,0,False,0
2025-01-07 19:11:10,Fail to pick,719,210,0,0,0,0,0,0,0,0,False,0
2025-01-07 19:11:10,segienamKuning,716,208,133,135,50,29,47,28,3,1,True,0.24073345784243982
2025-01-07 19:11:10,Fail to pick,716,208,0,0,0,0,0,0,0,0,False,0
2025-01-07 19:11:10,segienamKuning,652,162,125,146,170,49,168,45,2,4,True,0.10300159999510834
2025-01-07 19:11:11,segienamKuning,713,212,125,138,144,5,141,5,3,0,True,0.18761083080674062
2025-01-07 19:11:11,segienamKuning,702,206,130,142,48,62,50,64,2,2,True,0.3209342550540667
2025-01-07 19:11:11,segienamKuning,661,176,132,141,192,61,193,59,1,2,True,0.3739273535463018
2025-01-07 19:11:11,persegiKuning,661,175,130,141,124,36,123,33,1,3,True,0.33483647085254453
2025-01-07 19:11:11,Fail to pick,661,175,0,0,0,0,0,0,0,0,False,0
2025-01-07 19:11:13,segienamKuning,622,490,131,131,93,49,92,49,1,0,True,0.4427745800524817
2025-01-07 19:11:13,persegiKuning,622,491,129,133,97,31,93,31,4,0,False,0.33187276316389946
2025-01-07 19:11:13,Kuning,622,490,tensor(131.9728),tensor(131.0170),63,57,65,61,2,4,True,0.0
2025-01-07 19:11:13,Fail to pick,622,491,0,0,0,0,0,0,0,0,False,0
2025-01-07 19:11:13,persegiKuning,642,503,120,128,62,58,60,57,2,1,True,0.1582801621916838
2025-01-07 19:11:13,segienamKuning,641,503,121,129,93,0,94,3,1,3,True,0.4501164211408536
2025-01-07 19:11:13,lingkaranKuning,638,498,112,121,190,61,185,65,5,4,True,0.2698791926434465
2025-01-07 19:11:13,Fail to pick,641,503,0,0,0,0,0,0,0,0,False,0
2025-01-07 19:11:13,Fail to pick,638,498,0,0,0,0,0,0,0,0,False,0
2025-01-07 19:11:14,persegiKuning,651,495,122,126,157,66,160,67,3,1,True,0.38852045698207316
2025-01-07 19:11:14,persegiKuning,627,497,130,130,99,52,95,51,4,1,True,0.29848578069842735
2025-01-07 19:11:14,segienamKuning,626,497,133,130,152,1,149,-3,3,4,True,0.4183751841224429
2025-01-07 19:11:14,Fail to pick,626,497,0,0,0,0,0,0,0,0,False,0
2025-01-07 19:11:14,segienamKuning,674,518,125,121,178,21,175,25,3,4,True,0.30451783292578766
2025-01-07 19:11:14,lingkaranKuning,671,517,115,119,199,82,196,82,3,0,True,0.12437679426088706
2025-01-07 19:11:14,Fail to pick,671,517,0,0,0,0,0,0,0,0,False,0
2025-01-07 19:11:14,segienamKuning,656,496,128,129,17,46,19,47,2,1,True,0.2548317640667717
2025-01-07 19:11:14,persegiKuning,657,496,127,128,143,59,142,58,1,1,True,0.30545043369982483
2025-01-07 19:11:14,Fail to pick,657,496,0,0,0,0,0,0,0,0,False,0
2025-01-07 19:11:14,segienamKuning,617,489,124,131,5,22,6,19,1,3,True,0.10281534715234182
2025-01-07 19:11:14,persegiKuning,618,490,123,132,78,23,76,23,2,0,True,0.1858505861918879
2025-01-07 19:11:14,Fail to pick,618,490,0,0,0,0,0,0,0,0,False,0
2025-01-07 19:11:14,segienamKuning,635,492,129,133,95,93,98,88,3,5,True,0.12570784755371978
2025-01-07 19:11:14,persegiKuning,635,492,127,132,196,73,194,70,2,3,False,0.35045728626172934
2025-01-07 19:11:14,Fail to pick,635,492,0,0,0,0,0,0,0,0,False,0
2025-01-07 19:11:14,segienamKuning,616,487,123,134,127,94,131,95,4,1,True,0.2789464991729028
2025-01-07 19:11:14,segienamKuning,621,495,127,133,38,71,36,71,2,0,True,0.3866278578174963
2025-01-07 19:11:14,persegiKuning,621,495,127,132,93,28,89,31,4,3,True,0.3723632162750641
2025-01-07 19:11:14,lingkaranKuning,618,489,117,124,162,49,158,53,4,4,True,0.244173481283967
2025-01-07 19:11:14,Fail to pick,621,495,0,0,0,0,0,0,0,0,False,0
2025-01-07 19:11:14,Fail to pick,621,495,0,0,0,0,0,0,0,0,False,0
2025-01-07 19:11:14,Fail to pick,618,489,0,0,0,0,0,0,0,0,False,0
2025-01-07 19:11:14,segienamKuning,604,480,124,137,73,90,74,91,1,1,True,0.3060591329041271
2025-01-07 19:11:14,Kuning,604,480,tensor(124.7751),tensor(137.6281),66,55,65,50,1,5,True,0.0
2025-01-07 19:11:15,segienamKuning,660,517,126,125,104,87,104,91,0,4,True,0.28685308488698935
2025-01-07 19:11:15,lingkaranKuning,660,514,118,120,191,61,194,63,3,2,True,0.47181782268547423
2025-01-07 19:11:15,Fail to pick,660,514,0,0,0,0,0,0,0,0,False,0
2025-01-07 19:11:15,segienamKuning,671,525,120,123,8,84,9,85,1,1,True,0.15308158060753174
2025-01-07 19:11:15,segienamKuning,665,517,119,128,126,85,128,87,2,2,True,0.2732633452032034
2025-01-07 19:11:15,lingkaranKuning,663,514,113,121,63,31,60,32,3,1,True,0.18136659605579328
2025-01-07 19:11:15,Fail to pick,665,517,0,0,0,0,0,0,0,0,False,0
2025-01-07 19:11:15,Fail to pick,663,514,0,0,0,0,0,0,0,0,False,0
2025-01-07 19:11:15,segienamKuning,663,514,123,123,150,28,150,32,0,4,True,0.23262691371554092
2025-01-07 19:11:15,lingkaranKuning,662,511,116,121,65,95,60,92,5,3,True,0.41011514995398746
2025-01-07 19:11:15,Fail to pick,663,514,0,0,0,0,0,0,0,0,False,0
2025-01-07 19:11:15,Fail to pick,662,511,0,0,0,0,0,0,0,0,False,0
2025-01-07 19:11:15,segienamKuning,667,516,122,124,70,45,73,44,3,1,False,0.47195581165353984
2025-01-07 19:11:15,lingkaranKuning,663,512,114,118,197,92,201,89,4,3,True,0.2758286265902917
2025-01-07 19:11:15,Fail to pick,667,516,0,0,0,0,0,0,0,0,False,0
2025-01-07 19:11:15,Fail to pick,663,512,0,0,0,0,0,0,0,0,False,0
2025-01-07 19:11:15,segienamKuning,661,512,125,126,95,27,98,29,3,2,True,0.4988716143636782
2025-01-07 19:11:15,Fail to pick,661,512,0,0,0,0,0,0,0,0,False,0
2025-01-07 19:11:18,segienamKuning,658,519,123,123,80,30,77,33,3,3,True,0.3591126100932631
2025-01-07 19:11:18,persegiKuning,658,518,121,121,82,65,86,69,4,4,True,0.4535716330832753
2025-01-07 19:11:18,lingkaranKuning,657,516,114,118,122,52,123,48,1,4,True,0.3553234860760289
2025-01-07 19:11:18,Fail to pick,658,519,0,0,0,0,0,0,0,0,False,0
2025-01-07 19:11:18,Fail to pick,658,518,0,0,0,0,0,0,0,0,False,0
2025-01-07 19:11:18,Fail to pick,657,516,0,0,0,0,0,0,0,0,False,0
2025-01-07 19:11:18,persegiKuning,652,521,120,128,28,7,24,3,4,4,True,0.3448477189043049
2025-01-07 19:11:18,segienamKuning,651,520,120,126,125,36,128,38,3,2,True,0.2307803316912251
2025-01-07 19:11:18,Kuning,652,521,tensor(120.7167),tensor(128.2635),55,60,51,62,4,2,True,0.0005044937133789062
2025-01-07 19:11:18,Fail to pick,652,521,0,0,0,0,0,0,0,0,False,0
2025-01-07 19:11:18,Fail to pick,651,520,0,0,0,0,0,0,0,0,False,0
2025-01-07 19:11:18,persegiKuning,671,506,123,141,127,22,129,18,2,4,True,0.321661083798075
2025-01-07 19:11:18,segienamKuning,671,506,125,141,31,74,31,72,0,2,True,0.4048993707541386
2025-01-07 19:11:18,Fail to pick,671,506,0,0,0,0,0,0,0,0,False,0
2025-01-07 19:11:18,persegiKuning,618,488,129,158,76,30,71,30,5,0,True,0.2222221460288516
2025-01-07 19:11:18,persegiKuning,659,515,119,126,121,57,125,58,4,1,False,0.4214598790045897
2025-01-07 19:11:19,segienamKuning,612,481,126,143,128,51,126,54,2,3,True,0.26816882268558584
2025-01-07 19:11:19,persegiKuning,613,480,125,140,71,62,75,59,4,3,True,0.3472136140531617
2025-01-07 19:11:19,Fail to pick,613,480,0,0,0,0,0,0,0,0,False,0
2025-01-07 19:11:19,segienamKuning,610,482,125,140,39,59,36,55,3,4,True,0.16916885141572338
2025-01-07 19:11:19,Fail to pick,610,482,0,0,0,0,0,0,0,0,False,0
2025-01-07 19:11:19,segienamKuning,610,481,123,139,94,82,89,80,5,2,False,0.41101331590768175
2025-01-07 19:11:19,persegiKuning,610,480,123,135,7,4,6,6,1,2,True,0.3444418644373528
2025-01-07 19:11:19,Fail to pick,610,481,0,0,0,0,0,0,0,0,False,0
2025-01-07 19:11:19,Fail to pick,610,480,0,0,0,0,0,0,0,0,False,0
2025-01-07 19:11:19,segienamKuning,603,479,127,138,123,14,126,9,3,5,True,0.46658577664568235
2025-01-07 19:11:19,persegiKuning,603,478,124,135,38,96,42,95,4,1,True,0.30397049755343797
2025-01-07 19:11:19,Fail to pick,603,479,0,0,0,0,0,0,0,0,False,0
2025-01-07 19:11:19,Fail to pick,603,478,0,0,0,0,0,0,0,0,False,0
2025-01-07 19:11:19,segienamKuning,661,512,127,122,137,53,133,48,4,5,True,0.17813668820749787
2025-01-07 19:11:19,Kuning,661,512,tensor(127.0148),tensor(122.9371),57,61,56,59,1,2,True,0.0
2025-01-07 19:11:19,persegiKuning,635,500,121,134,148,16,144,15,4,1,True,0.21925186883040643
2025-01-07 19:11:19,segienamKuning,634,500,123,135,91,33,91,37,0,4,True,0.10408830442415358
2025-01-07 19:11:19,lingkaranKuning,634,495,117,124,185,68,188,69,3,1,True,0.4456791210423915
2025-01-07 19:11:19,Fail to pick,634,500,0,0,0,0,0,0,0,0,False,0
2025-01-07 19:11:19,Fail to pick,634,495,0,0,0,0,0,0,0,0,False,0
2025-01-07 19:11:19,segienamKuning,611,480,127,137,181,79,182,75,1,4,True,0.24664180974391936
2025-01-07 19:11:19,segienamKuning,606,484,126,138,70,23,74,22,4,1,True,0.47073588774856856
2025-01-07 19:11:19,persegiKuning,607,484,126,137,105,77,107,75,2,2,True,0.31216888968573064
2025-01-07 19:11:19,Fail to pick,606,484,0,0,0,0,0,0,0,0,False,0
2025-01-07 19:11:19,Fail to pick,607,484,0,0,0,0,0,0,0,0,False,0
2025-01-07 19:11:20,segienamKuning,631,493,126,130,161,49,156,46,5,3,True,0.2659972591277734
2025-01-07 19:11:20,segienamKuning,622,486,126,133,161,72,164,74,3,2,True,0.2279970063459092
2025-01-07 19:11:20,persegiKuning,623,486,126,133,66,49,67,45,1,4,True,0.1485480467184664
2025-01-07 19:11:20,Fail to pick,622,486,0,0,0,0,0,0,0,0,False,0
2025-01-07 19:11:20,Fail to pick,623,486,0,0,0,0,0,0,0,0,False,0
2025-01-07 19:11:20,lingkaranKuning,638,496,112,124,144,33,142,30,2,3,True,0.29430763348332745
2025-01-07 19:11:20,segienamKuning,638,499,115,131,36,70,34,70,2,0,True,0.4330609206621693
2025-01-07 19:11:20,persegiKuning,638,498,115,130,156,80,153,83,3,3,True,0.13923547419756713
2025-01-07 19:11:20,Fail to pick,638,499,0,0,0,0,0,0,0,0,False,0
2025-01-07 19:11:20,Fail to pick,638,498,0,0,0,0,0,0,0,0,False,0
2025-01-07 19:11:20,lingkaranKuning,635,494,114,124,178,38,178,38,0,0,True,0.4798300778326653
2025-01-07 19:11:20,segienamKuning,636,494,120,124,159,92,157,95,2,3,True,0.45361949567172755
2025-01-07 19:11:20,Fail to pick,635,494,0,0,0,0,0,0,0,0,False,0
2025-01-07 19:11:20,Fail to pick,636,494,0,0,0,0,0,0,0,0,False,0
2025-01-07 19:11:20,segienamKuning,632,495,127,131,23,21,26,22,3,1,True,0.47868373789462326
2025-01-07 19:11:20,persegiKuning,632,494,126,130,104,34,108,29,4,5,True,0.45564323938842577
2025-01-07 19:11:20,lingkaranKuning,631,494,118,127,131,39,128,37,3,2,True,0.48239484271581334
2025-01-07 19:11:20,Fail to pick,632,495,0,0,0,0,0,0,0,0,False,0
2025-01-07 19:11:20,Fail to pick,632,494,0,0,0,0,0,0,0,0,False,0
2025-01-07 19:11:20,Fail to pick,631,494,0,0,0,0,0,0,0,0,False,0
2025-01-07 19:11:20,segienamKuning,632,502,120,132,92,73,89,72,3,1,True,0.12371555246722506
2025-01-07 19:11:20,persegiKuning,632,501,118,131,197,60,193,58,4,2,True,0.21467015575499648
2025-01-07 19:11:20,lingkaranKuning,633,497,115,125,58,26,62,28,4,2,True,0.2003583757082409
2025-01-07 19:11:20,Kuning,632,502,tensor(120.3285),tensor(132.6241),60,58,62,55,2,3,True,0.0
2025-01-07 19:11:20,Fail to pick,632,502,0,0,0,0,0,0,0,0,False,0
2025-01-07 19:11:20,Fail to pick,632,501,0,0,0,0,0,0,0,0,False,0
2025-01-07 19:11:20,Fail to pick,633,497,0,0,0,0,0,0,0,0,False,0
2025-01-07 19:11:20,segienamKuning,618,491,120,126,20,23,21,18,1,5,True,0.32672050066433656
2025-01-07 19:11:20,lingkaranKuning,618,488,118,125,64,10,62,11,2,1,True,0.33835517867970993
2025-01-07 19:11:20,Fail to pick,618,488,0,0,0,0,0,0,0,0,False,0
2025-01-07 19:11:20,persegiKuning,616,490,117,130,6,77,3,78,3,1,True,0.4923100951878525
2025-01-07 19:11:20,Fail to pick,616,490,0,0,0,0,0,0,0,0,False,0
2025-01-07 19:11:21,persegiKuning,619,491,124,137,105,45,107,43,2,2,True,0.43325631727498914
2025-01-07 19:11:21,segienamKuning,618,490,125,135,39,32,34,34,5,2,True,0.40912714170270104
2025-01-07 19:11:21,Fail to pick,619,491,0,0,0,0,0,0,0,0,False,0
2025-01-07 19:11:21,Fail to pick,618,490,0,0,0,0,0,0,0,0,False,0
2025-01-07 19:11:21,segienamKuning,615,491,122,134,69,61,66,59,3,2,True,0.1442575304582975
2025-01-07 19:11:21,persegiKuning,616,492,121,136,185,70,182,67,3,3,True,0.14817227137951364
2025-01-07 19:11:21,Fail to pick,615,491,0,0,0,0,0,0,0,0,False,0
2025-01-07 19:11:21,Fail to pick,616,492,0,0,0,0,0,0,0,0,False,0
2025-01-07 19:11:21,persegiKuning,626,499,124,127,80,54,84,50,4,4,True,0.14944011441302366
2025-01-07 19:11:21,lingkaranKuning,623,496,115,124,196,83,198,86,2,3,False,0.12207691847488236
2025-01-07 19:11:21,segienamKuning,626,499,124,129,12,23,16,27,4,4,False,0.48224456520887415
2025-01-07 19:11:21,Fail to pick,623,496,0,0,0,0,0,0,0,0,False,0
2025-01-07 19:11:21,Fail to pick,626,499,0,0,0,0,0,0,0,0,False,0
2025-01-07 19:11:21,lingkaranKuning,635,494,115,125,89,77,84,78,5,1,True,0.26498226687450566
2025-01-07 19:11:21,segienamKuning,635,495,122,130,55,52,53,53,2,1,True,0.4945958425141238
2025-01-07 19:11:21,Fail to pick,635,494,0,0,0,0,0,0,0,0,False,0
2025-01-07 19:11:21,Fail to pick,635,495,0,0,0,0,0,0,0,0,False,0
2025-01-07 19:11:21,segienamKuning,625,489,129,138,13,73,14,76,1,3,True,0.4956140425062131
2025-01-07 19:11:21,persegiKuning,627,490,130,140,94,8,97,3,3,5,False,0.22466090933601432
2025-01-07 19:11:21,Fail to pick,627,490,0,0,0,0,0,0,0,0,False,0
2025-01-07 19:11:21,segienamKuning,646,498,122,130,118,18,114,21,4,3,False,0.3930249085998978
2025-01-07 19:11:21,lingkaranKuning,646,495,118,125,96,99,100,99,4,0,True,0.3481856972116488
2025-01-07 19:11:21,persegiKuning,646,498,121,130,8,10,10,13,2,3,True,0.21193871695294272
2025-01-07 19:11:21,Fail to pick,646,495,0,0,0,0,0,0,0,0,False,0
2025-01-07 19:11:21,Fail to pick,646,498,0,0,0,0,0,0,0,0,False,0
2025-01-07 19:11:21,segienamKuning,613,484,125,137,132,29,127,29,5,0,True,0.11997066097300571
2025-01-07 19:11:21,persegiKuning,615,484,123,136,182,88,178,85,4,3,True,0.16362639654398117
2025-01-07 19:11:21,Kuning,613,484,tensor(125.4570),tensor(137.3599),65,56,62,54,3,2,True,0.0004994869232177734
2025-01-07 19:11:21,Fail to pick,615,484,0,0,0,0,0,0,0,0,False,0
2025-01-07 19:11:21,persegiKuning,627,496,126,134,75,20,79,23,4,3,True,0.19901606296241853
2025-01-07 19:11:21,segienamKuning,627,496,128,135,191,1,189,2,2,1,True,0.3160194796982479
2025-01-07 19:11:21,Fail to pick,627,496,0,0,0,0,0,0,0,0,False,0
2025-01-07 19:11:21,segienamKuning,632,498,123,129,105,83,102,79,3,4,True,0.21194652637679626
2025-01-07 19:11:21,lingkaranKuning,633,496,119,126,39,89,36,89,3,0,True,0.31417208315456313
2025-01-07 19:11:21,Fail to pick,632,498,0,0,0,0,0,0,0,0,False,0
2025-01-07 19:11:21,Fail to pick,633,496,0,0,0,0,0,0,0,0,False,0
2025-01-07 19:11:22,lingkaranKuning,631,497,112,126,178,92,182,89,4,3,True,0.2511503066307418
2025-01-07 19:11:22,persegiKuning,633,500,117,128,149,29,145,25,4,4,True,0.2719925684963898
2025-01-07 19:11:22,Fail to pick,631,497,0,0,0,0,0,0,0,0,False,0
2025-01-07 19:11:22,Fail to pick,633,500,0,0,0,0,0,0,0,0,False,0
2025-01-07 19:11:22,segienamKuning,630,494,122,132,75,87,71,88,4,1,True,0.4522516841948675
2025-01-07 19:11:22,lingkaranKuning,632,494,118,127,52,1,47,-3,5,4,True,0.19872719087484017
2025-01-07 19:11:22,Fail to pick,630,494,0,0,0,0,0,0,0,0,False,0
2025-01-07 19:11:22,Fail to pick,632,494,0,0,0,0,0,0,0,0,False,0
2025-01-07 19:11:22,persegiKuning,640,496,114,133,17,98,18,93,1,5,True,0.29523392178400376
2025-01-07 19:11:22,lingkaranKuning,639,494,109,125,114,60,113,55,1,5,False,0.21385610469700925
2025-01-07 19:11:22,Fail to pick,640,496,0,0,0,0,0,0,0,0,False,0
2025-01-07 19:11:22,Fail to pick,639,494,0,0,0,0,0,0,0,0,False,0
2025-01-07 19:11:22,persegiKuning,621,488,122,134,166,37,168,33,2,4,True,0.13417730647850004
2025-01-07 19:11:22,segienamKuning,621,485,123,136,166,62,164,62,2,0,True,0.37208027544711064
2025-01-07 19:11:22,Fail to pick,621,485,0,0,0,0,0,0,0,0,False,0
2025-01-07 19:11:22,segienamKuning,614,488,125,133,85,59,87,56,2,3,True,0.2884856409414873
2025-01-07 19:11:22,persegiKuning,615,490,122,138,174,86,169,84,5,2,True,0.2934523125292763
2025-01-07 19:11:22,Fail to pick,614,488,0,0,0,0,0,0,0,0,False,0
2025-01-07 19:11:22,Fail to pick,615,490,0,0,0,0,0,0,0,0,False,0
2025-01-07 19:11:22,persegiKuning,625,494,119,137,173,7,168,2,5,5,True,0.333354573323947
2025-01-07 19:11:22,segienamKuning,625,494,119,134,25,78,23,81,2,3,True,0.44519891365182185
2025-01-07 19:11:22,lingkaranKuning,624,494,114,126,189,49,184,52,5,3,True,0.11610871086943386
2025-01-07 19:11:22,Fail to pick,625,494,0,0,0,0,0,0,0,0,False,0
2025-01-07 19:11:22,Fail to pick,624,494,0,0,0,0,0,0,0,0,False,0
2025-01-07 19:11:22,segienamKuning,631,492,123,133,91,18,90,16,1,2,True,0.36294763927713813
2025-01-07 19:11:22,Kuning,631,492,tensor(123.2845),tensor(133.1800),63,58,59,56,4,2,True,0.0005011558532714844
2025-01-07 19:11:22,Fail to pick,631,492,0,0,0,0,0,0,0,0,False,0
2025-01-07 19:11:22,segienamKuning,631,496,122,136,26,42,24,44,2,2,True,0.24715443317932073
2025-01-07 19:11:22,persegiKuning,631,496,120,136,12,63,12,64,0,1,True,0.2878062257319021
2025-01-07 19:11:22,lingkaranKuning,631,488,113,123,1,83,4,83,3,0,True,0.2998606112770992
2025-01-07 19:11:22,Fail to pick,631,496,0,0,0,0,0,0,0,0,False,0
2025-01-07 19:11:22,Fail to pick,631,496,0,0,0,0,0,0,0,0,False,0
2025-01-07 19:11:22,Fail to pick,631,488,0,0,0,0,0,0,0,0,False,0
2025-01-07 19:11:23,segienamKuning,610,478,116,138,12,45,9,48,3,3,True,0.19909993065035927
2025-01-07 19:11:23,persegiKuning,629,487,125,137,60,61,58,56,2,5,True,0.4014378107737997
2025-01-07 19:11:23,segienamKuning,614,487,122,131,152,87,148,91,4,4,True,0.16874054602539768
2025-01-07 19:11:23,persegiKuning,614,487,120,131,46,79,41,75,5,4,True,0.20056907145005237
2025-01-07 19:11:23,Fail to pick,614,487,0,0,0,0,0,0,0,0,False,0
2025-01-07 19:11:23,persegiKuning,607,481,120,137,193,18,193,13,0,5,True,0.43135456301830166
2025-01-07 19:11:23,segienamKuning,606,480,119,134,100,2,104,1,4,1,False,0.44991175107876213
2025-01-07 19:11:23,Fail to pick,607,481,0,0,0,0,0,0,0,0,False,0
2025-01-07 19:11:23,Fail to pick,606,480,0,0,0,0,0,0,0,0,False,0
2025-01-07 19:11:23,segienamKuning,632,494,121,127,186,12,182,7,4,5,True,0.33663190879302685
2025-01-07 19:11:23,persegiKuning,633,495,122,130,31,98,35,94,4,4,True,0.1487732541564656
2025-01-07 19:11:23,Fail to pick,633,495,0,0,0,0,0,0,0,0,False,0
2025-01-07 19:11:26,segienamKuning,569,504,141,123,182,26,181,29,1,3,True,0.20056273065712796
2025-01-07 19:11:26,Kuning,569,504,tensor(141.3712),tensor(123.2454),60,52,57,53,3,1,True,0.0
2025-01-07 19:11:26,segienamKuning,559,499,136,122,82,70,86,68,4,2,True,0.300387779155076
2025-01-07 19:11:27,segienamKuning,559,508,133,125,44,8,39,3,5,5,True,0.353080345122866
2025-01-07 19:11:27,Fail to pick,559,508,0,0,0,0,0,0,0,0,False,0
2025-01-07 19:11:27,segienamKuning,550,500,143,136,128,5,124,5,4,0,True,0.14586726236003114
2025-01-07 19:11:27,Fail to pick,550,500,0,0,0,0,0,0,0,0,False,0
2025-01-07 19:11:56,segienamKuning,646,430,124,134,12,97,8,95,4,2,True,0.39198380092400786
2025-01-07 19:11:56,Kuning,646,430,tensor(124.5178),tensor(134.2792),80,59,80,61,0,2,True,0.0
2025-01-07 19:11:56,segienamKuning,642,433,141,144,102,77,102,80,0,3,True,0.34858105642624027
2025-01-07 19:11:56,Fail to pick,642,433,0,0,0,0,0,0,0,0,False,0
2025-01-07 19:11:56,segienamKuning,651,430,135,138,185,83,188,85,3,2,True,0.20191793457898644
2025-01-07 19:11:56,Fail to pick,651,430,0,0,0,0,0,0,0,0,False,0
2025-01-07 19:11:56,segienamKuning,698,465,122,129,149,31,144,31,5,0,True,0.34413328241091445
2025-01-07 19:11:56,segienamKuning,700,467,124,120,28,59,29,57,1,2,True,0.4857727164713107
2025-01-07 19:11:56,Fail to pick,700,467,0,0,0,0,0,0,0,0,False,0
2025-01-07 19:11:57,segienamKuning,696,464,127,126,130,65,133,68,3,3,True,0.4963223716618722
2025-01-07 19:11:57,Fail to pick,696,464,0,0,0,0,0,0,0,0,False,0
2025-01-07 19:11:57,segienamKuning,646,440,135,131,139,66,139,64,0,2,True,0.25175660259338073
2025-01-07 19:11:57,segienamKuning,692,470,121,115,44,23,39,19,5,4,True,0.3956263095886545
2025-01-07 19:11:57,segienamKuning,707,462,132,126,25,98,25,98,0,0,True,0.25960240210092445
2025-01-07 19:11:57,segienamKuning,697,467,125,119,149,52,144,48,5,4,True,0.25831968931930627
2025-01-07 19:11:57,segienamKuning,695,468,118,115,189,57,192,56,3,1,True,0.33862501284130087
2025-01-07 19:11:57,Fail to pick,695,468,0,0,0,0,0,0,0,0,False,0
2025-01-07 19:11:57,segienamKuning,694,467,128,115,192,76,191,77,1,1,True,0.43044073791530535
2025-01-07 19:11:57,Fail to pick,694,467,0,0,0,0,0,0,0,0,False,0
2025-01-07 19:11:58,segienamKuning,691,466,130,116,176,20,177,20,1,0,True,0.36680935976680995
2025-01-07 19:11:58,Fail to pick,691,466,0,0,0,0,0,0,0,0,False,0
2025-01-07 19:11:58,segienamKuning,700,465,125,116,108,76,109,75,1,1,True,0.39548167662609746
2025-01-07 19:11:58,Fail to pick,700,465,0,0,0,0,0,0,0,0,False,0
2025-01-07 19:11:58,segienamKuning,652,436,124,126,147,23,146,27,1,4,True,0.2114857269356974
2025-01-07 19:11:58,segienamKuning,649,427,132,133,126,34,123,36,3,2,True,0.45716570186214556
2025-01-07 19:11:58,Kuning,649,427,tensor(132.1403),tensor(133.9128),81,60,84,57,3,3,True,0.0005006790161132812
2025-01-07 19:11:58,Fail to pick,649,427,0,0,0,0,0,0,0,0,False,0
2025-01-07 19:11:58,segienamKuning,701,465,125,125,115,18,114,22,1,4,True,0.460103958228572
2025-01-07 19:11:58,segienamKuning,693,468,126,117,106,77,105,75,1,2,True,0.32838193364869916
2025-01-07 19:11:58,Fail to pick,693,468,0,0,0,0,0,0,0,0,False,0
2025-01-07 19:11:58,segienamKuning,710,471,128,114,78,82,82,78,4,4,True,0.32901981363702315
2025-01-07 19:11:58,segienamKuning,649,438,127,125,107,60,108,61,1,1,True,0.41796611288830465
2025-01-07 19:11:58,segienamKuning,698,467,121,122,93,76,92,78,1,2,True,0.4322515891016352
2025-01-07 19:11:59,segienamKuning,695,463,121,120,65,60,64,63,1,3,True,0.14621397519454635
2025-01-07 19:11:59,Fail to pick,695,463,0,0,0,0,0,0,0,0,False,0
2025-01-07 19:11:59,segienamKuning,627,430,130,134,127,58,128,54,1,4,True,0.2866365011883465
2025-01-07 19:11:59,segienamKuning,647,428,129,131,166,79,164,74,2,5,True,0.3701946290594147
2025-01-07 19:11:59,segienamKuning,651,434,133,126,198,39,199,38,1,1,True,0.49331098498200265
2025-01-07 19:11:59,Fail to pick,651,434,0,0,0,0,0,0,0,0,False,0
2025-01-07 19:11:59,segienamKuning,643,434,132,127,126,97,123,101,3,4,True,0.3871250228831369
2025-01-07 19:11:59,Fail to pick,643,434,0,0,0,0,0,0,0,0,False,0
2025-01-07 19:12:00,persegiKuning,738,259,133,149,27,75,23,71,4,4,True,0.2777230343686793
2025-01-07 19:12:00,segienamKuning,738,258,131,147,164,60,161,59,3,1,True,0.39231581659140635
2025-01-07 19:12:00,Kuning,738,259,tensor(133.0712),tensor(149.9412),128,68,130,72,2,4,True,0.0004992485046386719
2025-01-07 19:12:00,Fail to pick,738,258,0,0,0,0,0,0,0,0,False,0
2025-01-07 19:12:00,persegiKuning,757,282,116,152,175,80,175,81,0,1,True,0.4713655684055087
2025-01-07 19:12:00,segienamKuning,758,279,115,149,89,22,91,24,2,2,True,0.4935919081479002
2025-01-07 19:12:00,Fail to pick,758,279,0,0,0,0,0,0,0,0,False,0
2025-01-07 19:12:00,persegiKuning,753,266,125,149,44,93,46,96,2,3,True,0.31939862268385033
2025-01-07 19:12:00,segienamKuning,753,265,125,147,10,38,13,34,3,4,True,0.1284566902950803
2025-01-07 19:12:00,Fail to pick,753,265,0,0,0,0,0,0,0,0,False,0
2025-01-07 19:12:01,segienamKuning,803,303,119,129,109,93,111,93,2,0,True,0.42722106445702634
2025-01-07 19:12:01,segienamKuning,729,252,127,142,12,5,13,6,1,1,True,0.45978152674468187
2025-01-07 19:12:01,segienamKuning,752,279,123,131,199,40,197,38,2,2,True,0.4972727045350964
2025-01-07 19:12:01,segienamKuning,774,293,112,131,98,85,98,83,0,2,True,0.1958618048968838
2025-01-07 19:12:01,segienamKuning,766,276,122,128,8,27,6,31,2,4,True,0.2598787093845849
2025-01-07 19:12:01,segienamKuning,763,284,122,137,13,4,11,6,2,2,True,0.4321086774800299
2025-01-07 19:12:01,Fail to pick,763,284,0,0,0,0,0,0,0,0,False,0
2025-01-07 19:12:01,segienamKuning,759,272,126,134,140,73,140,72,0,1,True,0.22722053749487411
2025-01-07 19:12:01,segienamKuning,800,305,122,127,37,11,33,8,4,3,True,0.47545496443008817
2025-01-07 19:12:02,segienamKuning,801,310,125,125,127,88,131,84,4,4,True,0.49557141898666657
2025-01-07 19:12:02,Fail to pick,801,310,0,0,0,0,0,0,0,0,False,0
2025-01-07 19:12:02,segienamKuning,809,312,125,126,4,84,0,80,4,4,True,0.39195152312757875
2025-01-07 19:12:02,Fail to pick,809,312,0,0,0,0,0,0,0,0,False,0
2025-01-07 19:12:02,segienamKuning,795,309,122,127,60,57,55,58,5,1,True,0.3503373123240753
2025-01-07 19:12:02,segienamKuning,789,304,123,127,17,31,17,32,0,1,True,0.4671526460033901
2025-01-07 19:12:02,Fail to pick,789,304,0,0,0,0,0,0,0,0,False,0
2025-01-07 19:12:02,segienamKuning,804,308,115,124,137,46,139,49,2,3,True,0.4490696451070716
2025-01-07 19:12:02,segienamKuning,805,311,123,129,103,88,106,89,3,1,True,0.19304855618283046
2025-01-07 19:12:02,Fail to pick,805,311,0,0,0,0,0,0,0,0,False,0
2025-01-07 19:12:02,segienamKuning,801,310,126,127,93,79,94,81,1,2,True,0.14630968197753372
2025-01-07 19:12:02,Fail to pick,801,310,0,0,0,0,0,0,0,0,False,0
2025-01-07 19:12:02,segienamKuning,792,302,128,127,111,9,114,8,3,1,False,0.25076110860250234
2025-01-07 19:12:02,persegiKuning,794,302,127,130,53,95,53,95,0,0,False,0.2713116455808049
2025-01-07 19:12:02,Fail to pick,792,302,0,0,0,0,0,0,0,0,False,0
2025-01-07 19:12:02,Fail to pick,794,302,0,0,0,0,0,0,0,0,False,0
2025-01-07 19:12:03,segienamKuning,805,308,121,126,171,80,172,77,1,3,True,0.1902527813630874
2025-01-07 19:12:03,Kuning,805,308,tensor(121.7433),tensor(126.2259),114,74,110,76,4,2,True,0.0
2025-01-07 19:12:05,segienamKuning,637,302,127,125,14,40,10,35,4,5,True,0.15061277069083429
2025-01-07 19:12:06,segienamKuning,620,308,149,129,127,2,126,1,1,1,True,0.16964106883495378
2025-01-07 19:12:08,segienamKuning,815,475,127,130,127,11,129,14,2,3,True,0.33698863357744907
2025-01-07 19:12:08,Kuning,815,475,tensor(127.3998),tensor(130.0811),68,75,66,73,2,2,True,0.0
2025-01-07 19:12:08,segienamKuning,842,494,125,114,76,60,79,60,3,0,True,0.38397759847011625
2025-01-07 19:12:08,segienamKuning,809,470,127,125,40,63,43,62,3,1,True,0.4399359205169273
2025-01-07 19:12:08,segienamKuning,811,473,127,123,61,15,65,11,4,4,False,0.13206475194774267
2025-01-07 19:12:08,Fail to pick,811,473,0,0,0,0,0,0,0,0,False,0
2025-01-07 19:12:08,segienamKuning,811,473,127,123,150,24,150,24,0,0,True,0.12613962988309996
2025-01-07 19:12:08,Fail to pick,811,473,0,0,0,0,0,0,0,0,False,0
2025-01-07 19:12:08,segienamKuning,801,466,126,126,76,22,77,23,1,1,True,0.41371048365391994
2025-01-07 19:12:08,segienamKuning,792,467,125,122,35,99,36,94,1,5,True,0.22721370638200802
2025-01-07 19:12:08,Fail to pick,792,467,0,0,0,0,0,0,0,0,False,0
2025-01-07 19:12:08,segienamKuning,795,462,128,131,112,34,116,36,4,2,False,0.429849447387217
2025-01-07 19:12:08,Fail to pick,795,462,0,0,0,0,0,0,0,0,False,0
2025-01-07 19:12:08,segienamKuning,802,466,124,124,148,61,152,58,4,3,True,0.22122040503363538
2025-01-07 19:12:08,Fail to pick,802,466,0,0,0,0,0,0,0,0,False,0
2025-01-07 19:12:09,segienamKuning,817,470,125,125,193,42,191,46,2,4,True,0.33853727984921483
2025-01-07 19:12:09,segienamKuning,777,457,128,127,189,87,187,88,2,1,True,0.2418727071760985
2025-01-07 19:12:09,segienamKuning,810,474,127,119,173,42,171,42,2,0,True,0.12599179716769215
2025-01-07 19:12:09,segienamKuning,810,477,125,121,91,1,86,0,5,1,True,0.1719189191163556
2025-01-07 19:12:09,Fail to pick,810,477,0,0,0,0,0,0,0,0,False,0
2025-01-07 19:12:09,segienamKuning,797,459,132,131,118,76,119,73,1,3,True,0.10217178100423495
2025-01-07 19:12:09,segienamKuning,835,496,124,115,142,66,146,66,4,0,True,0.32221818216487474
2025-01-07 19:12:09,segienamKuning,840,494,123,115,92,15,96,16,4,1,True,0.10659330557282468
2025-01-07 19:12:09,Fail to pick,840,494,0,0,0,0,0,0,0,0,False,0
2025-01-07 19:12:09,segienamKuning,832,493,124,113,8,26,11,21,3,5,True,0.2173911321653993
2025-01-07 19:12:09,Fail to pick,832,493,0,0,0,0,0,0,0,0,False,0
2025-01-07 19:12:09,segienamKuning,832,493,124,113,36,40,33,44,3,4,True,0.11140172109810056
2025-01-07 19:12:09,Fail to pick,832,493,0,0,0,0,0,0,0,0,False,0
2025-01-07 19:12:10,segienamKuning,787,466,124,125,179,49,177,46,2,3,True,0.20901705406121418
2025-01-07 19:12:10,segienamKuning,838,499,124,113,118,66,116,64,2,2,True,0.3527816352139844
2025-01-07 19:12:10,segienamKuning,816,484,126,118,164,26,167,29,3,3,False,0.4426138343016983
2025-01-07 19:12:10,segienamKuning,794,460,126,128,158,96,161,97,3,1,True,0.20047633543944154
2025-01-07 19:12:10,segienamKuning,805,471,122,116,147,80,148,84,1,4,True,0.1901036224393117
2025-01-07 19:12:10,segienamKuning,797,465,128,123,106,63,106,62,0,1,True,0.13950667865511887
2025-01-07 19:12:10,Fail to pick,797,465,0,0,0,0,0,0,0,0,False,0
2025-01-07 19:12:10,segienamKuning,804,469,120,123,46,77,48,81,2,4,True,0.3498115226796854
2025-01-07 19:12:10,Fail to pick,804,469,0,0,0,0,0,0,0,0,False,0
2025-01-07 19:12:10,segienamKuning,804,470,120,116,163,28,164,32,1,4,True,0.26156842130237745
2025-01-07 19:12:10,Fail to pick,804,470,0,0,0,0,0,0,0,0,False,0
2025-01-07 19:12:11,segienamKuning,807,472,122,122,121,52,122,49,1,3,True,0.3344849688521193
2025-01-07 19:12:11,Fail to pick,807,472,0,0,0,0,0,0,0,0,False,0
2025-01-07 19:12:11,segienamKuning,807,472,122,122,96,32,98,35,2,3,True,0.2193223916994963
2025-01-07 19:12:11,Fail to pick,807,472,0,0,0,0,0,0,0,0,False,0
2025-01-07 19:12:11,segienamKuning,840,497,125,113,38,0,40,3,2,3,True,0.1957733008032502
2025-01-07 19:12:11,segienamKuning,804,475,126,125,35,41,34,43,1,2,True,0.2617885882374724
2025-01-07 19:12:11,segienamKuning,798,466,130,125,97,87,94,85,3,2,False,0.44435450036645796
2025-01-07 19:12:11,Fail to pick,798,466,0,0,0,0,0,0,0,0,False,0
2025-01-07 19:12:11,segienamKuning,804,472,120,121,159,60,162,62,3,2,True,0.1768727660234665
2025-01-07 19:12:11,Fail to pick,804,472,0,0,0,0,0,0,0,0,False,0
2025-01-07 19:12:11,segienamKuning,797,457,126,123,192,37,188,38,4,1,True,0.172254194298047
2025-01-07 19:12:11,segienamKuning,840,500,122,111,104,92,101,89,3,3,True,0.1085093796314462
2025-01-07 19:12:11,segienamKuning,792,462,132,125,42,47,42,46,0,1,False,0.1056272243267082
2025-01-07 19:12:12,segienamKuning,800,460,128,127,101,73,103,72,2,1,True,0.133493061232113
2025-01-07 19:12:12,Fail to pick,800,460,0,0,0,0,0,0,0,0,False,0
2025-01-07 19:12:12,segienamKuning,840,497,127,113,34,81,29,83,5,2,True,0.38379318292169096
2025-01-07 19:12:12,segienamKuning,785,455,130,126,56,0,52,1,4,1,True,0.2987562658366988
2025-01-07 19:12:12,segienamKuning,812,472,128,125,93,60,95,57,2,3,True,0.30347370669649126
2025-01-07 19:12:12,segienamKuning,791,466,129,128,34,91,31,87,3,4,True,0.12484595946920836
2025-01-07 19:12:12,segienamKuning,797,468,124,119,165,57,164,60,1,3,True,0.44877903233159133
2025-01-07 19:12:12,Fail to pick,797,468,0,0,0,0,0,0,0,0,False,0
2025-01-07 19:12:12,segienamKuning,808,469,120,122,91,97,93,96,2,1,True,0.10372927221217099
2025-01-07 19:12:12,segienamKuning,837,500,125,114,179,83,176,85,3,2,True,0.42522389617931156
2025-01-07 19:12:12,segienamKuning,786,459,136,132,91,22,89,21,2,1,True,0.11443051213277236
2025-01-07 19:12:13,segienamKuning,788,453,137,130,146,1,149,2,3,1,True,0.4074591298496758
2025-01-07 19:12:13,Fail to pick,788,453,0,0,0,0,0,0,0,0,False,0
2025-01-07 19:12:14,segienamKuning,709,293,128,132,117,71,116,69,1,2,True,0.2970722046732939
2025-01-07 19:12:14,Kuning,709,293,tensor(128.1465),tensor(132.3400),118,65,119,67,1,2,True,0.0004980564117431641
2025-01-07 19:12:14,segienamKuning,635,227,124,142,67,0,63,0,4,0,True,0.286691365827732
2025-01-07 19:12:14,segienamKuning,705,286,124,136,156,52,160,54,4,2,True,0.11684625834363326
2025-01-07 19:12:14,segienamKuning,706,287,122,127,119,4,115,4,4,0,True,0.21822236574613943
2025-01-07 19:12:14,Fail to pick,706,287,0,0,0,0,0,0,0,0,False,0
2025-01-07 19:12:14,segienamKuning,706,287,122,127,9,9,6,10,3,1,True,0.3100895679537703
2025-01-07 19:12:14,Fail to pick,706,287,0,0,0,0,0,0,0,0,False,0
2025-01-07 19:12:14,segienamKuning,707,286,126,134,153,53,149,57,4,4,True,0.28246983847108453
2025-01-07 19:12:14,Fail to pick,707,286,0,0,0,0,0,0,0,0,False,0
2025-01-07 19:12:14,segienamKuning,711,280,123,129,159,59,161,62,2,3,True,0.44087477328708147
2025-01-07 19:12:14,Fail to pick,711,280,0,0,0,0,0,0,0,0,False,0
2025-01-07 19:12:14,segienamKuning,705,280,127,130,137,92,136,94,1,2,True,0.37552489961637225
2025-01-07 19:12:14,Fail to pick,705,280,0,0,0,0,0,0,0,0,False,0
2025-01-07 19:12:14,segienamKuning,705,280,120,129,195,3,199,1,4,2,True,0.3985196192036279
2025-01-07 19:12:14,Fail to pick,705,280,0,0,0,0,0,0,0,0,False,0
2025-01-07 19:12:14,segienamKuning,638,230,126,147,29,62,26,60,3,2,False,0.19743190944498382
2025-01-07 19:12:15,segienamKuning,702,288,134,128,156,10,156,7,0,3,True,0.38051781834524756
2025-01-07 19:12:15,Kuning,702,288,tensor(134.0648),tensor(128.8817),120,65,120,66,0,1,True,0.0
2025-01-07 19:12:15,segienamKuning,711,285,125,126,190,69,191,71,1,2,True,0.3850701225879579
2025-01-07 19:12:15,Fail to pick,711,285,0,0,0,0,0,0,0,0,False,0
2025-01-07 19:12:15,segienamKuning,711,281,130,134,165,44,164,45,1,1,True,0.27005448486755834
2025-01-07 19:12:15,Fail to pick,711,281,0,0,0,0,0,0,0,0,False,0
2025-01-07 19:12:15,segienamKuning,709,284,129,136,146,99,144,102,2,3,True,0.17239379061549964
2025-01-07 19:12:15,Fail to pick,709,284,0,0,0,0,0,0,0,0,False,0
2025-01-07 19:12:15,segienamKuning,712,278,120,135,40,58,43,59,3,1,False,0.10933501792575516
2025-01-07 19:12:15,persegiKuning,714,278,120,136,88,28,92,28,4,0,True,0.4324305266917581
2025-01-07 19:12:15,Fail to pick,712,278,0,0,0,0,0,0,0,0,False,0
2025-01-07 19:12:15,Fail to pick,714,278,0,0,0,0,0,0,0,0,False,0
2025-01-07 19:12:15,segienamKuning,704,287,129,129,96,52,97,52,1,0,True,0.4214315137488238
2025-01-07 19:12:15,segienamKuning,647,244,134,130,84,22,87,17,3,5,True,0.2904817325723133
2025-01-07 19:12:15,segienamKuning,647,241,138,137,141,8,144,12,3,4,True,0.27154595421585603
2025-01-07 19:12:15,Fail to pick,647,241,0,0,0,0,0,0,0,0,False,0
2025-01-07 19:12:16,segienamKuning,707,280,126,128,78,35,79,37,1,2,False,0.461719287957008
2025-01-07 19:12:16,segienamKuning,709,286,128,132,167,12,167,10,0,2,True,0.4865328149815701
2025-01-07 19:12:16,Kuning,709,286,tensor(128.8474),tensor(132.9971),120,65,117,63,3,2,True,0.0004990100860595703
2025-01-07 19:12:16,Fail to pick,709,286,0,0,0,0,0,0,0,0,False,0
2025-01-07 19:12:16,segienamKuning,704,284,124,126,157,60,157,61,0,1,True,0.44111661405436997
2025-01-07 19:12:16,Fail to pick,704,284,0,0,0,0,0,0,0,0,False,0
2025-01-07 19:12:16,segienamKuning,654,240,127,134,170,24,173,28,3,4,False,0.3196844979695539
2025-01-07 19:12:16,persegiKuning,644,232,119,140,197,80,197,82,0,2,True,0.27121833437636
2025-01-07 19:12:16,segienamKuning,712,289,122,132,12,58,15,53,3,5,True,0.3013968962735136
2025-01-07 19:12:16,persegiKuning,650,245,122,134,5,31,3,30,2,1,True,0.1169520932427663
2025-01-07 19:12:16,segienamKuning,650,246,123,134,7,92,4,96,3,4,True,0.4975207488022805
2025-01-07 19:12:16,Fail to pick,650,246,0,0,0,0,0,0,0,0,False,0
2025-01-07 19:12:16,segienamKuning,702,285,129,131,191,40,194,39,3,1,True,0.26656012924327055
2025-01-07 19:12:16,segienamKuning,713,276,125,130,20,89,24,91,4,2,True,0.4465738297302152
2025-01-07 19:12:17,segienamKuning,704,284,131,125,74,85,77,85,3,0,True,0.33278957659071506
2025-01-07 19:12:17,Fail to pick,704,284,0,0,0,0,0,0,0,0,False,0
2025-01-07 19:12:17,persegiKuning,710,281,127,129,47,23,44,21,3,2,True,0.11568715683125529
2025-01-07 19:12:17,Fail to pick,710,281,0,0,0,0,0,0,0,0,False,0
2025-01-07 19:12:17,segienamKuning,703,285,130,129,38,44,39,39,1,5,True,0.24475520943508433
2025-01-07 19:12:18,Fail to pick,703,285,0,0,0,0,0,0,0,0,False,0
2025-01-07 19:12:20,segienamKuning,703,263,131,131,63,31,59,30,4,1,True,0.47110737006377346
2025-01-07 19:12:20,persegiKuning,703,264,132,130,43,96,39,94,4,2,True,0.4609371016436219
2025-01-07 19:12:20,Fail to pick,703,264,0,0,0,0,0,0,0,0,False,0
2025-01-07 19:12:20,segienamKuning,708,264,130,132,130,3,125,-2,5,5,True,0.3065744535723006
2025-01-07 19:12:20,Fail to pick,708,264,0,0,0,0,0,0,0,0,False,0
2025-01-07 19:12:20,segienamKuning,703,260,123,137,181,90,181,86,0,4,True,0.4210059197554207
2025-01-07 19:12:20,Fail to pick,703,260,0,0,0,0,0,0,0,0,False,0
2025-01-07 19:12:20,segienamKuning,703,260,123,137,199,80,200,78,1,2,True,0.38753140115039664
2025-01-07 19:12:20,Fail to pick,703,260,0,0,0,0,0,0,0,0,False,0
2025-01-07 19:12:21,segienamKuning,702,262,124,133,181,83,184,84,3,1,True,0.2916600550707559
2025-01-07 19:12:21,persegiKuning,703,261,122,132,100,10,101,14,1,4,True,0.3638650356224816
2025-01-07 19:12:21,Fail to pick,702,262,0,0,0,0,0,0,0,0,False,0
2025-01-07 19:12:21,Fail to pick,703,261,0,0,0,0,0,0,0,0,False,0
2025-01-07 19:12:21,persegiKuning,709,258,131,133,163,24,159,28,4,4,True,0.2631455495833954
2025-01-07 19:12:21,Kuning,709,258,tensor(131.4979),tensor(133.8379),128,65,132,67,4,2,True,0.0004992485046386719
2025-01-07 19:12:21,Fail to pick,709,258,0,0,0,0,0,0,0,0,False,0
2025-01-07 19:12:21,segienamKuning,703,272,120,132,46,35,45,35,1,0,True,0.48925171711413207
2025-01-07 19:12:21,segienamKuning,708,261,129,140,83,27,86,29,3,2,False,0.24547702044714154
2025-01-07 19:12:21,persegiKuning,708,262,130,139,140,75,138,74,2,1,False,0.4535570182320475
2025-01-07 19:12:21,Fail to pick,708,262,0,0,0,0,0,0,0,0,False,0
2025-01-07 19:12:28,segienamKuning,802,562,120,118,161,63,162,58,1,5,True,0.39115171350295175
2025-01-07 19:12:28,segienamKuning,801,561,124,114,198,53,201,49,3,4,True,0.43000217288873255
2025-01-07 19:12:28,Fail to pick,801,561,0,0,0,0,0,0,0,0,False,0
2025-01-07 19:12:29,segienamKuning,802,558,147,120,66,16,69,19,3,3,True,0.28604205196446575
2025-01-07 19:12:29,Fail to pick,802,558,0,0,0,0,0,0,0,0,False,0
2025-01-07 19:12:35,segienamKuning,810,558,133,119,118,83,118,85,0,2,True,0.43476933078289315
2025-01-07 19:12:35,Fail to pick,810,558,0,0,0,0,0,0,0,0,False,0
2025-01-07 19:12:35,segienamKuning,750,531,133,126,126,56,129,52,3,4,True,0.11238444164966062
2025-01-07 19:12:35,segienamKuning,799,562,124,117,151,83,148,81,3,2,False,0.33851548976148327
2025-01-07 19:12:36,segienamKuning,802,557,122,117,10,95,10,97,0,2,True,0.31945350021693975
2025-01-07 19:12:36,Fail to pick,802,557,0,0,0,0,0,0,0,0,False,0
2025-01-07 19:12:36,segienamKuning,795,558,125,112,9,1,9,0,0,1,True,0.3105603210940996
2025-01-07 19:12:36,Fail to pick,795,558,0,0,0,0,0,0,0,0,False,0
2025-01-07 19:12:36,segienamKuning,798,558,124,114,51,42,46,43,5,1,True,0.31540433169971754
2025-01-07 19:12:36,Fail to pick,798,558,0,0,0,0,0,0,0,0,False,0
2025-01-07 19:12:36,segienamKuning,799,562,129,115,114,50,115,45,1,5,True,0.49207992832418135
2025-01-07 19:12:36,Fail to pick,799,562,0,0,0,0,0,0,0,0,False,0
2025-01-07 19:12:36,segienamKuning,809,560,125,111,114,92,114,93,0,1,True,0.2137967232195738
2025-01-07 19:12:36,segienamKuning,809,560,125,111,183,21,184,16,1,5,True,0.1359519288233944
2025-01-07 19:12:36,Fail to pick,809,560,0,0,0,0,0,0,0,0,False,0
2025-01-07 19:12:36,segienamKuning,802,560,124,114,62,51,58,47,4,4,True,0.2948464733299232
2025-01-07 19:12:36,Fail to pick,802,560,0,0,0,0,0,0,0,0,False,0
2025-01-07 19:12:36,segienamKuning,805,561,122,117,183,80,185,83,2,3,True,0.44879034612311164
2025-01-07 19:12:36,Fail to pick,805,561,0,0,0,0,0,0,0,0,False,0
2025-01-07 19:12:37,segienamKuning,801,560,120,111,6,53,3,57,3,4,True,0.10886134635613694
2025-01-07 19:12:37,Fail to pick,801,560,0,0,0,0,0,0,0,0,False,0
2025-01-07 19:12:37,segienamKuning,802,562,125,112,127,61,122,63,5,2,True,0.3420144326225086
2025-01-07 19:12:37,Fail to pick,802,562,0,0,0,0,0,0,0,0,False,0
2025-01-07 19:12:37,segienamKuning,802,562,125,112,82,36,77,35,5,1,True,0.40975944014731613
2025-01-07 19:12:37,Fail to pick,802,562,0,0,0,0,0,0,0,0,False,0
2025-01-07 19:12:37,segienamKuning,806,559,122,114,35,75,32,74,3,1,True,0.146163082977484
2025-01-07 19:12:37,Fail to pick,806,559,0,0,0,0,0,0,0,0,False,0
2025-01-07 19:12:37,segienamKuning,806,557,123,111,29,7,26,9,3,2,True,0.38742322141394303
2025-01-07 19:12:37,Fail to pick,806,557,0,0,0,0,0,0,0,0,False,0
2025-01-07 19:12:37,segienamKuning,752,534,124,134,6,32,9,35,3,3,True,0.3350570210356838
2025-01-07 19:12:37,segienamKuning,754,536,127,129,182,63,184,59,2,4,True,0.4828829001951491
2025-01-07 19:12:37,Fail to pick,754,536,0,0,0,0,0,0,0,0,False,0
2025-01-07 19:12:38,segienamKuning,802,563,124,114,95,70,99,70,4,0,True,0.2357055751388154
2025-01-07 19:12:38,segienamKuning,802,559,123,109,101,10,99,12,2,2,True,0.31558116354531207
2025-01-07 19:12:38,Fail to pick,802,559,0,0,0,0,0,0,0,0,False,0
2025-01-07 19:12:38,segienamKuning,802,565,125,111,192,60,195,63,3,3,True,0.35214640529455676
2025-01-07 19:12:38,Fail to pick,802,565,0,0,0,0,0,0,0,0,False,0
2025-01-07 19:12:38,segienamKuning,804,560,120,115,137,4,136,4,1,0,False,0.49533358527883775
2025-01-07 19:12:38,Fail to pick,804,560,0,0,0,0,0,0,0,0,False,0
2025-01-07 19:12:38,segienamKuning,802,561,123,105,41,8,43,5,2,3,True,0.417126749304529
2025-01-07 19:12:38,Fail to pick,802,561,0,0,0,0,0,0,0,0,False,0
2025-01-07 19:12:38,segienamKuning,799,558,127,109,85,61,85,60,0,1,True,0.3702091023767865
2025-01-07 19:12:38,Fail to pick,799,558,0,0,0,0,0,0,0,0,False,0
2025-01-07 19:12:38,segienamKuning,804,557,120,110,80,41,75,38,5,3,True,0.16045248348815955
2025-01-07 19:12:38,Fail to pick,804,557,0,0,0,0,0,0,0,0,False,0
2025-01-07 19:12:39,segienamKuning,779,431,122,117,180,32,175,35,5,3,True,0.23380212918773982
2025-01-07 19:12:39,Kuning,779,431,tensor(122.4729),tensor(117.0615),80,72,84,73,4,1,True,0.0
2025-01-07 19:12:39,segienamKuning,780,435,122,119,180,32,178,36,2,4,True,0.11899992320026281
2025-01-07 19:12:39,Fail to pick,780,435,0,0,0,0,0,0,0,0,False,0
2025-01-07 19:12:39,segienamKuning,781,435,120,117,97,27,92,30,5,3,True,0.4827798676923375
2025-01-07 19:12:39,Fail to pick,781,435,0,0,0,0,0,0,0,0,False,0
2025-01-07 19:12:39,segienamKuning,743,411,120,124,170,10,167,12,3,2,True,0.49106738309425024
2025-01-07 19:12:40,segienamKuning,785,430,118,118,63,79,58,74,5,5,True,0.13536090225938222
2025-01-07 19:12:40,segienamKuning,734,392,128,127,138,88,133,90,5,2,True,0.45635041752921823
2025-01-07 19:12:40,segienamKuning,788,435,127,118,105,6,104,1,1,5,True,0.3400681375393977
2025-01-07 19:12:40,segienamKuning,784,436,126,122,46,9,44,5,2,4,True,0.4512217566386202
2025-01-07 19:12:40,Fail to pick,784,436,0,0,0,0,0,0,0,0,False,0
2025-01-07 19:12:40,segienamKuning,743,402,122,125,175,73,172,70,3,3,True,0.11717344549296707
2025-01-07 19:12:40,persegiKuning,744,403,120,126,113,0,116,1,3,1,True,0.4127767918736458
2025-01-07 19:12:40,Fail to pick,744,403,0,0,0,0,0,0,0,0,False,0
2025-01-07 19:12:40,segienamKuning,777,431,127,129,25,2,24,5,1,3,True,0.2425721337489554
2025-01-07 19:12:40,Kuning,777,431,tensor(127.1482),tensor(129.8263),80,71,82,73,2,2,True,0.0004992485046386719
2025-01-07 19:12:40,segienamKuning,734,402,132,129,151,30,155,29,4,1,True,0.3993105933683786
2025-01-07 19:12:41,segienamKuning,782,432,126,122,179,6,179,2,0,4,True,0.3911904759482163
2025-01-07 19:12:41,segienamKuning,781,431,124,124,174,98,170,95,4,3,True,0.3254540274247061
2025-01-07 19:12:41,Fail to pick,781,431,0,0,0,0,0,0,0,0,False,0
2025-01-07 19:12:41,segienamKuning,726,403,122,134,143,84,146,88,3,4,True,0.39787677014817846
2025-01-07 19:12:41,segienamKuning,776,435,119,120,137,1,135,-4,2,5,True,0.3609271965006583
2025-01-07 19:12:41,segienamKuning,775,435,124,121,42,58,38,62,4,4,True,0.3856768790487014
2025-01-07 19:12:41,Fail to pick,775,435,0,0,0,0,0,0,0,0,False,0
2025-01-07 19:12:41,segienamKuning,783,434,130,118,164,6,164,2,0,4,True,0.19137055279233084
2025-01-07 19:12:41,Fail to pick,783,434,0,0,0,0,0,0,0,0,False,0
2025-01-07 19:12:41,segienamKuning,786,433,129,120,83,73,86,75,3,2,True,0.244153239864706
2025-01-07 19:12:41,Fail to pick,786,433,0,0,0,0,0,0,0,0,False,0
2025-01-07 19:12:41,segienamKuning,776,431,124,117,77,82,80,80,3,2,False,0.18799672931769093
2025-01-07 19:12:42,segienamKuning,777,435,124,119,42,39,40,38,2,1,True,0.16940492897060225
2025-01-07 19:12:42,Fail to pick,777,435,0,0,0,0,0,0,0,0,False,0
2025-01-07 19:12:42,segienamKuning,781,436,125,118,170,87,169,83,1,4,True,0.4351033914342841
2025-01-07 19:12:42,Fail to pick,781,436,0,0,0,0,0,0,0,0,False,0
2025-01-07 19:12:42,segienamKuning,781,429,124,124,35,6,34,3,1,3,True,0.34545278436119464
2025-01-07 19:12:42,Fail to pick,781,429,0,0,0,0,0,0,0,0,False,0
2025-01-07 19:12:42,segienamKuning,780,429,125,117,55,39,52,41,3,2,False,0.38409697249157304
2025-01-07 19:12:42,Fail to pick,780,429,0,0,0,0,0,0,0,0,False,0
2025-01-07 19:12:42,segienamKuning,787,432,132,117,44,75,42,78,2,3,True,0.33711004064370664
2025-01-07 19:12:42,Fail to pick,787,432,0,0,0,0,0,0,0,0,False,0
2025-01-07 19:12:42,segienamKuning,785,435,132,115,39,36,34,40,5,4,True,0.4676733130951253
2025-01-07 19:12:42,Fail to pick,785,435,0,0,0,0,0,0,0,0,False,0
2025-01-07 19:12:42,segienamKuning,782,434,126,119,92,97,96,93,4,4,True,0.4545361450486154
2025-01-07 19:12:42,Fail to pick,782,434,0,0,0,0,0,0,0,0,False,0
2025-01-07 19:14:11,segienamKuning,748,339,126,109,171,75,169,73,2,2,True,0.43991392737503965
2025-01-07 19:14:11,segienamKuning,756,339,146,124,76,69,80,65,4,4,True,0.1913141869822546
2025-01-07 19:14:11,Fail to pick,756,339,0,0,0,0,0,0,0,0,False,0
2025-01-07 19:14:11,persegiKuning,728,331,116,128,7,42,5,44,2,2,False,0.21765829499729994
2025-01-07 19:14:11,segienamKuning,740,341,118,113,79,63,76,58,3,5,True,0.27740596583911425
2025-01-07 19:14:11,persegiKuning,740,341,117,114,193,93,196,89,3,4,True,0.32773014206557854
2025-01-07 19:14:11,Fail to pick,740,341,0,0,0,0,0,0,0,0,False,0
2025-01-07 19:14:12,persegiKuning,752,339,118,114,118,68,121,63,3,5,True,0.24664333444388561
2025-01-07 19:14:12,segienamKuning,751,338,118,113,178,3,182,2,4,1,True,0.43234254157725605
2025-01-07 19:14:12,lingkaranKuning,751,339,114,115,86,37,81,38,5,1,True,0.18793520009957743
2025-01-07 19:14:12,Kuning,752,339,tensor(118.7629),tensor(114.5102),105,69,105,69,0,0,True,0.0
2025-01-07 19:14:12,Fail to pick,751,338,0,0,0,0,0,0,0,0,False,0
2025-01-07 19:14:12,Fail to pick,751,339,0,0,0,0,0,0,0,0,False,0
2025-01-07 19:14:12,segienamKuning,740,335,115,111,118,88,119,89,1,1,True,0.23309830578810603
2025-01-07 19:14:12,persegiKuning,740,335,115,111,85,44,80,47,5,3,True,0.1481651620842601
2025-01-07 19:14:12,Fail to pick,740,335,0,0,0,0,0,0,0,0,False,0
2025-01-07 19:14:13,segienamKuning,740,335,115,111,47,13,47,16,0,3,True,0.26601228671551147
2025-01-07 19:14:13,persegiKuning,740,335,115,111,121,32,119,35,2,3,True,0.31200240521107486
2025-01-07 19:14:13,Fail to pick,740,335,0,0,0,0,0,0,0,0,False,0
2025-01-07 19:14:13,Fail to pick,740,335,0,0,0,0,0,0,0,0,False,0
2025-01-07 19:14:13,segienamKuning,759,333,117,115,157,87,156,91,1,4,False,0.4751454871492511
2025-01-07 19:14:13,segienamKuning,755,337,117,114,22,4,19,8,3,4,True,0.2215555368391689
2025-01-07 19:14:13,Fail to pick,755,337,0,0,0,0,0,0,0,0,False,0
2025-01-07 19:14:13,persegiKuning,761,333,117,112,154,25,156,20,2,5,True,0.1246312718160858
2025-01-07 19:14:13,Fail to pick,761,333,0,0,0,0,0,0,0,0,False,0
2025-01-07 19:14:16,persegiKuning,751,350,108,132,143,8,139,10,4,2,True,0.4330131779424463
2025-01-07 19:14:17,persegiKuning,758,338,114,107,34,74,36,72,2,2,True,0.2765707443074634
2025-01-07 19:14:17,lingkaranKuning,760,338,110,111,105,7,105,4,0,3,True,0.2600627700408784
2025-01-07 19:14:17,Fail to pick,760,338,0,0,0,0,0,0,0,0,False,0
2025-01-07 19:14:17,persegiKuning,749,343,117,112,162,45,157,47,5,2,True,0.3740081724370178
2025-01-07 19:14:17,segienamKuning,749,343,118,112,186,43,183,45,3,2,True,0.13665168265421448
2025-01-07 19:14:17,Kuning,749,343,tensor(117.0106),tensor(112.0694),104,69,102,70,2,1,True,0.0
2025-01-07 19:14:17,Fail to pick,749,343,0,0,0,0,0,0,0,0,False,0
2025-01-07 19:14:17,segienamKuning,750,337,120,110,146,58,144,55,2,3,True,0.43401195846607055
2025-01-07 19:14:17,Fail to pick,750,337,0,0,0,0,0,0,0,0,False,0
2025-01-07 19:14:17,segienamKuning,751,341,118,108,120,29,116,28,4,1,True,0.14421138950880402
2025-01-07 19:14:17,Fail to pick,751,341,0,0,0,0,0,0,0,0,False,0
2025-01-07 19:14:17,persegiKuning,750,340,116,105,87,48,87,52,0,4,True,0.20913623609420762
2025-01-07 19:14:17,Fail to pick,750,340,0,0,0,0,0,0,0,0,False,0
2025-01-07 19:14:17,segienamKuning,752,340,119,108,183,60,186,59,3,1,True,0.19735376352572467
2025-01-07 19:14:17,Fail to pick,752,340,0,0,0,0,0,0,0,0,False,0
2025-01-07 19:14:18,persegiKuning,752,342,117,113,97,78,96,75,1,3,True,0.2559696718152221
2025-01-07 19:14:18,segienamKuning,752,342,116,113,22,14,18,17,4,3,True,0.4653230051517411
2025-01-07 19:14:18,Fail to pick,752,342,0,0,0,0,0,0,0,0,False,0
2025-01-07 19:14:18,Fail to pick,752,342,0,0,0,0,0,0,0,0,False,0
2025-01-07 19:14:18,persegiKuning,752,341,114,108,35,77,37,75,2,2,True,0.23248221766400323
2025-01-07 19:14:18,Fail to pick,752,341,0,0,0,0,0,0,0,0,False,0
2025-01-07 19:14:18,persegiKuning,751,342,115,104,59,18,63,13,4,5,True,0.12149845975055906
2025-01-07 19:14:18,Fail to pick,751,342,0,0,0,0,0,0,0,0,False,0
2025-01-07 19:14:18,segienamKuning,755,338,116,104,121,35,117,35,4,0,True,0.2802769250961845
2025-01-07 19:14:18,Fail to pick,755,338,0,0,0,0,0,0,0,0,False,0
2025-01-07 19:14:18,segienamKuning,753,340,118,109,162,24,160,24,2,0,True,0.30276659798496086
2025-01-07 19:14:18,Fail to pick,753,340,0,0,0,0,0,0,0,0,False,0
2025-01-07 19:14:18,segienamKuning,754,341,116,105,25,24,29,26,4,2,True,0.39065120997966507
2025-01-07 19:14:18,Fail to pick,754,341,0,0,0,0,0,0,0,0,False,0
2025-01-07 19:14:18,segienamKuning,753,341,114,106,163,61,166,64,3,3,True,0.2948426823168674
2025-01-07 19:14:18,Fail to pick,753,341,0,0,0,0,0,0,0,0,False,0
2025-01-07 19:14:20,segienamKuning,829,590,112,91,126,6,125,4,1,2,True,0.2453217462553163
2025-01-07 19:14:20,lingkaranKuning,830,590,109,93,101,16,104,20,3,4,True,0.436640608891502
2025-01-07 19:14:20,Kuning,829,590,tensor(112.2217),tensor(91.2591),36,76,35,79,1,3,True,0.0
2025-01-07 19:14:20,Fail to pick,830,590,0,0,0,0,0,0,0,0,False,0
2025-01-07 19:14:20,segienamKuning,830,591,113,91,81,77,83,77,2,0,True,0.3411027474295678
2025-01-07 19:14:20,lingkaranKuning,830,590,110,95,36,73,37,68,1,5,True,0.3992292284617758
2025-01-07 19:14:20,Fail to pick,830,591,0,0,0,0,0,0,0,0,False,0
2025-01-07 19:14:20,Fail to pick,830,590,0,0,0,0,0,0,0,0,False,0
2025-01-07 19:14:20,segienamKuning,830,594,113,95,47,89,48,84,1,5,True,0.14120236716004322
2025-01-07 19:14:20,Fail to pick,830,594,0,0,0,0,0,0,0,0,False,0
2025-01-07 19:14:20,segienamKuning,829,590,110,92,86,7,81,10,5,3,True,0.2641266271625097
2025-01-07 19:14:20,Fail to pick,829,590,0,0,0,0,0,0,0,0,False,0
2025-01-07 19:14:21,segienamKuning,832,591,112,97,41,52,43,51,2,1,True,0.4731146255422781
2025-01-07 19:14:21,Fail to pick,832,591,0,0,0,0,0,0,0,0,False,0
2025-01-07 19:14:21,segienamKuning,829,591,117,94,107,50,109,47,2,3,True,0.3893837242813979
2025-01-07 19:14:21,Fail to pick,829,591,0,0,0,0,0,0,0,0,False,0
2025-01-07 19:14:21,segienamKuning,830,592,115,95,106,54,103,52,3,2,True,0.43462032775422577
2025-01-07 19:14:21,Fail to pick,830,592,0,0,0,0,0,0,0,0,False,0
2025-01-07 19:14:21,segienamKuning,834,589,111,91,118,38,115,42,3,4,True,0.275429689309589
2025-01-07 19:14:21,Fail to pick,834,589,0,0,0,0,0,0,0,0,False,0
2025-01-07 19:14:21,segienamKuning,834,585,115,93,146,40,148,41,2,1,True,0.10665741917917787
2025-01-07 19:14:21,Fail to pick,834,585,0,0,0,0,0,0,0,0,False,0
2025-01-07 19:14:21,segienamKuning,830,589,118,97,97,11,99,11,2,0,True,0.11932089548156172
2025-01-07 19:14:21,Fail to pick,830,589,0,0,0,0,0,0,0,0,False,0
2025-01-07 19:14:25,segienamKuning,833,594,118,96,69,56,72,51,3,5,True,0.3987245693616035
2025-01-07 19:14:25,Fail to pick,833,594,0,0,0,0,0,0,0,0,False,0
2025-01-07 19:14:25,segienamKuning,831,592,122,93,163,94,163,98,0,4,True,0.21904893581380072
2025-01-07 19:14:25,Fail to pick,831,592,0,0,0,0,0,0,0,0,False,0
2025-01-07 19:14:25,segienamKuning,838,592,120,93,85,10,88,11,3,1,True,0.22551260291312392
2025-01-07 19:14:25,Fail to pick,838,592,0,0,0,0,0,0,0,0,False,0
2025-01-07 19:14:25,segienamKuning,836,590,112,89,92,34,92,38,0,4,True,0.3813764778121491
2025-01-07 19:14:25,Fail to pick,836,590,0,0,0,0,0,0,0,0,False,0
2025-01-07 19:14:25,segienamKuning,838,591,121,90,101,20,96,19,5,1,True,0.4673531097871707
2025-01-07 19:14:25,Fail to pick,838,591,0,0,0,0,0,0,0,0,False,0
2025-01-07 19:14:25,segienamKuning,835,591,114,96,196,84,196,84,0,0,True,0.4160852304750652
2025-01-07 19:14:25,Fail to pick,835,591,0,0,0,0,0,0,0,0,False,0
2025-01-07 19:14:25,segienamKuning,839,593,110,95,154,17,149,15,5,2,True,0.44918774190801947
2025-01-07 19:14:25,Fail to pick,839,593,0,0,0,0,0,0,0,0,False,0
2025-01-07 19:14:26,segienamKuning,832,594,118,95,173,56,171,51,2,5,False,0.433482947878003
2025-01-07 19:14:26,Fail to pick,832,594,0,0,0,0,0,0,0,0,False,0
2025-01-07 19:14:26,segienamKuning,833,596,117,93,76,92,79,87,3,5,True,0.4614629079791501
2025-01-07 19:14:26,Fail to pick,833,596,0,0,0,0,0,0,0,0,False,0
2025-01-07 19:14:26,segienamKuning,829,594,115,89,12,80,8,83,4,3,True,0.25706121840913243
2025-01-07 19:14:26,Fail to pick,829,594,0,0,0,0,0,0,0,0,False,0
2025-01-07 19:14:26,segienamKuning,837,593,114,91,92,55,90,53,2,2,True,0.14844308965763076
2025-01-07 19:14:26,Fail to pick,837,593,0,0,0,0,0,0,0,0,False,0
2025-01-07 19:14:26,segienamKuning,831,593,115,93,56,95,58,95,2,0,True,0.21166561524430283
2025-01-07 19:14:26,Fail to pick,831,593,0,0,0,0,0,0,0,0,False,0
2025-01-07 19:14:26,segienamKuning,834,594,114,93,148,78,150,75,2,3,True,0.2068827362196428
2025-01-07 19:14:26,Fail to pick,834,594,0,0,0,0,0,0,0,0,False,0
2025-01-07 19:14:26,segienamKuning,837,594,115,92,82,87,83,86,1,1,True,0.33464912817863757
2025-01-07 19:14:26,Fail to pick,837,594,0,0,0,0,0,0,0,0,False,0
2025-01-07 19:14:26,segienamKuning,836,595,114,93,157,33,153,35,4,2,True,0.39838028131720615
2025-01-07 19:14:26,Fail to pick,836,595,0,0,0,0,0,0,0,0,False,0
2025-01-07 19:14:27,segienamKuning,830,594,119,90,145,38,149,33,4,5,True,0.4713249902052107
2025-01-07 19:14:27,Fail to pick,830,594,0,0,0,0,0,0,0,0,False,0
2025-01-07 19:14:27,segienamKuning,837,592,114,93,16,43,18,41,2,2,True,0.38044959527178923
2025-01-07 19:14:27,Fail to pick,837,592,0,0,0,0,0,0,0,0,False,0
2025-01-07 19:14:27,segienamKuning,835,593,115,89,186,95,187,96,1,1,True,0.38470403952402654
2025-01-07 19:14:27,Fail to pick,835,593,0,0,0,0,0,0,0,0,False,0
2025-01-07 19:14:27,segienamKuning,833,594,120,93,128,18,128,18,0,0,True,0.4900347403604334
2025-01-07 19:14:27,Fail to pick,833,594,0,0,0,0,0,0,0,0,False,0
2025-01-07 19:14:27,segienamKuning,838,592,118,92,124,78,125,78,1,0,True,0.25031427582457255
2025-01-07 19:14:27,Fail to pick,838,592,0,0,0,0,0,0,0,0,False,0
2025-01-07 19:14:27,segienamKuning,837,593,121,87,99,11,95,15,4,4,True,0.31087928854610075
2025-01-07 19:14:27,Fail to pick,837,593,0,0,0,0,0,0,0,0,False,0
2025-01-07 19:14:27,segienamKuning,833,594,116,90,94,66,92,61,2,5,True,0.4329544626331583
2025-01-07 19:14:27,Fail to pick,833,594,0,0,0,0,0,0,0,0,False,0
2025-01-07 19:14:27,segienamKuning,839,591,112,92,77,53,80,56,3,3,True,0.1915602698671769
2025-01-07 19:14:27,Fail to pick,839,591,0,0,0,0,0,0,0,0,False,0
2025-01-07 19:14:28,segienamKuning,839,590,117,93,148,81,148,84,0,3,False,0.3065939652295225
2025-01-07 19:14:28,Fail to pick,839,590,0,0,0,0,0,0,0,0,False,0
2025-01-07 19:14:28,segienamKuning,835,593,119,94,141,84,145,79,4,5,True,0.4006547623684015
2025-01-07 19:14:28,Fail to pick,835,593,0,0,0,0,0,0,0,0,False,0
2025-01-07 19:14:28,segienamKuning,841,589,117,91,54,37,50,35,4,2,True,0.45623551856103983
2025-01-07 19:14:28,Fail to pick,841,589,0,0,0,0,0,0,0,0,False,0
2025-01-07 19:14:28,segienamKuning,836,592,112,89,96,79,92,76,4,3,True,0.23867882528803364
2025-01-07 19:14:28,lingkaranKuning,837,592,110,90,140,66,140,67,0,1,True,0.23108085069172787
2025-01-07 19:14:28,Fail to pick,836,592,0,0,0,0,0,0,0,0,False,0
2025-01-07 19:14:28,Fail to pick,837,592,0,0,0,0,0,0,0,0,False,0
2025-01-07 19:14:28,segienamKuning,620,607,117,84,183,81,181,81,2,0,True,0.30275326570804206
2025-01-07 19:14:28,persegiKuning,833,597,114,104,130,48,125,49,5,1,True,0.2762823913051846
2025-01-07 19:14:28,segienamKuning,833,596,114,104,47,76,51,80,4,4,True,0.24935760566476275
2025-01-07 19:14:28,Kuning,833,597,tensor(114.5753),tensor(104.7555),34,77,33,76,1,1,True,0.0
2025-01-07 19:14:28,segienamKuning,837,593,115,90,0,96,4,94,4,2,True,0.3367559710479427
2025-01-07 19:14:28,Fail to pick,837,593,0,0,0,0,0,0,0,0,False,0
2025-01-07 19:14:28,segienamKuning,834,592,119,87,108,85,105,89,3,4,True,0.2663921082959836
2025-01-07 19:14:28,Fail to pick,834,592,0,0,0,0,0,0,0,0,False,0
2025-01-07 19:14:28,segienamKuning,832,592,119,90,123,42,126,44,3,2,False,0.4593953952952077
2025-01-07 19:14:28,Fail to pick,832,592,0,0,0,0,0,0,0,0,False,0
2025-01-07 19:14:29,segienamKuning,837,597,133,102,98,3,99,4,1,1,True,0.4385317351989225
2025-01-07 19:14:29,Fail to pick,837,597,0,0,0,0,0,0,0,0,False,0
2025-01-07 19:14:29,segienamKuning,833,593,116,92,77,97,74,96,3,1,True,0.32660498863043746
2025-01-07 19:14:29,Fail to pick,833,593,0,0,0,0,0,0,0,0,False,0
2025-01-07 19:14:29,segienamKuning,838,594,118,88,19,25,19,29,0,4,False,0.37213269635338164
2025-01-07 19:14:29,Fail to pick,838,594,0,0,0,0,0,0,0,0,False,0
2025-01-07 19:14:29,segienamKuning,833,593,113,89,28,55,27,54,1,1,True,0.17917627012077403
2025-01-07 19:14:29,Fail to pick,833,593,0,0,0,0,0,0,0,0,False,0
2025-01-07 19:14:29,segienamKuning,830,594,113,89,82,53,84,55,2,2,True,0.12670903976062828
2025-01-07 19:14:29,Fail to pick,830,594,0,0,0,0,0,0,0,0,False,0
2025-01-07 19:14:29,segienamKuning,830,594,113,89,62,2,63,3,1,1,True,0.24451679082266461
2025-01-07 19:14:29,Fail to pick,830,594,0,0,0,0,0,0,0,0,False,0
2025-01-07 19:14:29,segienamKuning,834,595,115,91,53,30,52,31,1,1,True,0.15271762756611207
2025-01-07 19:14:29,Fail to pick,834,595,0,0,0,0,0,0,0,0,False,0
2025-01-07 19:14:29,segienamKuning,837,594,114,91,191,11,194,13,3,2,True,0.49138505203660254
2025-01-07 19:14:29,Fail to pick,837,594,0,0,0,0,0,0,0,0,False,0
2025-01-07 19:14:30,segienamKuning,830,592,123,91,159,44,158,39,1,5,True,0.42765451383857156
2025-01-07 19:14:30,Fail to pick,830,592,0,0,0,0,0,0,0,0,False,0
2025-01-07 19:14:30,segienamKuning,839,597,114,89,127,68,124,68,3,0,True,0.3188867417388429
2025-01-07 19:14:30,Fail to pick,839,597,0,0,0,0,0,0,0,0,False,0
2025-01-07 19:14:30,segienamKuning,839,592,120,90,25,35,21,31,4,4,False,0.3978764295656477
2025-01-07 19:14:30,Fail to pick,839,592,0,0,0,0,0,0,0,0,False,0
2025-01-07 19:14:30,segienamKuning,839,592,117,87,103,60,100,63,3,3,True,0.12301082009423654
2025-01-07 19:14:30,Fail to pick,839,592,0,0,0,0,0,0,0,0,False,0
2025-01-07 19:14:30,segienamKuning,830,589,115,88,58,0,57,2,1,2,False,0.18322778778485113
2025-01-07 19:14:30,Fail to pick,830,589,0,0,0,0,0,0,0,0,False,0
2025-01-07 19:14:30,lingkaranKuning,834,593,111,93,65,21,69,22,4,1,True,0.1891831414986411
2025-01-07 19:14:30,segienamKuning,833,594,113,92,6,59,5,59,1,0,True,0.48045809511191984
2025-01-07 19:14:30,Fail to pick,834,593,0,0,0,0,0,0,0,0,False,0
2025-01-07 19:14:30,Fail to pick,833,594,0,0,0,0,0,0,0,0,False,0
2025-01-07 19:14:34,segienamKuning,858,556,119,96,28,95,32,90,4,5,False,0.38350322542024684
2025-01-07 19:14:34,Kuning,858,556,tensor(119.8286),tensor(96.2747),45,79,47,80,2,1,True,0.0
2025-01-07 19:14:34,segienamKuning,856,556,118,97,161,39,163,34,2,5,True,0.2960349504988161
2025-01-07 19:14:34,Fail to pick,856,556,0,0,0,0,0,0,0,0,False,0
2025-01-07 19:14:34,segienamKuning,872,564,119,95,161,98,160,99,1,1,True,0.3258533632954186
2025-01-07 19:14:34,lingkaranKuning,874,563,114,95,29,14,32,11,3,3,True,0.17954696511746857
2025-01-07 19:14:34,Fail to pick,874,563,0,0,0,0,0,0,0,0,False,0
2025-01-07 19:14:35,segienamKuning,872,564,119,95,131,90,129,91,2,1,True,0.2869454878493687
2025-01-07 19:14:35,lingkaranKuning,874,563,114,95,199,86,196,90,3,4,True,0.19160898994509543
2025-01-07 19:14:35,Fail to pick,872,564,0,0,0,0,0,0,0,0,False,0
2025-01-07 19:14:35,Fail to pick,874,563,0,0,0,0,0,0,0,0,False,0
2025-01-07 19:14:35,segienamKuning,858,553,116,91,114,73,110,77,4,4,True,0.4324153304562256
2025-01-07 19:14:35,segienamKuning,860,556,122,96,180,59,183,60,3,1,True,0.4247516423020984
2025-01-07 19:14:35,Fail to pick,860,556,0,0,0,0,0,0,0,0,False,0
2025-01-07 19:14:35,segienamKuning,862,555,115,93,10,21,10,23,0,2,True,0.3472240150758098
2025-01-07 19:14:35,Fail to pick,862,555,0,0,0,0,0,0,0,0,False,0
2025-01-07 19:14:35,segienamKuning,857,555,115,89,102,89,105,90,3,1,True,0.1996814105079067
2025-01-07 19:14:35,Fail to pick,857,555,0,0,0,0,0,0,0,0,False,0
2025-01-07 19:14:35,segienamKuning,861,555,117,95,130,30,128,33,2,3,True,0.41458347407089247
2025-01-07 19:14:35,Fail to pick,861,555,0,0,0,0,0,0,0,0,False,0
2025-01-07 19:14:35,segienamKuning,857,553,115,96,72,57,73,55,1,2,True,0.4830268957512045
2025-01-07 19:14:35,Fail to pick,857,553,0,0,0,0,0,0,0,0,False,0
2025-01-07 19:14:36,segienamKuning,857,557,115,94,74,1,75,5,1,4,True,0.43750383657253855
2025-01-07 19:14:36,Fail to pick,857,557,0,0,0,0,0,0,0,0,False,0
2025-01-07 19:14:36,segienamKuning,859,554,119,93,31,24,28,28,3,4,True,0.1974111760207453
2025-01-07 19:14:36,Fail to pick,859,554,0,0,0,0,0,0,0,0,False,0
2025-01-07 19:14:36,segienamKuning,862,555,128,96,144,89,146,89,2,0,True,0.13493017512286087
2025-01-07 19:14:36,Fail to pick,862,555,0,0,0,0,0,0,0,0,False,0
2025-01-07 19:14:36,segienamKuning,859,558,122,97,75,62,74,59,1,3,False,0.24239881270923155
2025-01-07 19:14:36,Fail to pick,859,558,0,0,0,0,0,0,0,0,False,0
2025-01-07 19:14:36,segienamKuning,850,555,119,100,19,94,19,95,0,1,False,0.12391987485192564
2025-01-07 19:14:36,Fail to pick,850,555,0,0,0,0,0,0,0,0,False,0
2025-01-07 19:14:36,segienamKuning,853,559,118,98,145,91,149,86,4,5,False,0.22198933822795497
2025-01-07 19:14:36,Fail to pick,853,559,0,0,0,0,0,0,0,0,False,0
2025-01-07 19:14:36,segienamKuning,856,556,117,109,128,6,124,1,4,5,True,0.3223545724179736
2025-01-07 19:14:36,Fail to pick,856,556,0,0,0,0,0,0,0,0,False,0
2025-01-07 19:14:36,segienamKuning,842,531,121,123,67,13,69,11,2,2,True,0.2553563093202186
2025-01-07 19:14:43,segienamKuning,925,23,108,47,83,90,87,85,4,5,True,0.40551559810996707
2025-01-07 19:14:43,segienamKuning,925,23,108,47,175,51,170,51,5,0,True,0.4749147449395902
2025-01-07 19:14:43,Fail to pick,925,23,0,0,0,0,0,0,0,0,False,0
2025-01-07 19:14:43,segienamKuning,947,45,120,90,15,50,12,49,3,1,True,0.12741218357763723
2025-01-07 19:14:43,segienamKuning,947,45,120,90,59,28,61,24,2,4,True,0.14929086039657036
2025-01-07 19:14:43,Fail to pick,947,45,0,0,0,0,0,0,0,0,False,0
2025-01-07 19:14:44,segienamKuning,946,46,115,92,112,38,111,41,1,3,True,0.47674927531291855
2025-01-07 19:14:44,Fail to pick,946,46,0,0,0,0,0,0,0,0,False,0
2025-01-07 19:14:44,segienamKuning,949,46,125,93,125,74,122,76,3,2,True,0.28258594143192584
2025-01-07 19:14:44,Fail to pick,949,46,0,0,0,0,0,0,0,0,False,0
2025-01-07 19:14:44,segienamKuning,945,43,118,87,125,87,128,82,3,5,True,0.43844908621502743
2025-01-07 19:14:44,Fail to pick,945,43,0,0,0,0,0,0,0,0,False,0
2025-01-07 19:14:44,segienamKuning,942,46,117,93,188,91,192,91,4,0,True,0.2064677170153972
2025-01-07 19:14:44,Fail to pick,942,46,0,0,0,0,0,0,0,0,False,0
2025-01-07 19:14:44,segienamKuning,947,45,125,90,91,82,89,82,2,0,True,0.2421013986257895
2025-01-07 19:14:44,segitigaKuning,949,45,124,90,170,84,167,81,3,3,True,0.24415040168492924
2025-01-07 19:14:44,Fail to pick,947,45,0,0,0,0,0,0,0,0,False,0
2025-01-07 19:14:44,Fail to pick,949,45,0,0,0,0,0,0,0,0,False,0
2025-01-07 19:14:44,segienamKuning,942,42,116,85,133,26,131,30,2,4,True,0.33153578690460084
2025-01-07 19:14:44,segitigaKuning,944,42,115,85,174,51,173,46,1,5,True,0.41929213148757605
2025-01-07 19:14:44,Kuning,942,42,tensor(116.5252),tensor(85.3583),188,87,188,89,0,2,True,0.0004994869232177734
2025-01-07 19:14:44,Fail to pick,942,42,0,0,0,0,0,0,0,0,False,0
2025-01-07 19:14:44,Fail to pick,944,42,0,0,0,0,0,0,0,0,False,0
2025-01-07 19:14:44,segienamKuning,940,41,115,82,77,64,81,64,4,0,True,0.3568900825046869
2025-01-07 19:14:44,segitigaKuning,940,41,116,82,79,36,82,35,3,1,False,0.28332580861686385
2025-01-07 19:14:44,Fail to pick,940,41,0,0,0,0,0,0,0,0,False,0
2025-01-07 19:14:44,Fail to pick,940,41,0,0,0,0,0,0,0,0,False,0
2025-01-07 19:14:44,segienamKuning,950,45,119,91,178,19,182,19,4,0,True,0.2069388252926448
2025-01-07 19:14:45,segienamKuning,945,46,119,93,191,32,194,33,3,1,True,0.3888038409170377
2025-01-07 19:14:45,Fail to pick,945,46,0,0,0,0,0,0,0,0,False,0
2025-01-07 19:14:45,segienamKuning,946,46,119,92,155,31,158,31,3,0,True,0.14094500308217628
2025-01-07 19:14:45,Fail to pick,946,46,0,0,0,0,0,0,0,0,False,0
2025-01-07 19:14:45,segienamKuning,944,42,121,85,109,74,105,76,4,2,True,0.12989452265152251
2025-01-07 19:14:45,segitigaKuning,946,42,120,85,81,70,84,73,3,3,True,0.3545340511562153
2025-01-07 19:14:45,Fail to pick,944,42,0,0,0,0,0,0,0,0,False,0
2025-01-07 19:14:45,Fail to pick,946,42,0,0,0,0,0,0,0,0,False,0
2025-01-07 19:14:45,segienamKuning,942,45,116,91,88,28,89,25,1,3,True,0.1481343491669813
2025-01-07 19:14:45,Fail to pick,942,45,0,0,0,0,0,0,0,0,False,0
2025-01-07 19:14:45,segienamKuning,945,45,116,90,99,35,96,34,3,1,True,0.3354231111771851
2025-01-07 19:14:45,segitigaKuning,947,45,114,91,149,53,148,49,1,4,True,0.4449672314319807
2025-01-07 19:14:45,Fail to pick,945,45,0,0,0,0,0,0,0,0,False,0
2025-01-07 19:14:45,Fail to pick,947,45,0,0,0,0,0,0,0,0,False,0
2025-01-07 19:14:45,segienamKuning,943,43,121,86,172,5,173,7,1,2,False,0.2939374121798636
2025-01-07 19:14:45,segitigaKuning,945,42,119,85,182,63,183,66,1,3,True,0.132967398823325
2025-01-07 19:14:45,Fail to pick,943,43,0,0,0,0,0,0,0,0,False,0
2025-01-07 19:14:45,Fail to pick,945,42,0,0,0,0,0,0,0,0,False,0
2025-01-07 19:14:45,segienamKuning,947,44,121,89,185,82,187,79,2,3,True,0.41550809601049477
2025-01-07 19:14:45,Kuning,947,44,tensor(121.7460),tensor(89.1559),187,87,191,89,4,2,True,0.0
2025-01-07 19:14:45,Fail to pick,947,44,0,0,0,0,0,0,0,0,False,0
2025-01-07 19:14:46,segienamKuning,944,41,121,83,188,82,188,78,0,4,True,0.38206884132611496
2025-01-07 19:14:46,segitigaKuning,945,41,120,82,53,27,51,24,2,3,True,0.11310907988518887
2025-01-07 19:14:46,Fail to pick,944,41,0,0,0,0,0,0,0,0,False,0
2025-01-07 19:14:46,Fail to pick,945,41,0,0,0,0,0,0,0,0,False,0
2025-01-07 19:14:46,segienamKuning,942,44,119,88,137,31,141,32,4,1,True,0.10860000050799111
2025-01-07 19:14:46,Fail to pick,942,44,0,0,0,0,0,0,0,0,False,0
2025-01-07 19:14:46,segienamKuning,939,45,114,90,181,89,177,87,4,2,True,0.14339242967448712
2025-01-07 19:14:46,Fail to pick,939,45,0,0,0,0,0,0,0,0,False,0
2025-01-07 19:14:46,segienamKuning,942,44,115,88,184,22,181,19,3,3,True,0.1888182983016065
2025-01-07 19:14:46,Fail to pick,942,44,0,0,0,0,0,0,0,0,False,0
2025-01-07 19:14:46,segienamKuning,945,47,115,94,50,87,45,84,5,3,True,0.4637823246467164
2025-01-07 19:14:46,segitigaKuning,946,47,115,94,154,43,151,44,3,1,True,0.19059278074311536
2025-01-07 19:14:46,Fail to pick,945,47,0,0,0,0,0,0,0,0,False,0
2025-01-07 19:14:46,Fail to pick,946,47,0,0,0,0,0,0,0,0,False,0
2025-01-07 19:14:46,segienamKuning,950,46,120,93,108,79,106,81,2,2,True,0.1738514745596106
2025-01-07 19:14:46,Fail to pick,950,46,0,0,0,0,0,0,0,0,False,0
2025-01-07 19:14:46,segienamKuning,944,42,121,85,2,28,-3,24,5,4,True,0.2464827398068677
2025-01-07 19:14:46,segitigaKuning,945,42,119,85,80,39,77,38,3,1,True,0.4032157824305467
2025-01-07 19:14:46,Fail to pick,944,42,0,0,0,0,0,0,0,0,False,0
2025-01-07 19:14:46,Fail to pick,945,42,0,0,0,0,0,0,0,0,False,0
2025-01-07 19:14:47,segienamKuning,941,42,120,85,148,58,145,62,3,4,False,0.2072061880487901
2025-01-07 19:14:47,segitigaKuning,943,42,119,84,91,43,92,46,1,3,True,0.12204423168343381
2025-01-07 19:14:47,Kuning,941,42,tensor(120.1635),tensor(85.8940),188,87,191,87,3,0,True,0.0004975795745849609
2025-01-07 19:14:47,Fail to pick,941,42,0,0,0,0,0,0,0,0,False,0
2025-01-07 19:14:47,Fail to pick,943,42,0,0,0,0,0,0,0,0,False,0
2025-01-07 19:14:47,segienamKuning,941,42,120,85,94,39,98,41,4,2,True,0.4308277145545881
2025-01-07 19:14:47,segitigaKuning,943,42,119,84,118,62,120,57,2,5,True,0.21790457871914423
2025-01-07 19:14:47,Fail to pick,941,42,0,0,0,0,0,0,0,0,False,0
2025-01-07 19:14:47,Fail to pick,943,42,0,0,0,0,0,0,0,0,False,0
2025-01-07 19:14:47,segienamKuning,941,45,118,90,78,39,75,36,3,3,True,0.1099148809617919
2025-01-07 19:14:47,Fail to pick,941,45,0,0,0,0,0,0,0,0,False,0
2025-01-07 19:14:47,segienamKuning,941,44,117,89,9,20,5,17,4,3,False,0.3840662900768248
2025-01-07 19:14:47,Fail to pick,941,44,0,0,0,0,0,0,0,0,False,0
2025-01-07 19:14:47,segienamKuning,943,46,119,92,146,40,145,38,1,2,True,0.37669612397972807
2025-01-07 19:14:47,Fail to pick,943,46,0,0,0,0,0,0,0,0,False,0
2025-01-07 19:14:47,segienamKuning,943,45,119,91,193,70,190,73,3,3,True,0.22506337577325852
2025-01-07 19:14:47,segitigaKuning,945,45,118,90,184,89,182,91,2,2,True,0.1103096866588032
2025-01-07 19:14:47,Fail to pick,943,45,0,0,0,0,0,0,0,0,False,0
2025-01-07 19:14:47,Fail to pick,945,45,0,0,0,0,0,0,0,0,False,0
2025-01-07 19:14:47,segienamKuning,943,45,119,91,75,90,78,94,3,4,True,0.4823696656217682
2025-01-07 19:14:47,segitigaKuning,945,45,118,90,142,82,140,85,2,3,True,0.16013329094282325
2025-01-07 19:14:47,Fail to pick,943,45,0,0,0,0,0,0,0,0,False,0
2025-01-07 19:14:47,Fail to pick,945,45,0,0,0,0,0,0,0,0,False,0
2025-01-07 19:14:48,segienamKuning,943,47,118,94,162,22,158,23,4,1,True,0.38063982579368205
2025-01-07 19:14:48,Fail to pick,943,47,0,0,0,0,0,0,0,0,False,0
2025-01-07 19:14:48,segienamKuning,942,46,122,92,181,43,183,38,2,5,False,0.21763477446094437
2025-01-07 19:14:48,Fail to pick,942,46,0,0,0,0,0,0,0,0,False,0
2025-01-07 19:14:50,segienamKuning,945,48,120,96,108,16,104,14,4,2,True,0.3328379266841022
2025-01-07 19:14:50,Fail to pick,945,48,0,0,0,0,0,0,0,0,False,0
2025-01-07 19:14:50,segienamKuning,946,48,123,97,195,53,191,57,4,4,True,0.243036252339525
2025-01-07 19:14:50,Fail to pick,946,48,0,0,0,0,0,0,0,0,False,0
2025-01-07 19:14:50,segienamKuning,943,42,123,85,153,42,151,42,2,0,True,0.34589360918458667
2025-01-07 19:14:50,Fail to pick,943,42,0,0,0,0,0,0,0,0,False,0
2025-01-07 19:14:51,segienamKuning,943,42,123,85,141,47,141,42,0,5,True,0.40008156093392855
2025-01-07 19:14:51,Fail to pick,943,42,0,0,0,0,0,0,0,0,False,0
2025-01-07 19:15:17,segitigaKuning,954,40,123,81,17,55,16,52,1,3,True,0.11707756719745324
2025-01-07 19:15:17,persegiKuning,953,40,123,80,99,50,98,49,1,1,True,0.17087465761145554
2025-01-07 19:15:17,segienamKuning,953,42,123,84,55,79,55,75,0,4,True,0.26463720375219896
2025-01-07 19:15:17,Kuning,954,40,tensor(123.0820),tensor(81.7629),188,88,184,90,4,2,True,0.00031113624572753906
2025-01-07 19:15:17,Fail to pick,953,40,0,0,0,0,0,0,0,0,False,0
2025-01-07 19:15:17,Fail to pick,953,42,0,0,0,0,0,0,0,0,False,0
2025-01-07 19:15:17,segienamKuning,952,41,122,82,98,56,102,59,4,3,True,0.1903502919740715
2025-01-07 19:15:17,Fail to pick,952,41,0,0,0,0,0,0,0,0,False,0
2025-01-07 19:15:17,segienamKuning,946,46,123,92,100,81,103,80,3,1,True,0.24877179361144278
2025-01-07 19:15:17,Fail to pick,946,46,0,0,0,0,0,0,0,0,False,0
2025-01-07 19:15:17,segienamKuning,945,45,125,91,118,50,119,51,1,1,True,0.23573485181902104
2025-01-07 19:15:17,Fail to pick,945,45,0,0,0,0,0,0,0,0,False,0
2025-01-07 19:15:17,segienamKuning,952,46,123,93,171,57,166,56,5,1,True,0.134493361611254
2025-01-07 19:15:17,Fail to pick,952,46,0,0,0,0,0,0,0,0,False,0
2025-01-07 19:15:18,segienamKuning,948,44,119,88,147,67,142,62,5,5,True,0.4167279863581924
2025-01-07 19:15:18,Fail to pick,948,44,0,0,0,0,0,0,0,0,False,0
2025-01-07 19:15:18,segienamKuning,947,46,122,92,127,40,131,41,4,1,True,0.331465374080074
2025-01-07 19:15:18,Fail to pick,947,46,0,0,0,0,0,0,0,0,False,0
2025-01-07 19:15:18,segienamKuning,946,43,123,87,51,19,55,19,4,0,True,0.3683874002560238
2025-01-07 19:15:18,segitigaKuning,948,43,120,86,51,31,48,32,3,1,True,0.44114367451601144
2025-01-07 19:15:18,Fail to pick,946,43,0,0,0,0,0,0,0,0,False,0
2025-01-07 19:15:18,Fail to pick,948,43,0,0,0,0,0,0,0,0,False,0
2025-01-07 19:15:18,segienamKuning,947,46,117,92,53,69,55,73,2,4,False,0.24364437564433802
2025-01-07 19:15:18,Kuning,947,46,tensor(117.9497),tensor(92.0830),187,87,186,84,1,3,True,0.0
2025-01-07 19:15:18,Fail to pick,947,46,0,0,0,0,0,0,0,0,False,0
2025-01-07 19:15:18,segienamKuning,952,44,117,88,16,71,17,69,1,2,True,0.23649383081833394
2025-01-07 19:15:18,Fail to pick,952,44,0,0,0,0,0,0,0,0,False,0
2025-01-07 19:15:21,segienamKuning,943,46,146,93,177,95,176,99,1,4,True,0.1738024711092676
2025-01-07 19:15:21,Fail to pick,943,46,0,0,0,0,0,0,0,0,False,0
2025-01-07 19:15:21,segienamKuning,943,46,146,93,3,92,4,91,1,1,True,0.10662995927812005
2025-01-07 19:15:21,Fail to pick,943,46,0,0,0,0,0,0,0,0,False,0
2025-01-07 19:15:24,segienamKuning,929,668,133,89,155,65,153,68,2,3,True,0.11889721366584101
2025-01-07 19:15:24,Kuning,929,668,tensor(133.8105),tensor(89.1144),14,86,9,88,5,2,True,0.0
2025-01-07 19:15:24,segienamKuning,928,666,120,86,177,5,177,5,0,0,True,0.42187789062288095
2025-01-07 19:15:24,Fail to pick,928,666,0,0,0,0,0,0,0,0,False,0
2025-01-07 19:15:24,segienamKuning,929,667,125,89,26,30,30,25,4,5,True,0.2311720853124092
2025-01-07 19:15:24,Fail to pick,929,667,0,0,0,0,0,0,0,0,False,0
2025-01-07 19:15:25,segienamKuning,949,664,142,109,76,59,72,55,4,4,True,0.2448044781404204
2025-01-07 19:15:25,segienamKuning,947,678,114,82,159,42,161,44,2,2,True,0.3986968565763708
2025-01-07 19:15:25,segienamKuning,951,676,116,84,103,21,99,25,4,4,True,0.29814350796411626
2025-01-07 19:15:25,Fail to pick,951,676,0,0,0,0,0,0,0,0,False,0
2025-01-07 19:15:25,segienamKuning,953,675,117,82,149,77,148,76,1,1,True,0.47412904440243986
2025-01-07 19:15:25,Fail to pick,953,675,0,0,0,0,0,0,0,0,False,0
2025-01-07 19:15:25,segienamKuning,944,678,119,81,135,54,133,54,2,0,True,0.21296786304792936
2025-01-07 19:15:25,segienamKuning,553,618,167,136,115,92,114,89,1,3,True,0.43390722289801886
2025-01-07 19:15:25,Fail to pick,944,678,0,0,0,0,0,0,0,0,False,0
2025-01-07 19:15:25,segienamKuning,947,677,124,79,165,77,161,72,4,5,True,0.2134980631038515
2025-01-07 19:15:25,Fail to pick,947,677,0,0,0,0,0,0,0,0,False,0
2025-01-07 19:15:25,segienamKuning,951,677,121,79,181,92,180,91,1,1,True,0.15379108566853988
2025-01-07 19:15:25,Fail to pick,951,677,0,0,0,0,0,0,0,0,False,0
2025-01-07 19:15:26,segienamKuning,952,679,133,79,1,64,3,59,2,5,True,0.41844742049651606
2025-01-07 19:15:26,Fail to pick,952,679,0,0,0,0,0,0,0,0,False,0
2025-01-07 19:15:26,segienamKuning,950,678,133,80,149,47,152,43,3,4,True,0.4430075596101418
2025-01-07 19:15:26,Fail to pick,950,678,0,0,0,0,0,0,0,0,False,0
2025-01-07 19:15:26,segienamKuning,946,676,115,80,174,92,170,92,4,0,True,0.3291824103954227
2025-01-07 19:15:26,Fail to pick,946,676,0,0,0,0,0,0,0,0,False,0
2025-01-07 19:15:26,segienamKuning,948,678,114,79,81,98,80,96,1,2,True,0.45713342068481877
2025-01-07 19:15:26,Fail to pick,948,678,0,0,0,0,0,0,0,0,False,0
2025-01-07 19:15:26,segienamKuning,949,678,115,79,52,22,52,18,0,4,True,0.43101586269203085
2025-01-07 19:15:26,Fail to pick,949,678,0,0,0,0,0,0,0,0,False,0
2025-01-07 19:15:26,segienamKuning,946,679,113,78,124,34,126,30,2,4,True,0.3954949280461234
2025-01-07 19:15:26,Fail to pick,946,679,0,0,0,0,0,0,0,0,False,0
2025-01-07 19:15:26,segienamKuning,946,680,114,77,103,0,100,0,3,0,True,0.18277762787472282
2025-01-07 19:15:26,Fail to pick,946,680,0,0,0,0,0,0,0,0,False,0
2025-01-07 19:15:27,segienamKuning,956,676,112,79,41,41,45,39,4,2,True,0.3169659516349831
2025-01-07 19:15:27,segienamKuning,947,679,113,78,140,35,143,30,3,5,True,0.28333769518851726
2025-01-07 19:15:27,Fail to pick,947,679,0,0,0,0,0,0,0,0,False,0
2025-01-07 19:15:27,segienamKuning,942,680,116,76,117,25,113,22,4,3,True,0.44351266619719854
2025-01-07 19:15:27,Fail to pick,942,680,0,0,0,0,0,0,0,0,False,0
2025-01-07 19:15:27,segienamKuning,947,678,116,79,40,44,39,47,1,3,True,0.24345477037095198
2025-01-07 19:15:27,Fail to pick,947,678,0,0,0,0,0,0,0,0,False,0
2025-01-07 19:15:27,segienamKuning,951,680,120,78,149,28,149,23,0,5,True,0.14087558451796914
2025-01-07 19:15:27,Fail to pick,951,680,0,0,0,0,0,0,0,0,False,0
2025-01-07 19:15:27,segienamKuning,963,673,152,92,69,34,64,33,5,1,True,0.251696280614635
2025-01-07 19:15:28,segienamKuning,952,679,139,80,198,68,198,67,0,1,True,0.45598358377209547
2025-01-07 19:15:28,segienamKuning,949,678,130,81,91,53,89,57,2,4,True,0.38450414601868155
2025-01-07 19:15:28,Fail to pick,949,678,0,0,0,0,0,0,0,0,False,0
2025-01-07 19:15:28,segienamKuning,951,681,115,77,177,59,179,61,2,2,False,0.2984869557956752
2025-01-07 19:15:28,Fail to pick,951,681,0,0,0,0,0,0,0,0,False,0
2025-01-07 19:15:28,segienamKuning,946,680,110,77,192,88,191,84,1,4,False,0.40936251820083647
2025-01-07 19:15:28,Fail to pick,946,680,0,0,0,0,0,0,0,0,False,0
2025-01-07 19:15:30,segienamKuning,951,675,116,82,145,32,141,35,4,3,True,0.19338569598610073
2025-01-07 19:15:30,Fail to pick,951,675,0,0,0,0,0,0,0,0,False,0
2025-01-07 19:15:30,segienamKuning,951,675,120,84,89,59,92,56,3,3,True,0.4421644637247396
2025-01-07 19:15:30,Fail to pick,951,675,0,0,0,0,0,0,0,0,False,0
2025-01-07 19:15:30,segienamKuning,961,674,118,91,101,95,96,93,5,2,False,0.2962910558464684
2025-01-07 19:15:30,segienamKuning,961,674,118,91,138,41,136,43,2,2,True,0.3678084382452792
2025-01-07 19:15:30,Fail to pick,961,674,0,0,0,0,0,0,0,0,False,0
2025-01-07 19:15:30,segienamKuning,946,682,110,74,179,16,181,16,2,0,True,0.12223963855885361
2025-01-07 19:15:31,segienamKuning,950,679,109,80,76,34,71,38,5,4,True,0.37420839019818153
2025-01-07 19:15:31,Fail to pick,950,679,0,0,0,0,0,0,0,0,False,0
2025-01-07 19:15:31,segienamKuning,945,678,109,78,69,21,73,23,4,2,True,0.40559067912667046
2025-01-07 19:15:31,Fail to pick,945,678,0,0,0,0,0,0,0,0,False,0
2025-01-07 19:15:31,segienamKuning,947,678,110,77,127,41,130,44,3,3,True,0.3766199829599153
2025-01-07 19:15:31,Fail to pick,947,678,0,0,0,0,0,0,0,0,False,0
2025-01-07 19:15:32,segienamKuning,939,676,112,82,102,81,100,78,2,3,True,0.2642503838760696
2025-01-07 19:15:32,Fail to pick,939,676,0,0,0,0,0,0,0,0,False,0
2025-01-07 19:15:32,segienamKuning,941,678,113,78,16,8,14,9,2,1,False,0.3043959709548798
2025-01-07 19:15:32,Fail to pick,941,678,0,0,0,0,0,0,0,0,False,0
2025-01-07 19:15:32,segienamKuning,945,677,115,78,22,83,21,85,1,2,True,0.2956628403321922
2025-01-07 19:15:32,Fail to pick,945,677,0,0,0,0,0,0,0,0,False,0
2025-01-07 19:15:32,segienamKuning,945,678,113,79,154,83,155,80,1,3,True,0.38326090594101214
2025-01-07 19:15:32,Fail to pick,945,678,0,0,0,0,0,0,0,0,False,0
2025-01-07 19:15:32,segienamKuning,948,676,113,82,182,12,180,15,2,3,True,0.2578997031364808
2025-01-07 19:15:32,Fail to pick,948,676,0,0,0,0,0,0,0,0,False,0
2025-01-07 19:15:32,segienamKuning,943,675,111,80,159,0,156,-2,3,2,True,0.1942384438220114
2025-01-07 19:15:32,Fail to pick,943,675,0,0,0,0,0,0,0,0,False,0
2025-01-07 19:15:33,segienamKuning,943,677,114,78,85,81,83,85,2,4,True,0.23738221957435124
2025-01-07 19:15:33,Fail to pick,943,677,0,0,0,0,0,0,0,0,False,0
2025-01-07 19:15:33,segienamKuning,941,678,110,76,154,45,154,47,0,2,True,0.31039752041353036
2025-01-07 19:15:33,Fail to pick,941,678,0,0,0,0,0,0,0,0,False,0
2025-01-07 19:15:33,segienamKuning,946,678,108,79,29,73,24,76,5,3,False,0.35575761497765745
2025-01-07 19:15:33,Fail to pick,946,678,0,0,0,0,0,0,0,0,False,0
2025-01-07 19:15:33,segienamKuning,943,677,116,80,1,76,-2,79,3,3,True,0.293964248832682
2025-01-07 19:15:33,Fail to pick,943,677,0,0,0,0,0,0,0,0,False,0
2025-01-07 19:15:33,segienamKuning,948,676,110,81,158,62,156,64,2,2,True,0.36345820174051047
2025-01-07 19:15:33,Fail to pick,948,676,0,0,0,0,0,0,0,0,False,0
2025-01-07 19:15:34,segienamKuning,810,645,111,102,3,0,7,-4,4,4,False,0.19292567722811305
2025-01-07 19:15:34,Kuning,810,645,tensor(111.7555),tensor(102.4470),20,75,20,74,0,1,True,0.0
2025-01-07 19:15:34,segienamKuning,810,649,115,97,33,63,28,66,5,3,True,0.41460810765349243
2025-01-07 19:15:34,Fail to pick,810,649,0,0,0,0,0,0,0,0,False,0
2025-01-07 19:15:35,segienamKuning,808,652,116,101,54,97,56,95,2,2,True,0.18428773891915506
2025-01-07 19:15:35,Fail to pick,808,652,0,0,0,0,0,0,0,0,False,0
2025-01-07 19:15:35,segienamKuning,810,650,120,101,89,7,85,10,4,3,True,0.30274535569766625
2025-01-07 19:15:35,Fail to pick,810,650,0,0,0,0,0,0,0,0,False,0
2025-01-07 19:15:35,persegiKuning,809,650,119,102,84,57,81,54,3,3,True,0.3804853317417275
2025-01-07 19:15:35,Fail to pick,809,650,0,0,0,0,0,0,0,0,False,0
2025-01-07 19:15:36,segienamKuning,819,647,110,100,127,48,123,52,4,4,True,0.1695289061505214
2025-01-07 19:15:36,persegiKuning,818,647,113,103,165,48,169,48,4,0,True,0.36992507961618903
2025-01-07 19:15:36,Fail to pick,818,647,0,0,0,0,0,0,0,0,False,0
2025-01-07 19:15:36,segienamKuning,810,651,111,99,123,37,125,32,2,5,True,0.39097913288891284
2025-01-07 19:15:36,persegiKuning,810,651,111,101,136,70,133,67,3,3,True,0.24535286410460233
2025-01-07 19:15:36,Kuning,810,651,tensor(111.6740),tensor(99.2447),19,75,22,76,3,1,True,0.0
2025-01-07 19:15:36,Fail to pick,810,651,0,0,0,0,0,0,0,0,False,0
2025-01-07 19:15:36,Fail to pick,810,651,0,0,0,0,0,0,0,0,False,0
2025-01-07 19:15:36,segitigaKuning,824,652,125,94,171,29,168,26,3,3,True,0.23162029609672108
2025-01-07 19:15:36,segienamKuning,823,652,125,96,88,39,88,34,0,5,True,0.3877591037646628
2025-01-07 19:15:36,Fail to pick,823,652,0,0,0,0,0,0,0,0,False,0
2025-01-07 19:15:36,segienamKuning,828,651,111,95,71,28,68,24,3,4,True,0.126573323445515
2025-01-07 19:15:36,Fail to pick,828,651,0,0,0,0,0,0,0,0,False,0
2025-01-07 19:15:37,segienamKuning,823,651,107,96,157,62,157,63,0,1,True,0.353835659104183
2025-01-07 19:15:37,Fail to pick,823,651,0,0,0,0,0,0,0,0,False,0
2025-01-07 19:15:37,segienamKuning,817,651,111,97,29,95,27,95,2,0,True,0.30188076307674505
2025-01-07 19:15:37,Fail to pick,817,651,0,0,0,0,0,0,0,0,False,0
2025-01-07 19:15:37,segienamKuning,813,651,109,96,164,95,164,90,0,5,True,0.3425592537792233
2025-01-07 19:15:37,Fail to pick,813,651,0,0,0,0,0,0,0,0,False,0
2025-01-07 19:15:37,segienamKuning,817,646,120,97,69,78,69,75,0,3,True,0.4590174228355669
2025-01-07 19:15:37,Fail to pick,817,646,0,0,0,0,0,0,0,0,False,0
2025-01-07 19:15:37,segienamKuning,815,647,115,96,20,92,20,91,0,1,True,0.31306619572281474
2025-01-07 19:15:37,Fail to pick,815,647,0,0,0,0,0,0,0,0,False,0
2025-01-07 19:15:38,segienamKuning,813,646,121,97,89,16,91,18,2,2,True,0.3437788582589703
2025-01-07 19:15:38,Fail to pick,813,646,0,0,0,0,0,0,0,0,False,0
2025-01-07 19:15:38,segienamKuning,818,645,121,92,122,32,126,27,4,5,False,0.14676615426167544
2025-01-07 19:15:38,Fail to pick,818,645,0,0,0,0,0,0,0,0,False,0
2025-01-07 19:15:38,segienamKuning,819,645,117,93,177,6,173,8,4,2,True,0.44269170081521414
2025-01-07 19:15:38,Fail to pick,819,645,0,0,0,0,0,0,0,0,False,0
2025-01-07 19:15:38,segienamKuning,816,647,117,92,102,50,98,47,4,3,True,0.3226662806525552
2025-01-07 19:15:38,Fail to pick,816,647,0,0,0,0,0,0,0,0,False,0
2025-01-07 19:15:42,segienamKuning,804,636,119,91,129,71,128,69,1,2,True,0.3480534274960294
2025-01-07 19:15:42,segienamKuning,817,645,116,89,16,56,17,54,1,2,True,0.2857123999433398
2025-01-07 19:15:42,segienamKuning,817,647,120,91,129,54,127,52,2,2,True,0.47641536062570466
2025-01-07 19:15:42,Fail to pick,817,647,0,0,0,0,0,0,0,0,False,0
2025-01-07 19:15:42,segienamKuning,813,647,119,89,188,12,183,14,5,2,True,0.2401740610641282
2025-01-07 19:15:42,Fail to pick,813,647,0,0,0,0,0,0,0,0,False,0
2025-01-07 19:15:43,segienamKuning,812,646,120,86,87,67,85,67,2,0,True,0.44327327499027747
2025-01-07 19:15:43,Fail to pick,812,646,0,0,0,0,0,0,0,0,False,0
2025-01-07 19:15:43,segienamKuning,815,648,118,91,78,52,81,55,3,3,True,0.28618920341190207
2025-01-07 19:15:43,persegiKuning,815,648,118,92,98,57,96,56,2,1,True,0.1080581141557122
2025-01-07 19:15:43,Fail to pick,815,648,0,0,0,0,0,0,0,0,False,0
2025-01-07 19:15:43,Fail to pick,815,648,0,0,0,0,0,0,0,0,False,0
2025-01-07 19:15:43,segienamKuning,811,648,108,86,46,21,41,25,5,4,True,0.30638952516497353
2025-01-07 19:15:43,Kuning,811,648,tensor(108.5243),tensor(86.0682),20,75,22,71,2,4,True,0.0
2025-01-07 19:15:43,Fail to pick,811,648,0,0,0,0,0,0,0,0,False,0
2025-01-07 19:15:43,segienamKuning,813,646,114,93,134,49,129,51,5,2,True,0.4192728722403778
2025-01-07 19:15:43,Fail to pick,813,646,0,0,0,0,0,0,0,0,False,0
2025-01-07 19:15:43,segienamKuning,812,646,112,92,145,57,143,58,2,1,True,0.4463675200480798
2025-01-07 19:15:43,Fail to pick,812,646,0,0,0,0,0,0,0,0,False,0
2025-01-07 19:15:43,segienamKuning,812,645,122,97,6,31,1,35,5,4,True,0.1459020606052428
2025-01-07 19:15:43,Fail to pick,812,645,0,0,0,0,0,0,0,0,False,0
2025-01-07 19:15:43,segienamKuning,813,647,123,93,142,23,143,22,1,1,True,0.4912933261258827
2025-01-07 19:15:43,Fail to pick,813,647,0,0,0,0,0,0,0,0,False,0
2025-01-07 19:15:43,segienamKuning,809,649,117,92,192,10,195,12,3,2,True,0.23170411983738393
2025-01-07 19:15:43,Fail to pick,809,649,0,0,0,0,0,0,0,0,False,0
2025-01-07 19:15:44,segienamKuning,813,646,114,89,139,68,137,63,2,5,True,0.31599522414343567
2025-01-07 19:15:44,Fail to pick,813,646,0,0,0,0,0,0,0,0,False,0
2025-01-07 19:15:44,segienamKuning,813,646,121,90,152,19,156,19,4,0,True,0.48923229568347004
2025-01-07 19:15:44,Fail to pick,813,646,0,0,0,0,0,0,0,0,False,0
2025-01-07 19:15:44,persegiKuning,756,631,122,106,122,51,121,49,1,2,True,0.19144591067747474
2025-01-07 19:15:45,segienamKuning,805,649,115,99,34,22,36,26,2,4,True,0.4603936484466683
2025-01-07 19:15:45,segienamKuning,807,648,114,96,24,34,24,34,0,0,True,0.30398940896939647
2025-01-07 19:15:45,Fail to pick,807,648,0,0,0,0,0,0,0,0,False,0
2025-01-07 19:15:45,segienamKuning,804,646,107,98,167,7,164,4,3,3,True,0.3627371025083157
2025-01-07 19:15:45,Fail to pick,804,646,0,0,0,0,0,0,0,0,False,0
2025-01-07 19:15:45,segienamKuning,805,644,124,97,73,33,72,37,1,4,False,0.22525626627749584
2025-01-07 19:15:45,Fail to pick,805,644,0,0,0,0,0,0,0,0,False,0
2025-01-07 19:15:45,segienamKuning,801,648,116,98,152,44,150,39,2,5,True,0.4435034931693066
2025-01-07 19:15:45,Fail to pick,801,648,0,0,0,0,0,0,0,0,False,0
2025-01-07 19:15:45,segienamKuning,793,643,124,98,132,86,135,85,3,1,True,0.3193404127576463
2025-01-07 19:15:45,Fail to pick,793,643,0,0,0,0,0,0,0,0,False,0
2025-01-07 19:15:45,segienamKuning,788,643,122,109,155,43,152,45,3,2,True,0.23398021973976385
2025-01-07 19:15:45,Fail to pick,788,643,0,0,0,0,0,0,0,0,False,0
2025-01-07 19:15:46,segienamKuning,790,634,130,100,121,57,119,59,2,2,True,0.1337033972381368
2025-01-07 19:15:46,Fail to pick,790,634,0,0,0,0,0,0,0,0,False,0
2025-01-07 19:15:46,segienamKuning,783,636,121,107,84,90,85,87,1,3,True,0.13158070622064325
2025-01-07 19:15:46,Fail to pick,783,636,0,0,0,0,0,0,0,0,False,0
2025-01-07 19:15:46,segienamKuning,802,646,132,92,109,97,110,100,1,3,True,0.19407013917257332
2025-01-07 19:15:52,segienamKuning,792,378,118,106,14,86,18,89,4,3,True,0.42301992609088
2025-01-07 19:15:52,Kuning,792,378,tensor(118.5450),tensor(106.1308),95,73,94,70,1,3,True,0.0
2025-01-07 19:15:52,segienamKuning,790,376,118,114,133,38,133,37,0,1,True,0.17051034784080357
2025-01-07 19:15:52,persegiKuning,791,376,117,112,102,57,103,53,1,4,True,0.20213791690803584
2025-01-07 19:15:52,Fail to pick,790,376,0,0,0,0,0,0,0,0,False,0
2025-01-07 19:15:52,Fail to pick,791,376,0,0,0,0,0,0,0,0,False,0
2025-01-07 19:15:52,segienamKuning,796,381,120,103,122,72,125,69,3,3,True,0.10261988908926872
2025-01-07 19:15:52,lingkaranKuning,796,381,116,107,108,31,112,27,4,4,True,0.29052619453572126
2025-01-07 19:15:52,Fail to pick,796,381,0,0,0,0,0,0,0,0,False,0
2025-01-07 19:15:52,Fail to pick,796,381,0,0,0,0,0,0,0,0,False,0
2025-01-07 19:15:53,lingkaranKuning,795,382,114,112,173,55,177,50,4,5,True,0.30045530204684245
2025-01-07 19:15:53,segienamKuning,794,382,117,109,157,21,152,20,5,1,True,0.4438700146260329
2025-01-07 19:15:53,Fail to pick,795,382,0,0,0,0,0,0,0,0,False,0
2025-01-07 19:15:53,Fail to pick,794,382,0,0,0,0,0,0,0,0,False,0
2025-01-07 19:15:53,persegiKuning,791,377,116,106,74,20,77,20,3,0,True,0.4526728909041656
2025-01-07 19:15:53,Kuning,791,377,tensor(116.0884),tensor(106.6049),95,73,92,71,3,2,True,0.0
2025-01-07 19:15:53,Fail to pick,791,377,0,0,0,0,0,0,0,0,False,0
2025-01-07 19:15:53,segienamKuning,792,376,117,107,127,0,122,1,5,1,True,0.2446824115476771
2025-01-07 19:15:53,Fail to pick,792,376,0,0,0,0,0,0,0,0,False,0
2025-01-07 19:15:53,segienamKuning,792,376,117,107,61,55,58,53,3,2,True,0.21799816708630268
2025-01-07 19:15:53,Fail to pick,792,376,0,0,0,0,0,0,0,0,False,0
2025-01-07 19:15:53,segienamKuning,785,379,121,106,47,97,51,97,4,0,True,0.1833240561516019
2025-01-07 19:15:53,lingkaranKuning,786,379,116,109,153,45,149,45,4,0,True,0.11859767786433345
2025-01-07 19:15:53,Fail to pick,785,379,0,0,0,0,0,0,0,0,False,0
2025-01-07 19:15:53,Fail to pick,786,379,0,0,0,0,0,0,0,0,False,0
2025-01-07 19:15:53,segienamKuning,790,380,122,109,51,78,50,79,1,1,True,0.27857263744347927
2025-01-07 19:15:53,Fail to pick,790,380,0,0,0,0,0,0,0,0,False,0
2025-01-07 19:15:54,segienamKuning,793,376,123,105,62,68,59,69,3,1,True,0.27637654148661817
2025-01-07 19:15:54,Fail to pick,793,376,0,0,0,0,0,0,0,0,False,0
2025-01-07 19:15:54,segienamKuning,793,376,115,104,14,86,16,85,2,1,True,0.4200652370530361
2025-01-07 19:15:54,lingkaranKuning,794,377,114,109,85,86,84,82,1,4,True,0.3753439168136571
2025-01-07 19:15:54,Fail to pick,793,376,0,0,0,0,0,0,0,0,False,0
2025-01-07 19:15:54,Fail to pick,794,377,0,0,0,0,0,0,0,0,False,0
2025-01-07 19:15:54,segienamKuning,790,375,130,107,130,67,134,64,4,3,True,0.3620915015526628
2025-01-07 19:15:54,Kuning,790,375,tensor(130.2780),tensor(107.6218),95,73,92,77,3,4,True,0.0
2025-01-07 19:15:54,Fail to pick,790,375,0,0,0,0,0,0,0,0,False,0
2025-01-07 19:15:54,segienamKuning,784,374,117,106,123,52,122,48,1,4,True,0.2171873914108871
2025-01-07 19:15:54,Fail to pick,784,374,0,0,0,0,0,0,0,0,False,0
2025-01-07 19:15:54,segienamKuning,783,370,115,105,134,35,130,30,4,5,True,0.2922614423697937
2025-01-07 19:15:54,Fail to pick,783,370,0,0,0,0,0,0,0,0,False,0
2025-01-07 19:15:55,segienamKuning,791,380,118,108,137,8,136,7,1,1,True,0.2544318374579001
2025-01-07 19:15:55,persegiKuning,791,380,117,106,75,35,76,35,1,0,True,0.3119080343651007
2025-01-07 19:15:55,Fail to pick,791,380,0,0,0,0,0,0,0,0,False,0
2025-01-07 19:15:55,segienamKuning,788,374,118,107,134,97,129,99,5,2,True,0.2042057539624408
2025-01-07 19:15:55,persegiKuning,788,374,120,107,150,56,151,57,1,1,True,0.31831582163250116
2025-01-07 19:15:55,Fail to pick,788,374,0,0,0,0,0,0,0,0,False,0
2025-01-07 19:15:55,Fail to pick,788,374,0,0,0,0,0,0,0,0,False,0
2025-01-07 19:15:55,segienamKuning,792,374,116,104,127,45,126,46,1,1,True,0.22672401682199542
2025-01-07 19:15:55,Kuning,792,374,tensor(116.4359),tensor(104.5638),96,73,95,74,1,1,True,7.343292236328125e-05
2025-01-07 19:15:55,Fail to pick,792,374,0,0,0,0,0,0,0,0,False,0
2025-01-07 19:15:55,segienamKuning,790,378,113,104,1,23,4,18,3,5,True,0.13773162401248282
2025-01-07 19:15:55,lingkaranKuning,791,379,111,108,27,65,23,68,4,3,True,0.13779572138548735
2025-01-07 19:15:55,Fail to pick,790,378,0,0,0,0,0,0,0,0,False,0
2025-01-07 19:15:55,Fail to pick,791,379,0,0,0,0,0,0,0,0,False,0
2025-01-07 19:15:55,segienamKuning,790,378,117,107,75,11,74,15,1,4,True,0.349464904110107
2025-01-07 19:15:55,Fail to pick,790,378,0,0,0,0,0,0,0,0,False,0
2025-01-07 19:15:55,segienamKuning,785,375,113,104,44,3,42,7,2,4,True,0.2665266834349971
2025-01-07 19:15:55,lingkaranKuning,787,377,108,109,126,17,124,21,2,4,True,0.215551242323742
2025-01-07 19:15:55,Fail to pick,785,375,0,0,0,0,0,0,0,0,False,0
2025-01-07 19:15:55,Fail to pick,787,377,0,0,0,0,0,0,0,0,False,0
2025-01-07 19:15:55,segienamKuning,789,379,121,106,184,14,182,12,2,2,True,0.1520357484891795
2025-01-07 19:15:55,lingkaranKuning,792,380,115,111,11,57,11,57,0,0,True,0.35557964022035626
2025-01-07 19:15:55,Fail to pick,789,379,0,0,0,0,0,0,0,0,False,0
2025-01-07 19:15:55,Fail to pick,792,380,0,0,0,0,0,0,0,0,False,0
2025-01-07 19:15:56,segienamKuning,788,373,116,103,188,64,190,60,2,4,True,0.2689332672706795
2025-01-07 19:15:56,Fail to pick,788,373,0,0,0,0,0,0,0,0,False,0
2025-01-07 19:15:56,segienamKuning,792,379,117,107,72,51,75,50,3,1,True,0.27733781709142846
2025-01-07 19:15:56,Fail to pick,792,379,0,0,0,0,0,0,0,0,False,0
2025-01-07 19:15:56,segienamKuning,786,381,119,107,165,4,167,1,2,3,True,0.14709538298579822
2025-01-07 19:15:56,Fail to pick,786,381,0,0,0,0,0,0,0,0,False,0
2025-01-07 19:15:56,lingkaranKuning,796,376,112,108,154,16,157,16,3,0,True,0.1018561267065818
2025-01-07 19:15:56,segienamKuning,794,375,116,103,59,52,59,53,0,1,True,0.3544855038535981
2025-01-07 19:15:56,Fail to pick,794,375,0,0,0,0,0,0,0,0,False,0
2025-01-07 19:15:57,segienamKuning,793,377,121,111,159,55,159,59,0,4,True,0.4778340450861619
2025-01-07 19:15:57,Kuning,793,377,tensor(121.0452),tensor(111.5719),95,73,96,76,1,3,True,0.0
2025-01-07 19:15:57,Fail to pick,793,377,0,0,0,0,0,0,0,0,False,0
2025-01-07 19:15:57,persegiKuning,789,378,118,100,131,91,133,92,2,1,False,0.23377746421040135
2025-01-07 19:15:57,segienamKuning,789,378,117,101,97,68,95,63,2,5,True,0.4953659809718203
2025-01-07 19:15:57,Fail to pick,789,378,0,0,0,0,0,0,0,0,False,0
2025-01-07 19:15:57,Fail to pick,789,378,0,0,0,0,0,0,0,0,False,0
2025-01-07 19:15:57,persegiKuning,789,378,118,100,113,64,114,62,1,2,True,0.4396211421961924
2025-01-07 19:15:57,segienamKuning,789,378,117,101,189,78,189,80,0,2,False,0.2555840569703943
2025-01-07 19:15:57,Fail to pick,789,378,0,0,0,0,0,0,0,0,False,0
2025-01-07 19:15:57,Fail to pick,789,378,0,0,0,0,0,0,0,0,False,0
2025-01-07 19:16:00,segienamKuning,799,372,119,105,12,52,16,50,4,2,True,0.2521964176593594
2025-01-07 19:16:00,Kuning,799,372,tensor(119.8091),tensor(105.8462),96,73,99,76,3,3,True,0.0
2025-01-07 19:16:01,segienamKuning,796,376,118,106,140,26,137,29,3,3,True,0.2869991617456309
2025-01-07 19:16:01,Fail to pick,796,376,0,0,0,0,0,0,0,0,False,0
2025-01-07 19:16:01,segienamKuning,794,376,118,106,24,26,25,29,1,3,True,0.22406436922952713
2025-01-07 19:16:01,Fail to pick,794,376,0,0,0,0,0,0,0,0,False,0
2025-01-07 19:16:01,segienamKuning,791,377,121,105,184,24,184,23,0,1,True,0.11513808078445181
2025-01-07 19:16:01,Fail to pick,791,377,0,0,0,0,0,0,0,0,False,0
2025-01-07 19:16:01,segienamKuning,793,375,116,108,69,55,68,56,1,1,True,0.2606489939605603
2025-01-07 19:16:01,Fail to pick,793,375,0,0,0,0,0,0,0,0,False,0
2025-01-07 19:16:01,segienamKuning,791,379,119,113,88,19,89,23,1,4,True,0.3443467207737039
2025-01-07 19:16:01,persegiKuning,791,378,119,111,97,45,99,45,2,0,True,0.28573647945371344
2025-01-07 19:16:01,Fail to pick,791,379,0,0,0,0,0,0,0,0,False,0
2025-01-07 19:16:01,Fail to pick,791,378,0,0,0,0,0,0,0,0,False,0
2025-01-07 19:16:01,segienamKuning,788,374,116,107,126,75,126,72,0,3,True,0.10863158986487159
2025-01-07 19:16:01,Fail to pick,788,374,0,0,0,0,0,0,0,0,False,0
2025-01-07 19:16:02,segienamKuning,795,377,119,107,1,10,2,11,1,1,True,0.22730189925028055
2025-01-07 19:16:02,Fail to pick,795,377,0,0,0,0,0,0,0,0,False,0
2025-01-07 19:16:02,segienamKuning,792,377,117,108,118,50,114,54,4,4,True,0.1104310113296744
2025-01-07 19:16:02,Fail to pick,792,377,0,0,0,0,0,0,0,0,False,0
2025-01-07 19:32:16,segienamKuning,802,199,147,162,142,43,144,43,2,0,True,0.10399850502283013
2025-01-07 19:32:16,Kuning,802,199,tensor(147.4552),tensor(162.2363),144,74,139,73,5,1,True,0.0004982948303222656
2025-01-07 19:32:16,segienamKuning,785,205,139,132,36,13,35,10,1,3,False,0.3405249227752589
2025-01-07 19:32:16,segienamKuning,788,205,132,127,23,32,18,30,5,2,True,0.13409444122268732
2025-01-07 19:32:16,Fail to pick,788,205,0,0,0,0,0,0,0,0,False,0
2025-01-07 19:32:25,segienamKuning,869,456,137,108,29,42,26,38,3,4,True,0.1603778262110411
2025-01-07 19:32:25,Kuning,869,456,tensor(137.6578),tensor(108.4328),73,80,74,82,1,2,True,0.0004985332489013672
2025-01-07 19:32:25,segienamKuning,886,444,151,115,19,58,23,60,4,2,True,0.29152060592215356
2025-01-07 19:32:32,segienamKuning,848,427,149,109,199,37,195,33,4,4,True,0.4517499345391821
2025-01-07 19:32:32,segienamKuning,860,444,166,102,131,74,127,77,4,3,True,0.19272351030726723
2025-01-07 19:32:33,segienamKuning,894,450,111,102,25,58,22,54,3,4,True,0.41733340090053317
2025-01-07 19:32:33,lingkaranKuning,897,450,107,103,112,37,112,35,0,2,True,0.11587222022752877
2025-01-07 19:32:33,Fail to pick,897,450,0,0,0,0,0,0,0,0,False,0
2025-01-07 19:32:33,segienamKuning,884,452,117,102,93,13,95,9,2,4,True,0.4575454285890841
2025-01-07 19:32:33,Kuning,884,452,tensor(117.0584),tensor(102.8687),74,81,74,83,0,2,True,0.0
2025-01-07 19:32:33,segienamKuning,881,453,122,101,193,13,196,12,3,1,True,0.29272351126911694
2025-01-07 19:32:33,Fail to pick,881,453,0,0,0,0,0,0,0,0,False,0
2025-01-07 19:32:33,segienamKuning,885,448,120,102,50,73,54,77,4,4,True,0.1257416229390157
2025-01-07 19:32:33,Fail to pick,885,448,0,0,0,0,0,0,0,0,False,0
2025-01-07 19:32:49,segienamKuning,833,238,120,115,80,88,77,90,3,2,True,0.2639416198092584
2025-01-07 19:32:49,Kuning,833,238,tensor(120.9644),tensor(115.8846),133,77,130,75,3,2,True,0.0005323886871337891
2025-01-07 19:32:49,segienamKuning,837,237,123,116,39,9,42,13,3,4,True,0.24667879741674703
2025-01-07 19:32:49,Fail to pick,837,237,0,0,0,0,0,0,0,0,False,0
2025-01-07 19:32:49,segienamKuning,834,238,124,113,199,92,197,90,2,2,True,0.15919146961899533
2025-01-07 19:32:49,Fail to pick,834,238,0,0,0,0,0,0,0,0,False,0
2025-01-07 19:32:50,segienamKuning,839,239,122,118,188,10,188,8,0,2,True,0.2241258657038613
2025-01-07 19:32:50,Fail to pick,839,239,0,0,0,0,0,0,0,0,False,0
2025-01-07 19:32:50,segienamKuning,839,236,120,113,74,84,69,79,5,5,True,0.3760517097443514
2025-01-07 19:32:50,Fail to pick,839,236,0,0,0,0,0,0,0,0,False,0
2025-01-07 19:32:50,segienamKuning,832,235,120,116,100,40,98,39,2,1,True,0.4533797356625996
2025-01-07 19:32:50,Fail to pick,832,235,0,0,0,0,0,0,0,0,False,0
2025-01-07 19:32:50,segienamKuning,834,235,117,118,143,80,141,84,2,4,True,0.38645907661955203
2025-01-07 19:32:50,Fail to pick,834,235,0,0,0,0,0,0,0,0,False,0
2025-01-07 19:32:50,segienamKuning,838,238,122,113,171,56,173,60,2,4,True,0.3713373316449289
2025-01-07 19:32:50,Fail to pick,838,238,0,0,0,0,0,0,0,0,False,0
2025-01-07 19:32:50,segienamKuning,839,237,118,118,78,86,76,90,2,4,True,0.49735761311049387
2025-01-07 19:32:50,Fail to pick,839,237,0,0,0,0,0,0,0,0,False,0
2025-01-07 19:32:51,segienamKuning,836,234,113,115,51,91,46,93,5,2,True,0.28240185879750124
2025-01-07 19:32:51,Fail to pick,836,234,0,0,0,0,0,0,0,0,False,0
2025-01-07 19:32:51,segienamKuning,836,234,113,115,79,14,77,14,2,0,True,0.10394671202996904
2025-01-07 19:32:51,Fail to pick,836,234,0,0,0,0,0,0,0,0,False,0
2025-01-07 19:32:53,segienamKuning,842,238,117,112,19,83,14,84,5,1,True,0.13490845793121894
2025-01-07 19:32:53,Fail to pick,842,238,0,0,0,0,0,0,0,0,False,0
2025-01-07 19:32:54,segienamKuning,845,227,114,113,85,90,86,86,1,4,True,0.40157122226865827
2025-01-07 19:33:02,segienamKuning,833,213,135,142,111,94,106,94,5,0,True,0.43480544901258156
2025-01-07 19:33:03,segienamKuning,818,217,129,134,61,85,57,83,4,2,True,0.48570510840764447
2025-01-07 19:33:03,segienamKuning,815,217,128,131,2,79,5,81,3,2,True,0.28387162698972535
2025-01-07 19:33:03,Fail to pick,815,217,0,0,0,0,0,0,0,0,False,0
2025-01-07 19:33:03,segienamKuning,837,212,129,132,162,69,162,73,0,4,True,0.4173607176344917
2025-01-07 19:33:04,segienamKuning,830,213,130,136,35,65,38,61,3,4,True,0.41780596894344835
2025-01-07 19:33:04,Fail to pick,830,213,0,0,0,0,0,0,0,0,False,0
2025-01-07 19:33:04,segienamKuning,826,209,137,136,41,34,42,33,1,1,True,0.40833817434538167
2025-01-07 19:33:04,Fail to pick,826,209,0,0,0,0,0,0,0,0,False,0
2025-01-07 19:33:04,segienamKuning,748,152,129,138,92,4,88,7,4,3,True,0.20422141121188805
2025-01-07 19:33:04,Kuning,748,152,tensor(129.3276),tensor(138.9563),157,69,160,64,3,5,True,0.0004975795745849609
2025-01-07 19:33:04,segienamKuning,793,231,129,134,95,8,96,10,1,2,False,0.3100381450120172
2025-01-07 19:33:04,segienamKuning,793,231,129,134,181,95,185,92,4,3,True,0.17303317959439118
2025-01-07 19:33:04,Fail to pick,793,231,0,0,0,0,0,0,0,0,False,0
2025-01-07 19:33:04,segienamKuning,801,226,139,142,32,97,30,93,2,4,True,0.4088661660868159
2025-01-07 19:33:04,Fail to pick,801,226,0,0,0,0,0,0,0,0,False,0
2025-01-07 19:33:05,segienamKuning,789,237,137,140,123,67,123,62,0,5,False,0.2885271859932327
2025-01-07 19:33:05,segienamKuning,789,237,137,140,10,59,12,61,2,2,True,0.101360986843122
2025-01-07 19:33:05,Fail to pick,789,237,0,0,0,0,0,0,0,0,False,0
2025-01-07 19:33:05,segienamKuning,792,236,133,137,158,37,154,33,4,4,True,0.4486832847985168
2025-01-07 19:33:05,Fail to pick,792,236,0,0,0,0,0,0,0,0,False,0
2025-01-07 19:33:05,segienamKuning,805,231,132,133,16,12,18,16,2,4,True,0.37423787366791716
2025-01-07 19:33:06,segienamKuning,791,235,139,135,184,29,179,29,5,0,True,0.1660564841891874
2025-01-07 19:33:06,segienamKuning,811,228,129,130,125,87,124,83,1,4,True,0.19374512957214401
2025-01-07 19:33:06,segienamKuning,812,223,133,135,102,25,97,27,5,2,True,0.4428139942954825
2025-01-07 19:33:06,Fail to pick,812,223,0,0,0,0,0,0,0,0,False,0
2025-01-07 19:33:06,segienamKuning,809,229,130,135,51,58,51,55,0,3,True,0.48956473226731134
2025-01-07 19:33:06,Fail to pick,809,229,0,0,0,0,0,0,0,0,False,0
2025-01-07 19:33:06,segienamKuning,810,231,136,133,192,57,189,52,3,5,True,0.39620762544567534
2025-01-07 19:33:06,Fail to pick,810,231,0,0,0,0,0,0,0,0,False,0
2025-01-07 19:33:07,segienamKuning,811,229,139,136,102,3,106,0,4,3,True,0.342896114874564
2025-01-07 19:33:07,Fail to pick,811,229,0,0,0,0,0,0,0,0,False,0
2025-01-07 19:33:07,segienamKuning,801,230,136,135,132,89,127,86,5,3,True,0.24027696318529262
2025-01-07 19:33:07,segienamKuning,805,232,141,135,194,30,198,27,4,3,True,0.3224059256736368
2025-01-07 19:33:07,Fail to pick,805,232,0,0,0,0,0,0,0,0,False,0
2025-01-07 19:33:07,segienamKuning,798,232,136,136,161,39,156,42,5,3,False,0.3636303004970257
2025-01-07 19:33:07,Fail to pick,798,232,0,0,0,0,0,0,0,0,False,0
2025-01-07 19:33:07,segienamKuning,802,234,136,134,79,14,81,17,2,3,True,0.37464083100974666
2025-01-07 19:33:07,Fail to pick,802,234,0,0,0,0,0,0,0,0,False,0
2025-01-07 19:33:08,segienamKuning,804,229,136,132,43,97,39,98,4,1,True,0.10165884800894404
2025-01-07 19:33:08,Fail to pick,804,229,0,0,0,0,0,0,0,0,False,0
2025-01-07 19:33:08,segienamKuning,807,233,137,135,70,30,73,34,3,4,True,0.21808174366723812
2025-01-07 19:33:08,Fail to pick,807,233,0,0,0,0,0,0,0,0,False,0
2025-01-07 19:33:08,segienamKuning,803,232,133,132,16,36,18,37,2,1,True,0.2558924118096876
2025-01-07 19:33:08,Fail to pick,803,232,0,0,0,0,0,0,0,0,False,0
2025-01-07 19:33:08,segienamKuning,801,229,137,134,128,33,130,31,2,2,True,0.1337747352493761
2025-01-07 19:33:08,Fail to pick,801,229,0,0,0,0,0,0,0,0,False,0
2025-01-07 19:33:08,segienamKuning,800,230,137,131,132,43,132,44,0,1,True,0.1745667864824983
2025-01-07 19:33:08,Fail to pick,800,230,0,0,0,0,0,0,0,0,False,0
2025-01-07 19:33:08,segienamKuning,800,230,137,131,31,53,31,55,0,2,True,0.10717462093863112
2025-01-07 19:33:08,Fail to pick,800,230,0,0,0,0,0,0,0,0,False,0
2025-01-07 19:33:09,segienamKuning,804,233,135,138,71,66,66,68,5,2,True,0.2658096484968935
2025-01-07 19:33:09,Fail to pick,804,233,0,0,0,0,0,0,0,0,False,0
2025-01-07 19:33:09,segienamKuning,787,227,134,134,25,56,20,57,5,1,True,0.464501535885115
2025-01-07 19:33:10,segienamKuning,799,233,134,132,55,89,52,85,3,4,True,0.18699865231579804
2025-01-07 19:33:10,segienamKuning,810,223,135,128,145,68,140,64,5,4,False,0.4512768861696398
2025-01-07 19:33:10,segienamKuning,813,223,128,128,126,54,124,51,2,3,True,0.21056132085708068
2025-01-07 19:33:10,Fail to pick,813,223,0,0,0,0,0,0,0,0,False,0
2025-01-07 19:33:10,segienamKuning,813,223,128,128,93,57,89,61,4,4,True,0.2186444853349305
2025-01-07 19:33:10,Fail to pick,813,223,0,0,0,0,0,0,0,0,False,0
2025-01-07 19:33:10,segienamKuning,813,220,125,133,158,88,154,83,4,5,True,0.4258003478453921
2025-01-07 19:33:10,Fail to pick,813,220,0,0,0,0,0,0,0,0,False,0
2025-01-07 19:33:16,segienamKuning,914,240,134,137,118,2,116,5,2,3,True,0.11868904620133974
2025-01-07 19:33:16,Kuning,914,240,tensor(134.6304),tensor(137.7439),133,84,134,80,1,4,True,0.0005056858062744141
2025-01-07 19:33:16,segienamKuning,917,243,128,137,109,67,105,71,4,4,True,0.29348759647460065
2025-01-07 19:33:16,Fail to pick,917,243,0,0,0,0,0,0,0,0,False,0
2025-01-07 19:33:16,segienamKuning,919,241,128,136,110,49,107,47,3,2,True,0.37464109583783134
2025-01-07 19:33:16,Fail to pick,919,241,0,0,0,0,0,0,0,0,False,0
2025-01-07 19:33:16,segienamKuning,910,241,125,134,115,50,110,45,5,5,True,0.1249611459581383
2025-01-07 19:33:16,Fail to pick,910,241,0,0,0,0,0,0,0,0,False,0
2025-01-07 19:33:17,segienamKuning,913,234,122,127,197,71,192,73,5,2,True,0.48326515101575074
2025-01-07 19:33:17,Fail to pick,913,234,0,0,0,0,0,0,0,0,False,0
2025-01-07 19:33:17,segienamKuning,944,236,128,130,100,16,100,11,0,5,True,0.31281203636145694
2025-01-07 19:33:17,segienamKuning,917,227,126,129,79,94,81,92,2,2,True,0.2058572240647071
2025-01-07 19:33:17,segienamKuning,956,238,128,131,76,53,79,54,3,1,True,0.27657170264045394
2025-01-07 19:33:28,segienamKuning,902,235,118,133,115,94,113,97,2,3,True,0.4222107003639186
2025-01-07 19:33:28,segienamKuning,855,209,124,142,92,32,88,28,4,4,True,0.36532967002255157
2025-01-07 19:33:28,segienamKuning,866,213,121,133,30,33,27,32,3,1,False,0.13455713939666497
2025-01-07 19:33:28,segienamKuning,843,174,128,139,25,45,21,44,4,1,True,0.2884621913287654
2025-01-07 19:33:28,Kuning,843,174,tensor(128.7559),tensor(139.2800),151,78,155,82,4,4,True,0.0004985332489013672
2025-01-07 19:33:28,segienamKuning,862,194,120,133,132,6,127,9,5,3,True,0.2351519535006078
2025-01-07 19:33:28,segienamKuning,851,180,121,138,132,78,127,76,5,2,True,0.3612085638915473
2025-01-07 19:33:28,persegiKuning,852,181,122,138,147,96,149,95,2,1,True,0.38862811801868336
2025-01-07 19:33:28,Fail to pick,852,181,0,0,0,0,0,0,0,0,False,0
2025-01-07 19:33:29,segienamKuning,854,191,124,136,154,75,155,75,1,0,False,0.13221222048898615
2025-01-07 19:33:29,segienamKuning,901,238,121,128,183,76,182,75,1,1,True,0.3594101463149755
2025-01-07 19:33:29,persegiKuning,899,237,121,128,169,54,167,51,2,3,True,0.4880318277865173
2025-01-07 19:33:29,Fail to pick,899,237,0,0,0,0,0,0,0,0,False,0
2025-01-07 19:33:29,segienamKuning,863,214,131,137,128,20,130,23,2,3,True,0.21038564189610365
2025-01-07 19:33:29,segienamKuning,840,174,140,141,6,64,2,68,4,4,True,0.24527931956987709
2025-01-07 19:33:29,segienamKuning,890,225,122,134,78,49,80,46,2,3,True,0.20037867689188926
2025-01-07 19:33:29,persegiKuning,890,226,121,134,82,72,85,75,3,3,True,0.13036568024525963
2025-01-07 19:33:29,Fail to pick,890,226,0,0,0,0,0,0,0,0,False,0
2025-01-07 19:33:29,segienamKuning,899,232,118,130,154,75,155,72,1,3,True,0.2721300115640296
2025-01-07 19:33:29,Kuning,899,232,tensor(118.5922),tensor(130.8565),135,83,136,78,1,5,True,0.0004990100860595703
2025-01-07 19:33:29,Fail to pick,899,232,0,0,0,0,0,0,0,0,False,0
2025-01-07 19:33:29,segienamKuning,868,201,122,130,34,86,33,86,1,0,True,0.4696617720012801
2025-01-07 19:33:29,segienamKuning,866,199,125,134,109,30,104,34,5,4,True,0.37209057193303907
2025-01-07 19:33:29,Fail to pick,866,199,0,0,0,0,0,0,0,0,False,0
2025-01-07 19:33:30,persegiKuning,890,232,121,132,27,25,27,23,0,2,True,0.3272398372092998
2025-01-07 19:33:30,segienamKuning,888,227,123,132,60,5,59,5,1,0,False,0.35836771451240546
2025-01-07 19:33:30,Fail to pick,888,227,0,0,0,0,0,0,0,0,False,0
2025-01-07 19:33:30,segienamKuning,890,225,123,125,199,31,195,30,4,1,False,0.38174665221577786
2025-01-07 19:33:30,persegiKuning,889,226,123,128,184,4,185,0,1,4,True,0.3217026275833899
2025-01-07 19:33:30,Fail to pick,890,225,0,0,0,0,0,0,0,0,False,0
2025-01-07 19:33:30,Fail to pick,889,226,0,0,0,0,0,0,0,0,False,0
2025-01-07 19:33:30,segienamKuning,889,234,125,132,148,9,151,6,3,3,True,0.22881191772766807
2025-01-07 19:33:30,persegiKuning,890,234,124,132,199,70,195,65,4,5,True,0.4783196076780142
2025-01-07 19:33:30,Kuning,889,234,tensor(125.8288),tensor(132.9550),135,82,131,79,4,3,True,0.0
2025-01-07 19:33:30,Fail to pick,889,234,0,0,0,0,0,0,0,0,False,0
2025-01-07 19:33:30,Fail to pick,890,234,0,0,0,0,0,0,0,0,False,0
2025-01-07 19:33:31,segienamKuning,890,232,120,134,44,80,39,84,5,4,True,0.16765656089422043
2025-01-07 19:33:31,persegiKuning,890,233,120,135,159,92,154,96,5,4,True,0.20037417264216845
2025-01-07 19:33:31,Fail to pick,890,232,0,0,0,0,0,0,0,0,False,0
2025-01-07 19:33:31,Fail to pick,890,233,0,0,0,0,0,0,0,0,False,0
2025-01-07 19:33:43,segienamKuning,922,170,144,119,144,37,141,36,3,1,True,0.36035503165635563
2025-01-07 19:33:43,Kuning,922,170,tensor(144.9365),tensor(119.2482),152,85,149,85,3,0,True,0.0005009174346923828
2025-01-07 19:33:44,segienamKuning,937,188,119,122,171,31,175,31,4,0,True,0.23164261608462342
2025-01-07 19:33:45,segienamKuning,934,189,137,125,116,93,120,95,4,2,True,0.4195346642426472
2025-01-07 19:33:45,Fail to pick,934,189,0,0,0,0,0,0,0,0,False,0
2025-01-07 19:33:45,segienamKuning,938,183,132,130,171,10,174,9,3,1,True,0.4617826489872766
2025-01-07 19:33:45,Fail to pick,938,183,0,0,0,0,0,0,0,0,False,0
2025-01-07 19:33:45,segienamKuning,936,176,136,128,64,45,63,43,1,2,True,0.4036270244528998
2025-01-07 19:33:45,Fail to pick,936,176,0,0,0,0,0,0,0,0,False,0
2025-01-07 19:33:45,segienamKuning,931,183,146,130,61,30,61,30,0,0,True,0.30212758673099227
2025-01-07 19:33:45,Fail to pick,931,183,0,0,0,0,0,0,0,0,False,0
2025-01-07 19:33:45,segienamKuning,945,191,130,124,122,21,123,25,1,4,True,0.3233601653336223
2025-01-07 19:33:45,segienamKuning,944,193,132,124,192,7,189,3,3,4,True,0.11729882094143834
2025-01-07 19:33:45,Fail to pick,944,193,0,0,0,0,0,0,0,0,False,0
2025-01-07 19:33:45,segienamKuning,952,190,136,128,7,40,8,44,1,4,True,0.2252979701712409
2025-01-07 19:33:45,Fail to pick,952,190,0,0,0,0,0,0,0,0,False,0
2025-01-07 19:33:46,segienamKuning,922,176,153,134,123,29,120,31,3,2,True,0.3458704915338927
2025-01-07 19:33:46,segienamKuning,933,179,135,127,46,58,46,58,0,0,True,0.4804934527220648
2025-01-07 19:33:46,segienamKuning,923,165,153,131,29,66,32,62,3,4,True,0.4502232305930046
2025-01-07 19:33:46,segienamKuning,931,169,139,126,170,98,169,99,1,1,True,0.3925984898542153
2025-01-07 19:33:46,Fail to pick,931,169,0,0,0,0,0,0,0,0,False,0
2025-01-07 19:33:48,segienamKuning,689,184,139,133,6,80,3,77,3,3,True,0.24256951944197647
2025-01-07 19:33:48,Kuning,689,184,tensor(139.5539),tensor(133.8177),148,63,148,64,0,1,True,0.0
2025-01-07 19:33:48,segienamKuning,830,269,154,118,86,93,90,93,4,0,True,0.29866822253086284
2025-01-07 19:33:48,segienamKuning,836,276,144,122,92,60,89,60,3,0,True,0.30470268785634624
2025-01-07 19:33:48,Fail to pick,836,276,0,0,0,0,0,0,0,0,False,0
2025-01-07 19:33:48,segienamKuning,835,286,139,119,166,97,168,94,2,3,True,0.14787884471222165
2025-01-07 19:33:48,segienamKuning,853,293,141,122,22,63,25,62,3,1,True,0.3494671492242185
2025-01-07 19:33:48,segienamKuning,846,295,133,118,170,13,171,11,1,2,False,0.344723184084897
2025-01-07 19:33:48,Fail to pick,846,295,0,0,0,0,0,0,0,0,False,0
2025-01-07 19:33:49,segienamKuning,849,294,135,122,57,59,59,59,2,0,True,0.20389861131535936
2025-01-07 19:33:49,Fail to pick,849,294,0,0,0,0,0,0,0,0,False,0
2025-01-07 19:33:49,segienamKuning,846,294,143,120,148,90,144,94,4,4,True,0.44183649897723754
2025-01-07 19:33:49,Fail to pick,846,294,0,0,0,0,0,0,0,0,False,0
2025-01-07 19:33:49,segienamKuning,849,298,140,117,172,24,168,21,4,3,False,0.28350533480444884
2025-01-07 19:33:49,Fail to pick,849,298,0,0,0,0,0,0,0,0,False,0
2025-01-07 19:33:49,segienamKuning,848,300,137,114,24,62,27,64,3,2,True,0.24911926118241878
2025-01-07 19:33:49,Fail to pick,848,300,0,0,0,0,0,0,0,0,False,0
2025-01-07 19:33:49,segienamKuning,845,295,146,122,118,77,114,72,4,5,True,0.3391527736625073
2025-01-07 19:33:49,Fail to pick,845,295,0,0,0,0,0,0,0,0,False,0
2025-01-07 19:33:49,segienamKuning,845,291,138,118,197,69,193,72,4,3,True,0.4037998110594303
2025-01-07 19:33:49,Fail to pick,845,291,0,0,0,0,0,0,0,0,False,0
2025-01-07 19:33:49,segienamKuning,835,297,133,119,120,14,119,16,1,2,True,0.3071286904709871
2025-01-07 19:33:49,segienamKuning,833,296,138,115,20,99,22,103,2,4,True,0.4500236161925678
2025-01-07 19:33:49,Fail to pick,833,296,0,0,0,0,0,0,0,0,False,0
2025-01-07 19:33:50,segienamKuning,828,290,133,114,184,31,188,32,4,1,True,0.3316858429457289
2025-01-07 19:33:50,Fail to pick,828,290,0,0,0,0,0,0,0,0,False,0
2025-01-07 19:33:50,segienamKuning,823,295,137,116,53,73,52,70,1,3,True,0.48073820550043733
2025-01-07 19:33:50,Fail to pick,823,295,0,0,0,0,0,0,0,0,False,0
2025-01-07 19:33:50,segienamKuning,835,296,134,117,149,41,151,42,2,1,True,0.1432675082250362
2025-01-07 19:33:50,segienamKuning,828,296,138,115,23,99,20,100,3,1,True,0.46253088550941257
2025-01-07 19:33:50,Fail to pick,828,296,0,0,0,0,0,0,0,0,False,0
2025-01-07 19:33:50,segienamKuning,834,296,140,117,65,27,62,31,3,4,True,0.28545707821927635
2025-01-07 19:33:50,Fail to pick,834,296,0,0,0,0,0,0,0,0,False,0
2025-01-07 19:33:50,segienamKuning,842,297,143,114,67,43,64,45,3,2,True,0.350794946570254
2025-01-07 19:33:50,Fail to pick,842,297,0,0,0,0,0,0,0,0,False,0
2025-01-07 19:33:50,segienamKuning,830,296,141,116,101,92,101,90,0,2,False,0.10040089589202301
2025-01-07 19:33:51,segienamKuning,831,293,140,114,8,5,3,7,5,2,True,0.25829816947396705
2025-01-07 19:33:51,Fail to pick,831,293,0,0,0,0,0,0,0,0,False,0
2025-01-07 19:33:51,segienamKuning,836,291,142,116,138,45,134,46,4,1,True,0.32594351470350136
2025-01-07 19:33:51,Fail to pick,836,291,0,0,0,0,0,0,0,0,False,0
2025-01-07 19:33:51,segienamKuning,846,293,134,117,53,71,54,70,1,1,True,0.24994447984116627
2025-01-07 19:33:51,segienamKuning,837,292,141,118,95,88,90,84,5,4,True,0.46604385206618903
2025-01-07 19:33:51,Fail to pick,837,292,0,0,0,0,0,0,0,0,False,0
2025-01-07 19:33:51,segienamKuning,840,295,137,116,0,61,-1,57,1,4,True,0.43827295702015256
2025-01-07 19:33:51,Fail to pick,840,295,0,0,0,0,0,0,0,0,False,0
2025-01-07 19:33:51,segienamKuning,837,289,151,117,93,25,92,24,1,1,True,0.19572006246728707
2025-01-07 19:33:51,Fail to pick,837,289,0,0,0,0,0,0,0,0,False,0
2025-01-07 19:33:51,segienamKuning,834,295,125,116,150,36,146,38,4,2,True,0.3703716282214149
2025-01-07 19:33:51,Fail to pick,834,295,0,0,0,0,0,0,0,0,False,0
2025-01-07 19:33:51,segienamKuning,838,298,135,120,14,73,16,73,2,0,True,0.38048432629702644
2025-01-07 19:33:51,Fail to pick,838,298,0,0,0,0,0,0,0,0,False,0
2025-01-07 19:33:52,segienamKuning,835,299,140,115,19,74,16,72,3,2,True,0.4290902059014189
2025-01-07 19:33:52,Fail to pick,835,299,0,0,0,0,0,0,0,0,False,0
2025-01-07 19:33:52,segienamKuning,847,284,145,112,61,4,65,4,4,0,True,0.34574436123524027
2025-01-07 19:33:52,segienamKuning,824,296,138,117,85,90,84,92,1,2,True,0.32642054160438105
2025-01-07 19:33:52,segienamKuning,820,290,144,117,129,22,127,21,2,1,True,0.31016026663701146
2025-01-07 19:33:52,Fail to pick,820,290,0,0,0,0,0,0,0,0,False,0
2025-01-07 19:33:52,segienamKuning,823,285,144,115,145,44,146,46,1,2,True,0.14712107120139348
2025-01-07 19:33:52,Fail to pick,823,285,0,0,0,0,0,0,0,0,False,0
2025-01-07 19:33:52,segienamKuning,820,275,144,116,50,62,49,59,1,3,True,0.30658348230310406
2025-01-07 19:33:54,segienamKuning,812,297,148,123,19,57,18,60,1,3,True,0.42965342227853043
2025-01-07 19:33:55,persegiKuning,823,293,150,188,191,28,191,30,0,2,True,0.2104279098393973
2025-01-07 19:33:55,persegiKuning,836,318,150,169,160,41,155,36,5,5,True,0.1715218760247145
2025-01-07 19:33:55,Kuning,836,318,tensor(150.4084),tensor(169.3573),111,77,109,76,2,1,True,0.0004987716674804688
2025-01-07 19:33:55,segienamKuning,830,316,150,125,26,8,26,3,0,5,True,0.2868056261989885
2025-01-07 19:33:55,Fail to pick,830,316,0,0,0,0,0,0,0,0,False,0
2025-01-07 19:33:55,segienamKuning,834,318,148,121,177,70,173,71,4,1,True,0.14930649042962565
2025-01-07 19:33:55,Fail to pick,834,318,0,0,0,0,0,0,0,0,False,0
2025-01-07 19:33:55,segienamKuning,836,320,142,120,82,28,83,27,1,1,True,0.19101338656141645
2025-01-07 19:33:55,Fail to pick,836,320,0,0,0,0,0,0,0,0,False,0
2025-01-07 19:33:56,segienamKuning,825,314,144,124,149,93,148,92,1,1,True,0.4046374354449397
2025-01-07 19:33:56,segienamKuning,822,310,146,152,27,21,30,22,3,1,True,0.15759514778675202
2025-01-07 19:33:56,Fail to pick,822,310,0,0,0,0,0,0,0,0,False,0
2025-01-07 19:33:56,segienamKuning,826,299,147,116,154,15,158,17,4,2,True,0.1300199719146491
2025-01-07 19:34:12,segienamKuning,260,360,166,124,191,9,187,11,4,2,False,0.12623434051030583
2025-01-07 19:34:12,Kuning,260,360,tensor(166.1781),tensor(124.1624),100,24,103,22,3,2,True,0.0
2025-01-07 19:34:12,segienamKuning,272,355,139,153,93,84,94,87,1,3,True,0.36690871235141176
2025-01-07 19:34:13,segienamKuning,271,359,151,139,130,33,131,29,1,4,True,0.31412458831246437
2025-01-07 19:34:13,Fail to pick,271,359,0,0,0,0,0,0,0,0,False,0
2025-01-07 19:34:13,segienamKuning,259,361,126,146,106,55,103,57,3,2,True,0.12117838511823492
2025-01-07 19:34:13,segienamKuning,270,362,134,137,47,67,47,68,0,1,True,0.4822836811640797
2025-01-07 19:34:13,segienamKuning,262,358,129,129,84,88,87,87,3,1,True,0.3075099152363272
2025-01-07 19:34:13,Fail to pick,262,358,0,0,0,0,0,0,0,0,False,0
2025-01-07 19:34:13,segienamKuning,267,355,134,159,165,25,164,20,1,5,True,0.2933947692143338
2025-01-07 19:34:13,Fail to pick,267,355,0,0,0,0,0,0,0,0,False,0
2025-01-07 19:34:13,segienamKuning,271,363,134,126,50,0,47,3,3,3,True,0.2828143990383919
2025-01-07 19:34:13,Fail to pick,271,363,0,0,0,0,0,0,0,0,False,0
2025-01-07 19:34:13,segienamKuning,257,359,124,132,196,87,196,86,0,1,True,0.2256088945049466
2025-01-07 19:34:14,segienamKuning,255,366,121,121,37,30,41,32,4,2,True,0.13020677398967007
2025-01-07 19:34:14,Fail to pick,255,366,0,0,0,0,0,0,0,0,False,0
2025-01-07 19:34:14,segienamKuning,259,368,135,131,182,18,182,22,0,4,False,0.3218603381670424
2025-01-07 19:34:14,Fail to pick,259,368,0,0,0,0,0,0,0,0,False,0
2025-01-07 19:34:14,segienamKuning,273,360,132,131,32,61,32,58,0,3,True,0.44220637776623206
2025-01-07 19:34:14,segienamKuning,265,364,130,124,87,93,89,92,2,1,True,0.29353211814277935
2025-01-07 19:34:14,Fail to pick,265,364,0,0,0,0,0,0,0,0,False,0
2025-01-07 19:34:14,segienamKuning,267,361,134,126,43,89,43,90,0,1,True,0.16515984916316562
2025-01-07 19:34:14,Fail to pick,267,361,0,0,0,0,0,0,0,0,False,0
2025-01-07 19:34:14,segienamKuning,261,364,133,127,88,64,84,63,4,1,True,0.48410519579898315
2025-01-07 19:34:14,Fail to pick,261,364,0,0,0,0,0,0,0,0,False,0
2025-01-07 19:34:14,segienamKuning,254,370,134,137,86,46,87,50,1,4,True,0.41844968611013245
2025-01-07 19:34:14,Fail to pick,254,370,0,0,0,0,0,0,0,0,False,0
2025-01-07 19:34:14,segienamKuning,260,367,129,128,70,12,66,14,4,2,True,0.2876567173378153
2025-01-07 19:34:14,Fail to pick,260,367,0,0,0,0,0,0,0,0,False,0
2025-01-07 19:34:15,segienamKuning,268,361,135,129,132,29,133,26,1,3,True,0.1538796053251757
2025-01-07 19:34:15,Fail to pick,268,361,0,0,0,0,0,0,0,0,False,0
2025-01-07 19:34:15,segienamKuning,258,371,129,133,182,83,183,84,1,1,True,0.4555618785906509
2025-01-07 19:34:15,segienamKuning,266,367,131,128,37,20,34,19,3,1,True,0.4938248411581584
2025-01-07 19:34:15,Fail to pick,266,367,0,0,0,0,0,0,0,0,False,0
2025-01-07 19:34:15,segienamKuning,261,367,134,127,156,18,160,18,4,0,True,0.28655806785515475
2025-01-07 19:34:15,Fail to pick,261,367,0,0,0,0,0,0,0,0,False,0
2025-01-07 19:34:15,segienamKuning,261,361,132,133,61,54,60,55,1,1,True,0.44093352881272596
2025-01-07 19:34:15,Fail to pick,261,361,0,0,0,0,0,0,0,0,False,0
2025-01-07 19:34:15,segienamKuning,266,368,132,126,152,57,150,54,2,3,True,0.32516173891913325
2025-01-07 19:34:15,Fail to pick,266,368,0,0,0,0,0,0,0,0,False,0
2025-01-07 19:34:15,segienamKuning,264,363,134,133,12,68,12,68,0,0,True,0.17810293353227366
2025-01-07 19:34:15,Fail to pick,264,363,0,0,0,0,0,0,0,0,False,0
2025-01-07 19:34:16,segienamKuning,272,362,134,131,120,20,119,21,1,1,False,0.2848961366003109
2025-01-07 19:34:16,Fail to pick,272,362,0,0,0,0,0,0,0,0,False,0
2025-01-07 19:34:16,segienamKuning,256,372,134,132,173,24,169,25,4,1,True,0.3475473501016466
2025-01-07 19:34:16,segienamKuning,258,357,127,124,145,49,140,45,5,4,True,0.15387393009310923
2025-01-07 19:34:16,segienamKuning,261,367,132,131,6,30,3,27,3,3,True,0.40628712851413273
2025-01-07 19:34:16,segienamKuning,265,357,127,125,102,30,97,32,5,2,False,0.12098325353155813
2025-01-07 19:34:16,segienamKuning,270,356,135,132,42,95,46,94,4,1,True,0.42359676909017907
2025-01-07 19:34:16,Fail to pick,270,356,0,0,0,0,0,0,0,0,False,0
2025-01-07 19:34:16,segienamKuning,267,363,124,126,44,97,46,97,2,0,True,0.41888120286934794
2025-01-07 19:34:16,Fail to pick,267,363,0,0,0,0,0,0,0,0,False,0
2025-01-07 19:34:17,segienamKuning,262,363,130,132,120,36,117,37,3,1,True,0.4576633708291634
2025-01-07 19:34:17,Fail to pick,262,363,0,0,0,0,0,0,0,0,False,0
2025-01-07 19:34:17,segienamKuning,272,363,137,127,179,10,176,14,3,4,True,0.28475846389667825
2025-01-07 19:34:17,segienamKuning,266,361,131,126,51,28,53,24,2,4,True,0.10789766660546665
2025-01-07 19:34:17,Fail to pick,266,361,0,0,0,0,0,0,0,0,False,0
2025-01-07 19:34:17,segienamKuning,261,360,129,128,28,81,31,81,3,0,True,0.24626773652828074
2025-01-07 19:34:17,Fail to pick,261,360,0,0,0,0,0,0,0,0,False,0
2025-01-07 19:34:17,segienamKuning,260,365,132,130,1,45,-1,42,2,3,True,0.23316412208462767
2025-01-07 19:34:17,Fail to pick,260,365,0,0,0,0,0,0,0,0,False,0
2025-01-07 19:34:17,segienamKuning,264,359,129,131,159,14,156,14,3,0,True,0.3292458958550103
2025-01-07 19:34:17,Fail to pick,264,359,0,0,0,0,0,0,0,0,False,0
2025-01-07 19:34:17,segienamKuning,265,359,125,132,130,30,127,33,3,3,True,0.49249215079900943
2025-01-07 19:34:17,Fail to pick,265,359,0,0,0,0,0,0,0,0,False,0
2025-01-07 19:34:18,segienamKuning,260,365,126,125,54,88,58,83,4,5,True,0.43219004321222476
2025-01-07 19:34:18,Fail to pick,260,365,0,0,0,0,0,0,0,0,False,0
2025-01-07 19:34:18,segienamKuning,261,361,130,132,85,63,88,66,3,3,True,0.2630455471098291
2025-01-07 19:34:18,Fail to pick,261,361,0,0,0,0,0,0,0,0,False,0
2025-01-07 19:34:18,segienamKuning,262,359,129,134,134,39,130,35,4,4,True,0.12466135248430198
2025-01-07 19:34:18,Fail to pick,262,359,0,0,0,0,0,0,0,0,False,0
2025-01-07 19:34:18,segienamKuning,268,360,130,131,85,53,86,55,1,2,True,0.29967365242345634
2025-01-07 19:34:18,Fail to pick,268,360,0,0,0,0,0,0,0,0,False,0
2025-01-07 19:34:18,segienamKuning,261,359,128,129,118,99,114,97,4,2,True,0.49384698608278466
2025-01-07 19:34:18,Fail to pick,261,359,0,0,0,0,0,0,0,0,False,0
2025-01-07 19:34:18,segienamKuning,258,365,132,129,149,26,148,24,1,2,False,0.2029985239971977
2025-01-07 19:34:18,Fail to pick,258,365,0,0,0,0,0,0,0,0,False,0
2025-01-07 19:34:19,segienamKuning,267,358,134,129,159,79,161,75,2,4,True,0.19174272733670583
2025-01-07 19:34:19,Fail to pick,267,358,0,0,0,0,0,0,0,0,False,0
2025-01-07 19:34:19,segienamKuning,266,360,128,129,185,81,181,79,4,2,True,0.34328794524266965
2025-01-07 19:34:19,Fail to pick,266,360,0,0,0,0,0,0,0,0,False,0
2025-01-07 19:34:19,segienamKuning,261,356,127,127,143,46,139,42,4,4,True,0.20808332543554095
2025-01-07 19:34:19,Fail to pick,261,356,0,0,0,0,0,0,0,0,False,0
2025-01-07 19:34:19,segienamKuning,266,360,133,133,68,62,70,57,2,5,True,0.38932045480292876
2025-01-07 19:34:19,Fail to pick,266,360,0,0,0,0,0,0,0,0,False,0
2025-01-07 19:34:19,segienamKuning,263,367,131,136,36,70,32,66,4,4,True,0.22981704830390745
2025-01-07 19:34:19,Fail to pick,263,367,0,0,0,0,0,0,0,0,False,0
2025-01-07 19:34:19,segienamKuning,260,359,132,129,181,41,181,42,0,1,True,0.19201403990842636
2025-01-07 19:34:19,Fail to pick,260,359,0,0,0,0,0,0,0,0,False,0
2025-01-07 19:34:19,segienamKuning,263,357,124,139,5,61,1,64,4,3,True,0.4914896951076948
2025-01-07 19:34:19,Fail to pick,263,357,0,0,0,0,0,0,0,0,False,0
2025-01-07 19:34:19,segienamKuning,264,360,125,130,73,74,76,78,3,4,True,0.32386800058564985
2025-01-07 19:34:19,Fail to pick,264,360,0,0,0,0,0,0,0,0,False,0
2025-01-07 19:34:20,segienamKuning,260,356,134,138,142,44,144,42,2,2,True,0.4880319155312135
2025-01-07 19:34:20,Fail to pick,260,356,0,0,0,0,0,0,0,0,False,0
2025-01-07 19:39:21,persegiBiru,251,633,125,114,40,12,41,10,1,2,True,0.20815474400394585
2025-01-07 19:39:21,Biru,251,633,tensor(125.6354),tensor(114.5012),24,23,21,21,3,2,True,0.0005006790161132812
2025-01-07 19:39:21,persegiBiru,273,620,128,117,91,45,86,47,5,2,True,0.3841228024474669
2025-01-07 19:39:21,persegiBiru,264,616,126,117,190,25,188,21,2,4,True,0.44151380252685424
2025-01-07 19:39:21,Fail to pick,264,616,0,0,0,0,0,0,0,0,False,0
2025-01-07 19:39:22,persegiBiru,235,618,123,114,132,17,129,17,3,0,True,0.47799887975259947
2025-01-07 19:39:22,persegiBiru,260,601,130,113,165,86,164,88,1,2,False,0.11802996694393851
2025-01-07 19:39:22,persegiBiru,250,574,127,111,122,30,124,32,2,2,True,0.4113137825176255
2025-01-07 19:39:22,persegiBiru,242,570,120,107,53,66,57,67,4,1,True,0.2938239707803363
2025-01-07 19:39:22,Fail to pick,242,570,0,0,0,0,0,0,0,0,False,0
2025-01-07 19:39:22,persegiBiru,211,583,117,104,178,67,174,67,4,0,False,0.1766078313897008
2025-01-07 19:39:22,persegiBiru,227,568,123,103,165,93,160,97,5,4,True,0.14816671826455516
2025-01-07 19:39:22,persegiBiru,255,541,126,110,159,2,155,-3,4,5,False,0.3527959078191888
2025-01-07 19:39:22,persegiBiru,255,539,124,112,0,49,4,48,4,1,True,0.11886967878653576
2025-01-07 19:39:22,Fail to pick,255,539,0,0,0,0,0,0,0,0,False,0
2025-01-07 19:39:22,persegiBiru,248,549,127,110,96,98,98,100,2,2,True,0.4711877150612813
2025-01-07 19:39:23,persegiBiru,217,569,120,105,194,56,192,52,2,4,True,0.12729450456638614
2025-01-07 19:39:23,persegiBiru,266,539,126,113,159,88,155,83,4,5,True,0.12332696783627478
2025-01-07 19:39:23,persegiBiru,243,544,125,110,109,23,104,23,5,0,True,0.48432322426965746
2025-01-07 19:39:23,persegiBiru,261,544,127,110,61,4,56,3,5,1,True,0.3799944497366966
2025-01-07 19:39:23,persegiBiru,261,539,127,112,118,62,121,62,3,0,True,0.18084401958392277
2025-01-07 19:39:23,Fail to pick,261,539,0,0,0,0,0,0,0,0,False,0
2025-01-07 19:39:23,persegiBiru,256,545,125,110,37,75,39,70,2,5,True,0.33549023449446974
2025-01-07 19:39:23,Fail to pick,256,545,0,0,0,0,0,0,0,0,False,0
2025-01-07 19:39:23,persegiBiru,256,541,129,115,38,93,37,88,1,5,True,0.3326683152955415
2025-01-07 19:39:23,Fail to pick,256,541,0,0,0,0,0,0,0,0,False,0
2025-01-07 19:39:23,persegiBiru,246,546,130,111,186,91,189,86,3,5,True,0.32890165949714906
2025-01-07 19:39:23,persegiBiru,256,543,130,113,167,47,169,49,2,2,True,0.16308408393005241
2025-01-07 19:39:24,persegiBiru,259,542,129,114,159,14,162,15,3,1,True,0.45876690220457284
2025-01-07 19:39:24,Fail to pick,259,542,0,0,0,0,0,0,0,0,False,0
2025-01-07 19:39:24,persegiBiru,258,544,129,109,129,52,131,54,2,2,True,0.33219302685764085
2025-01-07 19:39:24,Fail to pick,258,544,0,0,0,0,0,0,0,0,False,0
2025-01-07 19:39:24,persegiBiru,260,542,129,111,151,41,152,36,1,5,True,0.1099747691997747
2025-01-07 19:39:24,Fail to pick,260,542,0,0,0,0,0,0,0,0,False,0
2025-01-07 19:39:24,persegiBiru,246,549,127,108,139,90,134,93,5,3,True,0.4567337054952334
2025-01-07 19:39:24,persegiBiru,248,552,125,107,36,91,39,94,3,3,True,0.38338636501015966
2025-01-07 19:39:24,Fail to pick,248,552,0,0,0,0,0,0,0,0,False,0
2025-01-07 19:39:24,persegiBiru,247,553,123,105,27,12,29,10,2,2,True,0.11328816053777602
2025-01-07 19:39:24,Fail to pick,247,553,0,0,0,0,0,0,0,0,False,0
2025-01-07 19:39:24,persegiBiru,244,545,122,108,141,12,139,8,2,4,True,0.37511688127646525
2025-01-07 19:39:24,Fail to pick,244,545,0,0,0,0,0,0,0,0,False,0
2025-01-07 19:39:24,persegiBiru,245,558,123,105,89,65,88,62,1,3,True,0.43635158453398615
2025-01-07 19:39:25,persegiBiru,244,560,120,103,80,50,82,49,2,1,True,0.4355905324542587
2025-01-07 19:39:25,Fail to pick,244,560,0,0,0,0,0,0,0,0,False,0
2025-01-07 19:39:25,persegiBiru,245,558,120,108,117,32,113,34,4,2,True,0.40191603455660263
2025-01-07 19:39:25,Fail to pick,245,558,0,0,0,0,0,0,0,0,False,0
2025-01-07 19:39:25,persegiBiru,248,561,123,105,131,1,129,-3,2,4,True,0.4398745523227111
2025-01-07 19:39:25,Fail to pick,248,561,0,0,0,0,0,0,0,0,False,0
2025-01-07 19:39:25,persegiBiru,247,555,124,107,170,45,173,48,3,3,True,0.34504771865884526
2025-01-07 19:39:25,Fail to pick,247,555,0,0,0,0,0,0,0,0,False,0
2025-01-07 19:39:25,persegiBiru,242,559,119,107,90,69,88,69,2,0,True,0.32416038259964064
2025-01-07 19:39:25,Fail to pick,242,559,0,0,0,0,0,0,0,0,False,0
2025-01-07 19:39:25,persegiBiru,239,563,119,106,199,48,194,45,5,3,True,0.2476975852695562
2025-01-07 19:39:25,Fail to pick,239,563,0,0,0,0,0,0,0,0,False,0
2025-01-07 19:39:25,persegiBiru,238,575,118,104,145,33,149,29,4,4,True,0.3637463143891687
2025-01-07 19:39:25,persegiBiru,247,569,127,108,127,40,126,38,1,2,True,0.35782808453102677
2025-01-07 19:39:25,Fail to pick,247,569,0,0,0,0,0,0,0,0,False,0
2025-01-07 19:39:25,persegiBiru,246,565,126,109,192,32,193,30,1,2,True,0.3679057564672462
2025-01-07 19:39:25,Fail to pick,246,565,0,0,0,0,0,0,0,0,False,0
2025-01-07 19:39:26,persegiBiru,244,563,123,108,146,66,147,70,1,4,True,0.36209741966531095
2025-01-07 19:39:26,Fail to pick,244,563,0,0,0,0,0,0,0,0,False,0
2025-01-07 19:39:26,persegiBiru,243,568,119,105,186,0,184,1,2,1,True,0.4499616645340827
2025-01-07 19:39:26,Fail to pick,243,568,0,0,0,0,0,0,0,0,False,0
2025-01-07 19:39:26,persegiBiru,246,567,120,107,68,54,68,51,0,3,True,0.391845780585121
2025-01-07 19:39:26,Fail to pick,246,567,0,0,0,0,0,0,0,0,False,0
2025-01-07 19:39:26,persegiBiru,247,557,123,104,134,37,135,39,1,2,True,0.15308494087806146
2025-01-07 19:39:26,persegiBiru,241,558,119,104,190,26,192,28,2,2,True,0.3884307245849482
2025-01-07 19:39:26,Fail to pick,241,558,0,0,0,0,0,0,0,0,False,0
2025-01-07 19:39:26,persegiBiru,247,546,128,107,169,70,173,73,4,3,True,0.4691540765478103
2025-01-07 19:39:26,persegiBiru,246,546,128,106,78,39,77,42,1,3,True,0.3538853993262776
2025-01-07 19:39:26,Fail to pick,246,546,0,0,0,0,0,0,0,0,False,0
2025-01-07 19:39:26,persegiBiru,252,548,129,107,99,22,101,20,2,2,True,0.45312807070008654
2025-01-07 19:39:26,Fail to pick,252,548,0,0,0,0,0,0,0,0,False,0
2025-01-07 19:39:27,persegiBiru,261,540,130,114,20,93,18,97,2,4,True,0.11653555777908382
2025-01-07 19:39:27,Fail to pick,261,540,0,0,0,0,0,0,0,0,False,0
2025-01-07 19:39:27,persegiBiru,257,545,125,109,138,79,142,80,4,1,True,0.4199427634375804
2025-01-07 19:39:27,Fail to pick,257,545,0,0,0,0,0,0,0,0,False,0
2025-01-07 19:39:27,persegiBiru,255,546,122,107,143,81,146,76,3,5,True,0.43857668836678376
2025-01-07 19:39:27,Fail to pick,255,546,0,0,0,0,0,0,0,0,False,0
2025-01-07 19:39:27,persegiBiru,248,544,126,109,153,50,148,47,5,3,True,0.3907986344786035
2025-01-07 19:39:27,Fail to pick,248,544,0,0,0,0,0,0,0,0,False,0
2025-01-07 19:39:27,persegiBiru,252,546,128,110,90,99,93,97,3,2,True,0.3237926543316028
2025-01-07 19:39:27,Fail to pick,252,546,0,0,0,0,0,0,0,0,False,0
2025-01-07 19:39:27,persegiBiru,249,545,127,110,169,62,172,63,3,1,True,0.19276181031958695
2025-01-07 19:39:27,Fail to pick,249,545,0,0,0,0,0,0,0,0,False,0
2025-01-07 19:39:27,persegiBiru,257,546,131,110,180,14,179,12,1,2,False,0.35825531760581275
2025-01-07 19:39:27,Fail to pick,257,546,0,0,0,0,0,0,0,0,False,0
2025-01-07 19:39:27,persegiBiru,248,546,125,110,115,28,111,29,4,1,False,0.11031610310516911
2025-01-07 19:39:27,Fail to pick,248,546,0,0,0,0,0,0,0,0,False,0
2025-01-07 19:39:27,persegiBiru,260,541,127,112,45,96,46,96,1,0,True,0.4488883517301927
2025-01-07 19:39:28,persegiBiru,259,543,129,110,184,75,179,72,5,3,True,0.2123059366462997
2025-01-07 19:39:28,Fail to pick,259,543,0,0,0,0,0,0,0,0,False,0
2025-01-07 19:39:28,persegiBiru,248,544,126,112,181,86,178,82,3,4,True,0.3909004728842649
2025-01-07 19:39:28,persegiBiru,259,545,127,110,99,61,102,59,3,2,True,0.32108686292399674
2025-01-07 19:39:28,persegiBiru,248,541,126,112,192,39,191,38,1,1,True,0.49390484320663675
2025-01-07 19:39:28,persegiBiru,244,550,120,110,148,54,146,57,2,3,True,0.153635591136513
2025-01-07 19:39:28,Fail to pick,244,550,0,0,0,0,0,0,0,0,False,0
2025-01-07 19:39:28,persegiBiru,248,548,129,107,48,24,46,26,2,2,True,0.15836819985089204
2025-01-07 19:39:28,Fail to pick,248,548,0,0,0,0,0,0,0,0,False,0
2025-01-07 19:39:28,persegiBiru,259,540,133,111,23,1,21,1,2,0,True,0.3784613006794936
2025-01-07 19:39:28,persegiBiru,267,542,129,112,31,17,33,13,2,4,True,0.1479966549637971
2025-01-07 19:39:28,Fail to pick,267,542,0,0,0,0,0,0,0,0,False,0
2025-01-07 19:39:28,persegiBiru,236,553,123,110,43,49,43,48,0,1,False,0.3921687473173646
2025-01-07 19:39:29,persegiBiru,253,543,131,111,155,31,153,32,2,1,True,0.16711967010156326
2025-01-07 19:39:29,persegiBiru,250,542,129,111,8,24,10,22,2,2,True,0.10793400913213579
2025-01-07 19:39:29,Fail to pick,250,542,0,0,0,0,0,0,0,0,False,0
2025-01-07 19:39:29,persegiBiru,261,542,130,111,180,7,175,3,5,4,True,0.10109615170792403
2025-01-07 19:39:29,persegiBiru,235,557,120,110,184,58,182,62,2,4,True,0.3988809785063746
2025-01-07 19:39:29,persegiBiru,243,553,122,108,115,63,117,58,2,5,True,0.3106537892388429
2025-01-07 19:39:29,Fail to pick,243,553,0,0,0,0,0,0,0,0,False,0
2025-01-07 19:39:29,persegiBiru,255,548,126,105,138,10,139,9,1,1,True,0.10085886478702061
2025-01-07 19:39:29,persegiBiru,239,557,119,108,124,35,119,31,5,4,True,0.25094458089161786
2025-01-07 19:39:29,persegiBiru,249,543,126,111,60,79,56,81,4,2,True,0.11982433052900361
2025-01-07 19:39:29,persegiBiru,249,546,125,109,87,59,87,55,0,4,False,0.337970429210276
2025-01-07 19:39:29,Fail to pick,249,546,0,0,0,0,0,0,0,0,False,0
2025-01-07 19:39:30,persegiBiru,236,554,120,111,114,42,110,41,4,1,True,0.4273243589405319
2025-01-07 19:39:30,persegiBiru,250,578,129,121,76,85,75,89,1,4,False,0.2966137685611887
2025-01-07 19:39:46,persegiMerah,798,177,126,125,46,34,43,38,3,4,True,0.17357240733762117
2025-01-07 19:39:46,Merah,798,177,tensor(126.4047),tensor(125.4371),150,73,153,77,3,4,True,0.0
2025-01-07 19:39:46,persegiMerah,794,177,124,125,107,28,102,24,5,4,True,0.3038166769848918
2025-01-07 19:39:46,Fail to pick,794,177,0,0,0,0,0,0,0,0,False,0
2025-01-07 19:39:46,persegiMerah,789,181,128,126,56,89,52,88,4,1,True,0.4276261134633116
2025-01-07 19:39:46,Fail to pick,789,181,0,0,0,0,0,0,0,0,False,0
2025-01-07 19:39:46,persegiMerah,747,151,127,130,194,12,197,12,3,0,True,0.15426119326077045
2025-01-07 19:39:46,persegiMerah,785,186,128,125,45,4,44,2,1,2,False,0.38425691325576394
2025-01-07 19:39:47,persegiMerah,784,182,131,128,196,76,199,78,3,2,True,0.3162424999855602
2025-01-07 19:39:47,Fail to pick,784,182,0,0,0,0,0,0,0,0,False,0
2025-01-07 19:39:47,persegiMerah,785,188,127,128,153,40,151,35,2,5,True,0.12466062077175777
2025-01-07 19:39:47,Fail to pick,785,188,0,0,0,0,0,0,0,0,False,0
2025-01-07 19:39:47,persegiMerah,731,135,129,129,105,90,109,85,4,5,True,0.12409908458270613
2025-01-07 19:39:47,Merah,731,135,tensor(129.6005),tensor(129.4369),162,67,164,70,2,3,True,0.0004990100860595703
2025-01-07 19:39:47,persegiMerah,783,184,124,125,86,10,88,12,2,2,False,0.4950586668410547
2025-01-07 19:39:47,persegiMerah,787,186,127,129,105,86,105,89,0,3,True,0.4414746348085846
2025-01-07 19:39:47,Fail to pick,787,186,0,0,0,0,0,0,0,0,False,0
2025-01-07 19:39:47,persegiMerah,782,184,122,130,188,64,190,66,2,2,True,0.37780496871442826
2025-01-07 19:39:47,Fail to pick,782,184,0,0,0,0,0,0,0,0,False,0
2025-01-07 19:39:47,persegiMerah,782,189,123,127,146,19,146,23,0,4,True,0.15135980691556658
2025-01-07 19:39:47,Fail to pick,782,189,0,0,0,0,0,0,0,0,False,0
2025-01-07 19:39:48,persegiMerah,784,189,125,128,135,55,130,51,5,4,True,0.14325638137907648
2025-01-07 19:39:48,Fail to pick,784,189,0,0,0,0,0,0,0,0,False,0
2025-01-07 19:39:48,persegiMerah,769,189,131,130,179,72,178,76,1,4,True,0.3382902725998161
2025-01-07 19:39:48,persegiMerah,774,184,132,132,152,2,155,6,3,4,True,0.45749544610217474
2025-01-07 19:39:48,Fail to pick,774,184,0,0,0,0,0,0,0,0,False,0
2025-01-07 19:39:48,persegiMerah,779,192,126,125,41,8,44,12,3,4,True,0.40260924495461015
2025-01-07 19:39:48,Fail to pick,779,192,0,0,0,0,0,0,0,0,False,0
2025-01-07 19:43:29,segienamKuning,91,79,113,99,16,10,13,13,3,3,True,0.46299133719210717
2025-01-07 19:43:29,Kuning,91,79,tensor(113.1683),tensor(99.2246),178,8,182,3,4,5,True,0.0005056858062744141
2025-01-07 19:43:29,segienamKuning,95,83,119,92,140,36,144,34,4,2,True,0.174487220431629
2025-01-07 19:43:29,Fail to pick,95,83,0,0,0,0,0,0,0,0,False,0
2025-01-07 19:43:33,persegiHijau,413,30,93,61,36,78,39,77,3,1,True,0.14141547889302308
2025-01-07 19:43:33,persegiMerah,892,392,133,111,41,65,37,64,4,1,True,0.35089790070812366
2025-01-07 19:43:33,Hijau,413,30,tensor(93.5807),tensor(61.4635),191,38,193,42,2,4,True,0.0
2025-01-07 19:43:33,persegiMerah,891,392,131,111,128,61,128,65,0,4,True,0.1278697096574903
2025-01-07 19:43:33,persegiHijau,407,28,95,57,140,90,139,91,1,1,True,0.3133266130441007
2025-01-07 19:43:33,lingkaranHijau,409,29,93,59,130,87,127,83,3,4,True,0.2270025611531934
2025-01-07 19:43:33,Fail to pick,891,392,0,0,0,0,0,0,0,0,False,0
2025-01-07 19:43:33,Fail to pick,409,29,0,0,0,0,0,0,0,0,False,0
2025-01-07 19:43:34,persegiMerah,894,404,130,113,178,37,179,36,1,1,True,0.2794112321869736
2025-01-07 19:43:34,lingkaranHijau,397,29,89,59,134,32,133,36,1,4,True,0.12743564035474608
2025-01-07 19:43:34,Merah,894,404,tensor(130.0794),tensor(113.3409),87,82,90,83,3,1,True,0.0005054473876953125
2025-01-07 19:43:34,persegiMerah,893,403,129,112,10,23,10,24,0,1,True,0.12872450151840323
2025-01-07 19:43:34,persegiMerah,894,396,130,111,189,69,187,72,2,3,True,0.20696461370786895
2025-01-07 19:43:34,lingkaranHijau,404,28,94,57,127,29,129,27,2,2,True,0.3913772678848597
2025-01-07 19:43:34,Fail to pick,894,396,0,0,0,0,0,0,0,0,False,0
2025-01-07 19:43:35,persegiMerah,889,393,127,112,62,78,59,73,3,5,True,0.2942155645265581
2025-01-07 19:43:35,persegiHijau,395,29,94,59,188,8,190,12,2,4,False,0.18261671838545956
2025-01-07 19:43:35,persegiMerah,882,390,128,113,125,92,123,95,2,3,True,0.2778233473797491
2025-01-07 19:43:35,persegiMerah,882,388,127,112,59,42,54,44,5,2,True,0.3167278924459175
2025-01-07 19:43:35,persegiHijau,389,28,89,57,19,10,16,14,3,4,True,0.16131299887347775
2025-01-07 19:43:35,lingkaranHijau,388,29,90,58,55,51,54,55,1,4,True,0.3138139286541417
2025-01-07 19:43:35,Fail to pick,882,388,0,0,0,0,0,0,0,0,False,0
2025-01-07 19:43:35,Fail to pick,388,29,0,0,0,0,0,0,0,0,False,0
2025-01-07 19:43:35,persegiHijau,389,29,88,58,197,76,197,79,0,3,True,0.1440972599241965
2025-01-07 19:43:35,lingkaranHijau,389,29,88,58,180,53,183,57,3,4,True,0.33635097640342826
2025-01-07 19:43:35,Fail to pick,389,29,0,0,0,0,0,0,0,0,False,0
2025-01-07 19:43:35,Fail to pick,389,29,0,0,0,0,0,0,0,0,False,0
2025-01-07 19:43:36,lingkaranHijau,391,29,87,59,195,19,190,21,5,2,True,0.4831805241826522
2025-01-07 19:43:36,persegiHijau,391,29,88,58,8,14,8,18,0,4,True,0.23518703239892
2025-01-07 19:43:36,persegiMerah,882,386,129,111,183,0,185,0,2,0,True,0.2819763860896175
2025-01-07 19:43:36,Fail to pick,391,29,0,0,0,0,0,0,0,0,False,0
2025-01-07 19:43:36,Fail to pick,391,29,0,0,0,0,0,0,0,0,False,0
2025-01-07 19:43:36,Merah,882,386,tensor(129.3261),tensor(111.9590),92,81,96,77,4,4,True,0.0010046958923339844
2025-01-07 19:43:36,persegiMerah,880,391,130,112,193,65,188,65,5,0,True,0.3798842673383037
2025-01-07 19:43:36,lingkaranHijau,388,31,89,63,86,23,90,18,4,5,True,0.4121882918210905
2025-01-07 19:43:36,Fail to pick,880,391,0,0,0,0,0,0,0,0,False,0
2025-01-07 19:43:36,persegiMerah,881,387,128,111,55,41,55,42,0,1,True,0.42227423698214817
2025-01-07 19:43:36,persegiHijau,390,30,90,61,116,61,119,57,3,4,True,0.19779478443430581
2025-01-07 19:43:36,persegiMerah,874,385,128,114,164,3,159,4,5,1,True,0.1588273902425674
2025-01-07 19:43:36,lingkaranHijau,379,29,93,58,128,59,131,58,3,1,True,0.13617049809056037
2025-01-07 19:43:36,persegiHijau,378,28,95,57,172,86,172,83,0,3,True,0.2398048560337112
2025-01-07 19:43:36,Fail to pick,378,28,0,0,0,0,0,0,0,0,False,0
2025-01-07 19:43:36,persegiMerah,888,396,125,112,179,20,182,16,3,4,True,0.48078713157062813
2025-01-07 19:43:36,persegiMerah,888,396,125,112,31,33,28,36,3,3,True,0.35734694420519053
2025-01-07 19:43:36,Fail to pick,888,396,0,0,0,0,0,0,0,0,False,0
2025-01-07 19:43:36,persegiMerah,891,399,129,111,103,1,102,3,1,2,False,0.304783918399179
2025-01-07 19:43:36,Fail to pick,891,399,0,0,0,0,0,0,0,0,False,0
2025-01-07 19:43:36,persegiMerah,889,392,127,111,63,89,64,85,1,4,True,0.45295961703729504
2025-01-07 19:43:36,Fail to pick,889,392,0,0,0,0,0,0,0,0,False,0
2025-01-07 19:43:36,persegiMerah,889,385,131,112,17,17,18,20,1,3,True,0.280826398830607
2025-01-07 19:43:36,lingkaranHijau,418,32,91,65,193,80,189,82,4,2,True,0.3007358983432461
2025-01-07 19:43:36,Fail to pick,889,385,0,0,0,0,0,0,0,0,False,0
2025-01-07 19:43:37,persegiMerah,894,381,130,112,94,70,93,72,1,2,True,0.19788862716705508
2025-01-07 19:43:37,persegiHijau,427,31,96,62,116,32,120,29,4,3,True,0.42982752641704225
2025-01-07 19:43:37,lingkaranHijau,427,32,93,64,74,63,75,58,1,5,True,0.42515590120356495
2025-01-07 19:43:37,Fail to pick,427,32,0,0,0,0,0,0,0,0,False,0
2025-01-07 19:43:37,persegiMerah,887,381,129,113,119,77,121,79,2,2,True,0.3117441158401939
2025-01-07 19:43:37,Merah,887,381,tensor(129.6932),tensor(113.3996),94,82,91,79,3,3,True,0.0004994869232177734
2025-01-07 19:43:37,persegiMerah,887,402,127,112,104,80,99,84,5,4,True,0.24968836168389333
2025-01-07 19:43:37,persegiMerah,890,399,126,111,16,17,13,21,3,4,False,0.4720469511359424
2025-01-07 19:43:37,Fail to pick,890,399,0,0,0,0,0,0,0,0,False,0
2025-01-07 19:43:37,persegiMerah,895,393,128,113,148,18,151,20,3,2,True,0.36479776433828126
2025-01-07 19:43:37,Fail to pick,895,393,0,0,0,0,0,0,0,0,False,0
2025-01-07 19:43:38,lingkaranHijau,368,67,101,80,137,74,137,73,0,1,True,0.11227544540444345
2025-01-07 19:43:38,lingkaranHijau,371,68,96,78,92,38,94,36,2,2,True,0.20295382818720112
2025-01-07 19:43:38,Fail to pick,371,68,0,0,0,0,0,0,0,0,False,0
2025-01-07 19:43:39,lingkaranHijau,306,70,91,73,104,58,105,58,1,0,True,0.25929825172942045
2025-01-07 19:43:39,persegiMerah,936,408,127,118,18,75,14,71,4,4,False,0.42895204231711725
2025-01-07 19:43:39,Merah,936,408,tensor(127.4672),tensor(118.5155),86,86,86,82,0,4,True,0.0004994869232177734
2025-01-07 19:43:39,persegiMerah,919,423,129,114,130,85,131,82,1,3,True,0.32160147410275397
2025-01-07 19:43:39,persegiMerah,925,412,131,117,96,63,92,63,4,0,True,0.191156571764484
2025-01-07 19:43:39,persegiMerah,921,422,131,116,147,82,144,86,3,4,True,0.35223330403756936
2025-01-07 19:43:39,persegiMerah,919,419,129,116,196,87,199,83,3,4,True,0.2796271760026512
2025-01-07 19:43:39,Fail to pick,919,419,0,0,0,0,0,0,0,0,False,0
2025-01-07 19:43:39,persegiMerah,919,415,130,116,83,96,81,94,2,2,True,0.14939120850139448
2025-01-07 19:43:39,Fail to pick,919,415,0,0,0,0,0,0,0,0,False,0
2025-01-07 19:43:39,persegiMerah,911,422,131,117,92,40,92,44,0,4,True,0.1538327542061905
2025-01-07 19:43:39,Fail to pick,911,422,0,0,0,0,0,0,0,0,False,0
2025-01-07 19:43:40,persegiMerah,920,414,131,115,184,13,183,15,1,2,True,0.36710867550333526
2025-01-07 19:43:40,Fail to pick,920,414,0,0,0,0,0,0,0,0,False,0
2025-01-07 19:43:40,persegiMerah,919,417,131,117,67,43,67,39,0,4,True,0.31507648966965074
2025-01-07 19:43:40,Fail to pick,919,417,0,0,0,0,0,0,0,0,False,0
2025-01-07 19:43:40,persegiMerah,916,413,130,116,44,64,45,67,1,3,True,0.10834941216152366
2025-01-07 19:43:40,Fail to pick,916,413,0,0,0,0,0,0,0,0,False,0
2025-01-07 19:43:40,segienamKuning,217,139,93,74,133,95,137,96,4,1,True,0.4396465756344424
2025-01-07 19:43:40,persegiMerah,906,433,136,113,75,5,77,5,2,0,False,0.10104747440769346
2025-01-07 19:43:40,Kuning,217,139,tensor(93.5549),tensor(74.6386),161,20,163,15,2,5,True,0.0
2025-01-07 19:43:40,lingkaranHijau,323,96,89,72,72,4,72,0,0,4,True,0.4070948615372024
2025-01-07 19:43:40,persegiMerah,935,407,129,118,1,83,3,78,2,5,False,0.3653564749970668
2025-01-07 19:43:40,persegiMerah,915,427,132,119,62,58,62,57,0,1,True,0.41434255088077376
2025-01-07 19:43:43,segienamKuning,123,49,99,78,98,25,99,22,1,3,True,0.3750636115638789
2025-01-07 19:43:43,persegiMerah,940,408,132,120,178,99,174,95,4,4,True,0.29648881808850747
2025-01-07 19:43:43,Kuning,123,49,tensor(99.1985),tensor(78.5946),186,11,189,6,3,5,True,0.0
2025-01-07 19:43:43,segienamKuning,83,121,96,77,146,30,148,34,2,4,True,0.33850601423977056
2025-01-07 19:43:43,persegiMerah,916,414,138,118,130,75,127,74,3,1,True,0.18092733766636906
2025-01-07 19:43:43,segienamKuning,74,124,95,76,3,12,5,15,2,3,True,0.19425100616998647
2025-01-07 19:43:43,persegiMerah,915,427,143,124,175,97,170,99,5,2,True,0.3761987860670959
2025-01-07 19:43:43,segienamKuning,67,134,92,75,93,16,91,19,2,3,True,0.29498858141102346
2025-01-07 19:43:43,persegiMerah,919,417,141,117,65,49,69,45,4,4,True,0.14707657848057765
2025-01-07 19:43:43,segienamKuning,52,135,95,77,23,19,21,19,2,0,True,0.38322698216470796
2025-01-07 19:43:43,persegiMerah,919,412,140,117,81,39,82,41,1,2,True,0.313009533778677
2025-01-07 19:43:43,segienamKuning,59,132,95,77,125,58,129,59,4,1,True,0.3115252087528516
2025-01-07 19:43:43,segienamKuning,74,128,92,79,120,16,115,19,5,3,True,0.2811700654759809
2025-01-07 19:43:44,segienamKuning,61,130,91,76,157,15,154,15,3,0,True,0.3462241674436429
2025-01-07 19:43:44,segienamKuning,58,126,98,77,21,56,20,54,1,2,True,0.155206043538202
2025-01-07 19:43:44,persegiMerah,919,415,141,120,152,94,155,94,3,0,True,0.47878063485472955
2025-01-07 19:43:44,Fail to pick,58,126,0,0,0,0,0,0,0,0,False,0
2025-01-07 19:43:44,Merah,919,415,tensor(141.4525),tensor(120.6725),84,85,83,81,1,4,True,0.0004999637603759766
2025-01-07 19:43:44,segienamKuning,17,147,34,73,7,0,10,-3,3,3,False,0.15097908149907632
2025-01-07 19:43:44,persegiMerah,907,436,147,118,27,23,27,23,0,0,False,0.3434970399878845
2025-01-07 19:43:44,persegiMerah,916,429,146,119,153,85,149,81,4,4,True,0.20632227110109258
2025-01-07 19:43:44,Fail to pick,916,429,0,0,0,0,0,0,0,0,False,0
2025-01-07 19:43:44,persegiMerah,917,420,144,117,43,74,44,74,1,0,True,0.46147694470301515
2025-01-07 19:43:44,Fail to pick,917,420,0,0,0,0,0,0,0,0,False,0
2025-01-07 19:43:44,persegiMerah,915,433,145,119,123,51,120,46,3,5,True,0.4245303719164487
2025-01-07 19:43:44,segienamKuning,35,148,71,78,160,77,155,80,5,3,True,0.28868257941815767
2025-01-07 19:43:44,persegiMerah,913,431,147,117,189,10,193,10,4,0,True,0.23030180076465726
2025-01-07 19:43:44,segienamKuning,78,136,90,75,4,38,7,36,3,2,True,0.4686830393429302
2025-01-07 19:43:44,persegiMerah,920,414,142,118,37,94,34,91,3,3,True,0.21978055181184664
2025-01-07 19:43:45,segienamKuning,79,131,94,79,194,52,198,51,4,1,True,0.2274808722579819
2025-01-07 19:43:45,persegiMerah,921,414,140,118,152,81,156,85,4,4,True,0.31578463983979976
2025-01-07 19:43:45,segienamKuning,79,131,94,79,12,15,12,13,0,2,True,0.36746205246580266
2025-01-07 19:43:45,persegiMerah,921,414,140,118,93,78,94,79,1,1,True,0.1667172176216412
2025-01-07 19:43:45,segienamKuning,61,136,96,75,32,64,32,64,0,0,True,0.34571871238707474
2025-01-07 19:43:45,persegiMerah,922,419,142,119,96,47,92,42,4,5,True,0.4474983067704562
2025-01-07 19:43:45,Kuning,61,136,tensor(96.0053),tensor(75.7243),162,5,165,0,3,5,True,0.0
2025-01-07 19:43:45,segienamKuning,44,146,87,77,65,22,62,23,3,1,True,0.3624724698865782
2025-01-07 19:43:45,persegiMerah,913,429,148,120,145,87,140,85,5,2,True,0.4832049665340864
2025-01-07 19:43:45,segienamKuning,34,146,68,76,169,4,173,7,4,3,True,0.49816485910280717
2025-01-07 19:43:45,persegiMerah,919,426,142,120,96,48,92,50,4,2,True,0.3854586426805875
2025-01-07 19:43:45,segienamKuning,69,138,97,74,9,34,9,36,0,2,True,0.2415782812534819
2025-01-07 19:43:45,persegiMerah,921,424,145,122,190,32,186,28,4,4,True,0.34173531663521106
2025-01-07 19:43:45,segienamKuning,72,132,98,80,140,97,140,94,0,3,True,0.33492461115735006
2025-01-07 19:43:45,segienamKuning,68,135,96,78,94,74,91,72,3,2,True,0.2564734871054189
2025-01-07 19:43:45,Fail to pick,68,135,0,0,0,0,0,0,0,0,False,0
2025-01-07 19:43:45,segienamKuning,65,134,96,78,173,99,168,98,5,1,True,0.22463654511886155
2025-01-07 19:43:45,persegiMerah,918,420,140,121,112,79,108,80,4,1,True,0.19928886801615775
2025-01-07 19:43:45,Fail to pick,65,134,0,0,0,0,0,0,0,0,False,0
2025-01-07 19:43:46,persegiMerah,918,420,140,120,110,65,113,69,3,4,True,0.11257005215959333
2025-01-07 19:43:46,Fail to pick,918,420,0,0,0,0,0,0,0,0,False,0
2025-01-07 19:43:46,segienamKuning,75,135,94,78,0,90,4,91,4,1,True,0.48948843586456525
2025-01-07 19:43:46,segienamKuning,63,136,94,78,195,79,199,75,4,4,True,0.27825362752602967
2025-01-07 19:43:46,persegiMerah,920,422,144,119,54,97,52,96,2,1,True,0.38637453849073944
2025-01-07 19:43:46,Merah,920,422,tensor(144.6473),tensor(119.6990),82,85,78,82,4,3,True,0.000499725341796875
2025-01-07 19:43:46,segienamKuning,73,134,98,77,92,14,87,18,5,4,True,0.3645448439899843
2025-01-07 19:43:46,persegiMerah,922,420,143,119,105,49,105,52,0,3,True,0.4430760140191272
2025-01-07 19:43:46,segienamKuning,65,136,97,78,168,1,171,0,3,1,True,0.11050984032564029
2025-01-07 19:43:46,persegiMerah,918,423,141,121,100,53,101,49,1,4,True,0.4519209448237399
2025-01-07 19:43:46,segienamKuning,80,133,94,78,142,91,139,91,3,0,True,0.4316897616054537
2025-01-07 19:43:46,segienamKuning,77,130,96,81,64,71,63,75,1,4,True,0.47323654972683094
2025-01-07 19:43:46,persegiMerah,921,417,140,118,157,40,160,43,3,3,True,0.1525511682169509
2025-01-07 19:43:46,Fail to pick,77,130,0,0,0,0,0,0,0,0,False,0
2025-01-07 19:43:46,segienamKuning,76,131,95,78,30,46,31,43,1,3,True,0.4965527160291783
2025-01-07 19:43:46,persegiMerah,922,419,137,118,1,56,5,59,4,3,False,0.26318698002224195
2025-01-07 19:43:46,segienamKuning,72,136,98,77,52,99,50,95,2,4,True,0.40859390634198534
2025-01-07 19:43:46,persegiMerah,919,426,145,119,95,65,97,61,2,4,True,0.1610460933289034
2025-01-07 19:43:47,segienamKuning,85,135,96,76,165,32,163,31,2,1,True,0.4352352470633687
2025-01-07 19:43:47,persegiMerah,925,422,142,116,49,84,49,85,0,1,True,0.4081236436119783
2025-01-07 19:43:47,segienamKuning,73,132,96,77,34,85,29,89,5,4,True,0.15617582513018125
2025-01-07 19:43:47,persegiMerah,922,418,140,119,139,39,134,36,5,3,False,0.3239342103844196
2025-01-07 19:43:47,segienamKuning,77,131,95,80,185,86,180,83,5,3,True,0.12327587579068729
2025-01-07 19:43:47,persegiMerah,922,419,138,119,194,94,191,91,3,3,True,0.2086719728479751
2025-01-07 19:43:47,Kuning,77,131,tensor(95.6236),tensor(80.4951),163,7,159,9,4,2,True,0.0
2025-01-07 19:43:47,segienamKuning,48,139,92,77,164,85,159,84,5,1,True,0.22312755561388997
2025-01-07 19:43:47,persegiMerah,906,432,146,122,137,29,133,30,4,1,True,0.34806650540071404
2025-01-07 19:43:47,persegiMerah,900,434,147,120,151,21,146,18,5,3,True,0.17968243208411105
2025-01-07 19:43:47,segienamKuning,45,137,85,75,76,41,77,45,1,4,False,0.33709942256799075
2025-01-07 19:43:47,Fail to pick,900,434,0,0,0,0,0,0,0,0,False,0
2025-01-07 19:43:47,persegiMerah,900,436,146,121,114,46,111,50,3,4,False,0.19658164280525742
2025-01-07 19:43:47,persegiMerah,900,431,147,125,20,64,17,60,3,4,True,0.42814290143894074
2025-01-07 19:43:47,segienamKuning,55,142,89,71,30,49,30,44,0,5,True,0.21451996619128663
2025-01-07 19:43:47,Fail to pick,900,431,0,0,0,0,0,0,0,0,False,0
2025-01-07 19:43:48,persegiMerah,900,434,145,120,170,18,173,21,3,3,True,0.25637962266158865
2025-01-07 19:43:48,segienamKuning,48,143,89,70,97,41,101,38,4,3,True,0.11464327788769593
2025-01-07 19:43:48,persegiMerah,895,433,153,125,79,86,75,81,4,5,False,0.46039648263496524
2025-01-07 19:43:48,persegiMerah,897,421,148,125,7,27,10,27,3,0,True,0.4502926377505928
2025-01-07 19:43:48,segienamKuning,68,162,89,77,195,1,190,-3,5,4,True,0.23841147230934567
2025-01-07 19:43:48,Kuning,68,162,tensor(89.3105),tensor(77.4862),155,6,154,7,1,1,True,0.0
2025-01-07 19:43:48,segienamKuning,61,164,87,74,170,21,173,24,3,3,True,0.3470535059625355
2025-01-07 19:43:48,Fail to pick,61,164,0,0,0,0,0,0,0,0,False,0
2025-01-07 19:43:48,persegiMerah,894,437,147,120,37,23,32,19,5,4,True,0.370426455143394
2025-01-07 19:43:54,persegiMerah,914,401,126,119,84,9,81,9,3,0,True,0.1305253417894101
2025-01-07 19:43:54,lingkaranHijau,235,33,96,66,54,46,50,47,4,1,True,0.24013087542741812
2025-01-07 19:43:54,persegiMerah,922,403,128,117,16,80,12,75,4,5,True,0.1786287564335406
2025-01-07 19:43:54,Merah,922,403,tensor(128.5326),tensor(117.0971),88,85,86,84,2,1,True,0.0
2025-01-07 19:43:55,persegiMerah,895,415,139,117,50,22,47,17,3,5,False,0.4201544882086964
2025-01-07 19:43:55,persegiMerah,919,401,130,114,114,5,110,0,4,5,True,0.41970036271350497
2025-01-07 19:43:55,lingkaranHijau,216,36,99,73,174,90,171,91,3,1,False,0.20055717366072173
2025-01-07 19:43:55,persegiMerah,891,433,134,116,82,22,82,25,0,3,True,0.15671593661140612
2025-01-07 19:43:55,persegiMerah,919,402,129,115,186,4,184,7,2,3,True,0.3423000207193636
2025-01-07 19:43:55,persegiMerah,904,408,135,112,142,81,137,82,5,1,True,0.41731360352102465
2025-01-07 19:43:55,persegiMerah,914,417,132,114,191,62,190,57,1,5,True,0.35666808192266575
2025-01-07 19:43:55,persegiMerah,922,417,138,115,41,61,40,61,1,0,True,0.42937315305701584
2025-01-07 19:43:55,Fail to pick,922,417,0,0,0,0,0,0,0,0,False,0
2025-01-07 19:44:00,persegiBiru,893,404,115,110,67,73,65,69,2,4,True,0.10885943462695745
2025-01-07 19:44:47,persegiMerah,778,260,127,123,105,72,103,67,2,5,True,0.14379382749409486
2025-01-07 19:44:47,Merah,778,260,tensor(127.9438),tensor(123.8340),127,72,129,67,2,5,True,0.0
2025-01-07 19:44:47,persegiMerah,778,260,127,123,123,49,118,46,5,3,False,0.355785110115051
2025-01-07 19:44:47,Fail to pick,778,260,0,0,0,0,0,0,0,0,False,0
2025-01-07 19:44:48,persegiMerah,747,263,130,120,153,99,154,95,1,4,True,0.3580623687414791
2025-01-07 19:44:48,persegiMerah,755,267,132,119,5,7,4,10,1,3,True,0.4045592107142064
2025-01-07 19:44:48,Fail to pick,755,267,0,0,0,0,0,0,0,0,False,0
2025-01-07 19:44:48,persegiMerah,737,267,138,123,110,97,105,98,5,1,True,0.4431969679449874
2025-01-07 19:44:48,persegiMerah,734,256,128,118,134,54,134,54,0,0,True,0.10392060146788595
2025-01-07 19:44:48,persegiMerah,734,256,128,118,103,64,104,59,1,5,True,0.44206949921032945
2025-01-07 19:44:48,Fail to pick,734,256,0,0,0,0,0,0,0,0,False,0
2025-01-07 19:44:48,persegiMerah,740,265,137,122,93,63,94,60,1,3,True,0.1016715078159471
2025-01-07 19:44:48,Fail to pick,740,265,0,0,0,0,0,0,0,0,False,0
2025-01-07 19:44:48,persegiMerah,740,256,129,124,119,71,116,75,3,4,True,0.3145236549246395
2025-01-07 19:44:48,Fail to pick,740,256,0,0,0,0,0,0,0,0,False,0
2025-01-07 19:44:48,persegiMerah,764,269,130,121,180,78,180,73,0,5,True,0.3004909436308679
2025-01-07 19:44:49,persegiMerah,759,256,130,121,197,12,193,9,4,3,True,0.28038296631085524
2025-01-07 19:44:49,persegiMerah,778,246,125,124,198,50,200,45,2,5,True,0.17851732340664564
2025-01-07 19:44:49,persegiMerah,759,262,132,116,176,52,172,49,4,3,True,0.345896698175308
2025-01-07 19:44:49,persegiMerah,773,252,124,118,6,76,6,77,0,1,True,0.4468436423819816
2025-01-07 19:44:49,persegiMerah,745,268,135,124,117,35,118,36,1,1,True,0.2636720825071386
2025-01-07 19:44:49,persegiMerah,761,259,131,120,43,44,43,47,0,3,True,0.2031810121363954
2025-01-07 19:44:49,persegiMerah,754,256,129,117,169,24,167,25,2,1,True,0.30384810709017807
2025-01-07 19:44:49,Fail to pick,754,256,0,0,0,0,0,0,0,0,False,0
2025-01-07 19:44:50,persegiMerah,751,265,135,118,69,40,70,36,1,4,True,0.3432330508991315
2025-01-07 19:44:50,Fail to pick,751,265,0,0,0,0,0,0,0,0,False,0
2025-01-07 19:44:50,persegiMerah,740,269,138,117,105,71,103,75,2,4,True,0.2558494898256115
2025-01-07 19:44:50,persegiMerah,758,265,136,118,37,21,32,20,5,1,True,0.1823411246385963
2025-01-07 19:44:50,persegiMerah,748,264,132,118,58,88,54,91,4,3,True,0.35431306889750347
2025-01-07 19:44:50,persegiMerah,751,258,129,116,142,63,141,61,1,2,False,0.16441296995380608
2025-01-07 19:44:50,Fail to pick,751,258,0,0,0,0,0,0,0,0,False,0
2025-01-07 19:44:50,persegiMerah,748,265,142,120,52,44,47,42,5,2,True,0.16158203050771844
2025-01-07 19:44:50,Fail to pick,748,265,0,0,0,0,0,0,0,0,False,0
2025-01-07 19:44:50,persegiMerah,743,265,146,121,46,11,47,13,1,2,True,0.16232551876387175
2025-01-07 19:44:50,Fail to pick,743,265,0,0,0,0,0,0,0,0,False,0
2025-01-07 19:44:51,persegiMerah,763,252,138,120,152,12,148,11,4,1,True,0.20169238663138636
2025-01-07 19:44:51,persegiMerah,733,267,158,122,71,19,73,21,2,2,True,0.33450809954326327
2025-01-07 19:44:51,persegiMerah,761,250,135,120,116,8,115,4,1,4,True,0.11967354183766066
2025-01-07 19:44:52,persegiMerah,741,265,144,121,40,37,39,39,1,2,True,0.48799614159254345
2025-01-07 19:44:52,persegiMerah,741,265,144,122,180,12,176,11,4,1,True,0.1524992014716564
2025-01-07 19:44:52,Fail to pick,741,265,0,0,0,0,0,0,0,0,False,0
2025-01-07 19:44:52,persegiMerah,751,258,145,117,124,13,121,11,3,2,True,0.26125936441054365
2025-01-07 19:44:52,persegiMerah,748,264,136,119,105,84,106,83,1,1,True,0.13834274986834594
2025-01-07 19:44:52,Fail to pick,748,264,0,0,0,0,0,0,0,0,False,0
2025-01-07 19:44:53,persegiMerah,747,269,128,118,154,43,152,44,2,1,True,0.1346938775293726
2025-01-07 19:44:53,Fail to pick,747,269,0,0,0,0,0,0,0,0,False,0
2025-01-07 19:44:53,persegiMerah,752,265,145,121,89,23,84,20,5,3,True,0.34629363497861987
2025-01-07 19:44:53,Fail to pick,752,265,0,0,0,0,0,0,0,0,False,0
2025-01-07 19:44:53,persegiMerah,740,267,140,119,69,33,69,28,0,5,True,0.2830311977766624
2025-01-07 19:44:53,persegiMerah,762,263,141,123,124,48,119,47,5,1,True,0.18242295078332488
2025-01-07 19:44:53,persegiMerah,744,258,153,121,78,40,80,44,2,4,True,0.10529833352109637
2025-01-07 19:44:53,persegiMerah,754,261,126,112,17,60,20,59,3,1,True,0.4320892913746103
2025-01-07 19:44:53,persegiMerah,768,250,132,114,20,23,22,18,2,5,True,0.32306274847032435
2025-01-07 19:44:53,persegiMerah,749,256,135,119,8,18,10,13,2,5,True,0.26539856877293855
2025-01-07 19:44:54,persegiMerah,735,263,140,120,153,50,157,46,4,4,True,0.32698284423929636
2025-01-07 19:44:54,persegiMerah,742,269,136,117,6,38,3,42,3,4,True,0.3479098033439333
2025-01-07 19:44:54,Fail to pick,742,269,0,0,0,0,0,0,0,0,False,0
2025-01-07 19:44:54,persegiMerah,744,261,133,114,91,92,94,92,3,0,True,0.4555301867719883
2025-01-07 19:44:54,Fail to pick,744,261,0,0,0,0,0,0,0,0,False,0
2025-01-07 19:44:54,persegiMerah,749,244,134,122,152,65,151,68,1,3,True,0.35863878760556966
2025-01-07 19:44:54,persegiMerah,749,244,134,122,194,33,195,29,1,4,True,0.3435766788256267
2025-01-07 19:44:54,Fail to pick,749,244,0,0,0,0,0,0,0,0,False,0
2025-01-07 19:44:54,persegiMerah,742,255,140,115,40,33,35,29,5,4,True,0.35948755733107585
2025-01-07 19:44:54,persegiMerah,734,254,129,117,63,96,63,91,0,5,True,0.12419702436546456
2025-01-07 19:44:54,Fail to pick,734,254,0,0,0,0,0,0,0,0,False,0
2025-01-07 19:44:54,persegiMerah,738,263,142,116,114,67,109,71,5,4,True,0.20336174896234974
2025-01-07 19:44:54,Fail to pick,738,263,0,0,0,0,0,0,0,0,False,0
2025-01-07 19:44:55,persegiMerah,754,256,135,115,143,92,141,88,2,4,True,0.3320740047548599
2025-01-07 19:44:55,persegiMerah,759,262,132,115,78,93,77,92,1,1,True,0.3011194266275429
2025-01-07 19:44:55,Fail to pick,759,262,0,0,0,0,0,0,0,0,False,0
2025-01-07 19:44:55,persegiMerah,743,270,142,123,7,50,8,54,1,4,True,0.1933823108415724
2025-01-07 19:44:55,persegiMerah,763,251,131,115,72,6,75,9,3,3,True,0.10057421400262206
2025-01-07 19:44:55,persegiMerah,743,262,141,121,187,0,182,3,5,3,True,0.1685401660912899
2025-01-07 19:44:55,persegiMerah,753,273,144,118,35,86,39,82,4,4,True,0.29244328328403946
2025-01-07 19:44:56,persegiMerah,770,259,136,120,89,0,91,-4,2,4,True,0.20495634065240642
2025-01-07 19:44:57,persegiMerah,767,264,146,114,187,25,186,27,1,2,True,0.19197021153681837
2025-01-07 19:44:57,Fail to pick,767,264,0,0,0,0,0,0,0,0,False,0
2025-01-07 19:44:57,persegiMerah,757,260,148,117,103,48,98,45,5,3,True,0.19305779049346894
2025-01-07 19:45:05,persegiMerah,763,268,142,120,107,68,111,67,4,1,True,0.21741900993125457
2025-01-07 19:45:05,Fail to pick,763,268,0,0,0,0,0,0,0,0,False,0
2025-01-07 19:45:05,persegiMerah,758,267,141,126,37,10,34,8,3,2,False,0.34978035157256643
2025-01-07 19:45:05,Fail to pick,758,267,0,0,0,0,0,0,0,0,False,0
2025-01-07 19:45:07,persegiMerah,755,268,136,115,42,75,46,71,4,4,True,0.16077488758955139
2025-01-07 19:45:07,Fail to pick,755,268,0,0,0,0,0,0,0,0,False,0
2025-01-07 19:45:07,persegiMerah,754,272,138,118,184,28,182,24,2,4,True,0.19548186659012728
2025-01-07 19:45:07,Fail to pick,754,272,0,0,0,0,0,0,0,0,False,0
2025-01-07 19:45:08,persegiMerah,753,265,140,117,78,47,75,46,3,1,True,0.23567517657523954
2025-01-07 19:45:08,Fail to pick,753,265,0,0,0,0,0,0,0,0,False,0
2025-01-07 19:45:08,persegiMerah,756,268,145,119,102,13,103,15,1,2,True,0.2840652967651725
2025-01-07 19:45:08,Fail to pick,756,268,0,0,0,0,0,0,0,0,False,0
2025-01-07 19:45:14,persegiBiru,746,275,132,120,66,95,66,92,0,3,True,0.22586586364453926
2025-01-07 19:45:14,persegiBiru,736,276,137,119,145,4,143,0,2,4,True,0.20206796640256075
2025-01-07 19:45:14,persegiBiru,756,276,123,123,118,74,116,76,2,2,True,0.17135703989994036
2025-01-07 19:45:15,persegiBiru,757,253,120,115,140,15,135,16,5,1,True,0.11769674455354107
2025-01-07 19:45:15,persegiBiru,745,272,128,119,110,39,107,43,3,4,False,0.11867089008125903
2025-01-07 19:45:15,persegiBiru,751,270,119,115,42,39,40,34,2,5,True,0.4145591882397325
2025-01-07 19:45:15,Fail to pick,751,270,0,0,0,0,0,0,0,0,False,0
2025-01-07 19:45:16,persegiBiru,746,277,123,116,162,99,161,103,1,4,True,0.26973265156948784
2025-01-07 19:45:16,Fail to pick,746,277,0,0,0,0,0,0,0,0,False,0
2025-01-07 19:45:16,persegiBiru,740,264,119,119,19,27,18,24,1,3,True,0.2437737989481179
2025-01-07 19:45:17,persegiBiru,737,265,118,116,59,2,58,6,1,4,True,0.13852147653198665
2025-01-07 19:45:17,Fail to pick,737,265,0,0,0,0,0,0,0,0,False,0
2025-01-07 19:45:17,persegiBiru,747,274,128,110,185,24,184,20,1,4,True,0.183093021069198
2025-01-07 19:45:17,persegiBiru,746,269,124,113,112,47,108,46,4,1,True,0.4193114054553404
2025-01-07 19:45:17,Fail to pick,746,269,0,0,0,0,0,0,0,0,False,0
2025-01-07 19:45:17,persegiBiru,744,272,126,112,21,27,19,31,2,4,True,0.42505506821600414
2025-01-07 19:45:17,Fail to pick,744,272,0,0,0,0,0,0,0,0,False,0
2025-01-07 19:45:17,persegiBiru,745,271,126,113,48,83,45,80,3,3,True,0.13451637058272575
2025-01-07 19:45:17,Fail to pick,745,271,0,0,0,0,0,0,0,0,False,0
2025-01-07 19:45:17,persegiBiru,744,272,127,111,139,55,135,52,4,3,True,0.2521936085381496
2025-01-07 19:45:17,Fail to pick,744,272,0,0,0,0,0,0,0,0,False,0
2025-01-07 19:45:18,persegiBiru,742,271,125,113,156,87,157,84,1,3,True,0.37577811537253536
2025-01-07 19:45:18,Fail to pick,742,271,0,0,0,0,0,0,0,0,False,0
2025-01-07 19:45:18,persegiBiru,756,265,118,107,172,64,174,62,2,2,True,0.27902179911973357
2025-01-07 19:45:18,persegiBiru,758,278,120,107,68,67,70,63,2,4,True,0.3280211786772408
2025-01-07 19:45:18,persegiBiru,749,280,125,106,1,30,2,30,1,0,True,0.38994966314562307
2025-01-07 19:45:18,Fail to pick,749,280,0,0,0,0,0,0,0,0,False,0
2025-01-07 19:45:18,persegiBiru,764,275,128,106,167,45,170,44,3,1,True,0.1888577172243799
2025-01-07 19:45:18,persegiBiru,752,287,119,104,126,59,124,56,2,3,True,0.11360273181074386
2025-01-07 19:45:18,persegiBiru,748,268,117,110,38,91,37,91,1,0,True,0.2097207183489497
2025-01-07 19:45:18,persegiBiru,768,271,113,107,73,48,72,43,1,5,True,0.1748865390762096
2025-01-07 19:45:19,persegiBiru,765,275,117,105,56,36,52,40,4,4,True,0.3391525145540626
2025-01-07 19:45:19,Fail to pick,765,275,0,0,0,0,0,0,0,0,False,0
2025-01-07 19:45:19,persegiBiru,735,272,122,105,47,51,48,54,1,3,True,0.18937667129917127
2025-01-07 19:45:19,persegiBiru,747,283,123,105,15,38,15,35,0,3,True,0.46700620413426686
2025-01-07 19:45:19,persegiBiru,744,266,122,103,129,38,130,42,1,4,True,0.3888491681162086
2025-01-07 19:45:19,persegiBiru,763,274,119,105,194,29,190,26,4,3,True,0.47314439797543273
2025-01-07 19:45:19,persegiBiru,751,280,122,103,162,18,158,22,4,4,False,0.4511972348638139
2025-01-07 19:45:19,persegiBiru,748,283,122,101,29,49,26,45,3,4,True,0.3406897779107925
2025-01-07 19:45:19,Fail to pick,748,283,0,0,0,0,0,0,0,0,False,0
2025-01-07 19:45:19,persegiBiru,750,283,120,99,94,27,98,24,4,3,True,0.2166382789666832
2025-01-07 19:45:19,Fail to pick,750,283,0,0,0,0,0,0,0,0,False,0
2025-01-07 19:45:19,persegiBiru,736,269,122,104,13,41,16,36,3,5,True,0.4565656403223203
2025-01-07 19:45:19,persegiBiru,764,274,122,115,93,60,89,64,4,4,True,0.1182948671554399
2025-01-07 19:45:20,persegiBiru,754,261,119,102,98,63,100,64,2,1,True,0.11715812643838622
2025-01-07 19:45:20,persegiBiru,762,279,114,98,66,31,63,35,3,4,True,0.18166183415949583
2025-01-07 19:45:20,persegiBiru,739,264,116,104,148,3,143,3,5,0,True,0.1949300343827805
2025-01-07 19:45:20,persegiBiru,754,277,118,106,124,74,124,77,0,3,True,0.4306253900926108
2025-01-07 19:45:20,persegiBiru,747,260,116,97,2,45,2,41,0,4,True,0.3616255906862189
2025-01-07 19:45:20,persegiBiru,736,267,121,100,70,93,69,88,1,5,True,0.1672392876217748
2025-01-07 19:45:20,persegiBiru,746,288,120,94,131,23,132,25,1,2,True,0.47900900187297657
2025-01-07 19:45:20,persegiBiru,755,281,114,96,117,37,114,34,3,3,True,0.20508850163598727
2025-01-07 19:45:20,Fail to pick,755,281,0,0,0,0,0,0,0,0,False,0
2025-01-07 19:45:20,persegiBiru,749,282,120,97,199,13,199,10,0,3,True,0.1215805502189606
2025-01-07 19:45:20,Fail to pick,749,282,0,0,0,0,0,0,0,0,False,0
2025-01-07 19:45:21,persegiBiru,748,280,120,95,132,51,133,53,1,2,True,0.25279818152187805
2025-01-07 19:45:21,Fail to pick,748,280,0,0,0,0,0,0,0,0,False,0
2025-01-07 19:45:21,persegiBiru,748,284,116,95,50,80,49,82,1,2,True,0.29677376790467763
2025-01-07 19:45:21,Fail to pick,748,284,0,0,0,0,0,0,0,0,False,0
2025-01-07 19:45:21,persegiBiru,742,286,122,95,87,66,83,62,4,4,True,0.4088941191743717
2025-01-07 19:45:21,Fail to pick,742,286,0,0,0,0,0,0,0,0,False,0
2025-01-07 19:45:21,persegiBiru,728,270,117,102,126,28,127,23,1,5,True,0.3264183735091729
2025-01-07 19:45:21,persegiBiru,725,273,117,97,137,33,138,36,1,3,True,0.19924665222919222
2025-01-07 19:45:21,Fail to pick,725,273,0,0,0,0,0,0,0,0,False,0
2025-01-07 19:45:21,persegiBiru,731,271,119,101,29,2,26,0,3,2,True,0.1975364031219031
2025-01-07 19:45:21,Fail to pick,731,271,0,0,0,0,0,0,0,0,False,0
2025-01-07 19:45:21,persegiBiru,724,271,122,102,45,25,47,20,2,5,True,0.27940668744106445
2025-01-07 19:45:21,Fail to pick,724,271,0,0,0,0,0,0,0,0,False,0
2025-01-07 19:45:22,persegiBiru,746,289,126,94,129,92,129,93,0,1,True,0.3022084109008818
2025-01-07 19:45:22,persegiBiru,749,290,122,94,61,37,63,39,2,2,True,0.32315995731327585
2025-01-07 19:45:22,Fail to pick,749,290,0,0,0,0,0,0,0,0,False,0
2025-01-07 19:45:22,persegiBiru,747,287,120,97,179,61,176,64,3,3,True,0.49994298438099316
2025-01-07 19:45:22,Fail to pick,747,287,0,0,0,0,0,0,0,0,False,0
2025-01-07 19:45:22,persegiBiru,747,285,117,97,35,69,34,70,1,1,True,0.3556977879491028
2025-01-07 19:45:22,Fail to pick,747,285,0,0,0,0,0,0,0,0,False,0
2025-01-07 19:45:22,persegiBiru,742,286,122,97,81,44,83,42,2,2,True,0.2977319328746902
2025-01-07 19:45:22,Fail to pick,742,286,0,0,0,0,0,0,0,0,False,0
2025-01-07 19:45:22,persegiBiru,742,288,122,94,181,72,185,73,4,1,True,0.2844397124643222
2025-01-07 19:45:22,Fail to pick,742,288,0,0,0,0,0,0,0,0,False,0
2025-01-07 19:45:22,persegiBiru,742,289,122,96,79,28,82,24,3,4,True,0.48830947587952933
2025-01-07 19:45:23,Fail to pick,742,289,0,0,0,0,0,0,0,0,False,0
2025-01-07 19:45:23,persegiBiru,733,264,118,100,17,81,12,78,5,3,True,0.3094966045360038
2025-01-07 19:45:23,persegiBiru,730,268,122,102,145,86,148,88,3,2,False,0.1276688840206137
2025-01-07 19:45:23,Fail to pick,730,268,0,0,0,0,0,0,0,0,False,0
2025-01-07 19:45:23,persegiBiru,754,283,119,96,122,55,126,52,4,3,True,0.3825757216790958
2025-01-07 19:45:23,persegiBiru,755,281,120,96,61,2,62,2,1,0,False,0.2757078587663396
2025-01-07 19:45:23,Fail to pick,755,281,0,0,0,0,0,0,0,0,False,0
2025-01-07 19:45:24,persegiBiru,742,286,123,94,95,95,90,94,5,1,True,0.17701896291984343
2025-01-07 19:45:24,persegiBiru,739,288,121,93,4,60,0,61,4,1,True,0.4609645120986522
2025-01-07 19:45:24,Fail to pick,739,288,0,0,0,0,0,0,0,0,False,0
2025-01-07 19:45:24,persegiBiru,729,269,118,99,9,67,11,68,2,1,True,0.17183348658185138
2025-01-07 19:45:24,persegiBiru,745,287,119,95,12,96,9,99,3,3,True,0.48929015901772244
2025-01-07 19:45:24,persegiBiru,743,286,119,95,88,7,92,6,4,1,True,0.13575058375807303
2025-01-07 19:45:24,Fail to pick,743,286,0,0,0,0,0,0,0,0,False,0
2025-01-07 19:45:24,persegiBiru,751,286,116,95,5,96,5,98,0,2,True,0.4486594965674583
2025-01-07 19:45:24,Fail to pick,751,286,0,0,0,0,0,0,0,0,False,0
2025-01-07 19:45:24,persegiBiru,751,283,114,97,47,3,48,3,1,0,True,0.3282189318088145
2025-01-07 19:45:24,Fail to pick,751,283,0,0,0,0,0,0,0,0,False,0
2025-01-07 19:45:24,persegiBiru,748,279,123,95,0,77,-1,74,1,3,True,0.38267785663207043
2025-01-07 19:45:24,Fail to pick,748,279,0,0,0,0,0,0,0,0,False,0
2025-01-07 19:45:24,persegiBiru,743,286,116,93,109,86,111,82,2,4,True,0.3065529595138102
2025-01-07 19:45:24,Fail to pick,743,286,0,0,0,0,0,0,0,0,False,0
2025-01-07 19:45:25,persegiBiru,723,272,122,102,64,44,66,46,2,2,True,0.2882794063020052
2025-01-07 19:45:25,persegiBiru,744,289,122,94,3,53,-1,50,4,3,True,0.37297079084575635
2025-01-07 19:45:25,persegiBiru,748,287,114,93,17,80,14,78,3,2,True,0.13612230188046254
2025-01-07 19:45:25,Fail to pick,748,287,0,0,0,0,0,0,0,0,False,0
2025-01-07 19:45:25,persegiBiru,744,285,124,96,28,50,26,51,2,1,False,0.13537517280853617
2025-01-07 19:45:25,Fail to pick,744,285,0,0,0,0,0,0,0,0,False,0
2025-01-07 19:45:25,persegiBiru,751,286,123,95,12,24,12,27,0,3,True,0.1664774764336746
2025-01-07 19:45:25,Fail to pick,751,286,0,0,0,0,0,0,0,0,False,0
2025-01-07 19:45:25,persegiBiru,743,288,123,95,29,76,26,78,3,2,True,0.18219908765464218
2025-01-07 19:45:25,Fail to pick,743,288,0,0,0,0,0,0,0,0,False,0
2025-01-07 19:45:25,persegiBiru,754,279,121,96,51,94,47,96,4,2,True,0.31500948890089375
2025-01-07 19:45:25,persegiBiru,754,279,122,96,44,87,47,89,3,2,True,0.28404727293742493
2025-01-07 19:45:25,Fail to pick,754,279,0,0,0,0,0,0,0,0,False,0
2025-01-07 19:45:25,persegiBiru,730,273,121,102,118,3,122,2,4,1,True,0.48023223977513985
2025-01-07 19:45:25,persegiBiru,742,288,121,94,194,50,196,54,2,4,True,0.4530891842943018
2025-01-07 19:45:26,persegiBiru,736,265,125,100,102,80,106,75,4,5,True,0.4146213180926367
2025-01-07 19:45:26,persegiBiru,752,286,117,93,34,77,33,76,1,1,False,0.23401354951723286
2025-01-07 19:45:26,persegiBiru,739,284,115,96,15,75,12,77,3,2,True,0.47308005888111226
2025-01-07 19:45:26,persegiBiru,719,265,121,100,125,32,120,29,5,3,True,0.10485358538558126
2025-01-07 19:45:26,persegiBiru,744,286,119,93,128,40,132,44,4,4,False,0.4550934892656934
2025-01-07 19:45:26,persegiBiru,747,289,116,91,11,64,9,60,2,4,True,0.10799106153746259
2025-01-07 19:45:26,Fail to pick,747,289,0,0,0,0,0,0,0,0,False,0
2025-01-07 19:45:26,persegiBiru,744,283,120,95,41,43,41,39,0,4,True,0.3690364984129578
2025-01-07 19:45:26,Fail to pick,744,283,0,0,0,0,0,0,0,0,False,0
2025-01-07 19:45:26,persegiBiru,747,290,119,93,17,1,15,-2,2,3,True,0.26765944550698967
2025-01-07 19:45:26,Fail to pick,747,290,0,0,0,0,0,0,0,0,False,0
2025-01-07 19:45:26,persegiBiru,744,285,114,95,1,68,-1,67,2,1,False,0.20572368153852363
2025-01-07 19:45:26,Fail to pick,744,285,0,0,0,0,0,0,0,0,False,0
2025-01-07 19:45:27,persegiBiru,753,284,117,98,179,75,183,72,4,3,True,0.43804145315281084
2025-01-07 19:45:27,Fail to pick,753,284,0,0,0,0,0,0,0,0,False,0
2025-01-07 19:45:27,persegiBiru,730,270,122,101,184,74,182,78,2,4,True,0.2761811044909908
2025-01-07 19:45:27,persegiBiru,733,264,119,99,100,2,98,1,2,1,True,0.44448143235372695
2025-01-07 19:45:27,Fail to pick,733,264,0,0,0,0,0,0,0,0,False,0
2025-01-07 19:45:27,persegiBiru,744,287,121,92,32,81,32,76,0,5,True,0.4827513319326163
2025-01-07 19:45:27,persegiBiru,743,288,124,95,18,17,15,17,3,0,True,0.4080514239707974
2025-01-07 19:45:27,Fail to pick,743,288,0,0,0,0,0,0,0,0,False,0
2025-01-07 19:45:27,persegiBiru,749,286,122,96,151,68,150,65,1,3,True,0.3064591885024749
2025-01-07 19:45:27,Fail to pick,749,286,0,0,0,0,0,0,0,0,False,0
2025-01-07 19:45:27,persegiBiru,746,288,124,94,13,97,15,97,2,0,True,0.21618225511654796
2025-01-07 19:45:27,Fail to pick,746,288,0,0,0,0,0,0,0,0,False,0
2025-01-07 19:45:27,persegiBiru,749,288,117,95,9,53,13,57,4,4,True,0.2243962556843665
2025-01-07 19:45:27,Fail to pick,749,288,0,0,0,0,0,0,0,0,False,0
2025-01-07 19:45:27,persegiBiru,757,282,116,95,161,75,161,79,0,4,False,0.2852313493883341
2025-01-07 19:45:27,Fail to pick,757,282,0,0,0,0,0,0,0,0,False,0
2025-01-07 19:45:27,persegiBiru,731,270,122,100,52,92,49,88,3,4,True,0.20027132520049432
2025-01-07 19:45:28,persegiBiru,744,287,118,96,51,50,50,45,1,5,False,0.3506114741815751
2025-01-07 19:45:28,persegiBiru,746,285,117,94,121,51,121,46,0,5,True,0.35782224449166555
2025-01-07 19:45:28,Fail to pick,746,285,0,0,0,0,0,0,0,0,False,0
2025-01-07 19:45:28,persegiBiru,741,285,122,97,162,29,161,28,1,1,True,0.13642025857584641
2025-01-07 19:45:28,Fail to pick,741,285,0,0,0,0,0,0,0,0,False,0
2025-01-07 19:45:28,persegiBiru,738,287,116,95,148,43,145,41,3,2,True,0.12983048231326488
2025-01-07 19:45:28,Fail to pick,738,287,0,0,0,0,0,0,0,0,False,0
2025-01-07 19:45:28,persegiBiru,733,265,124,98,37,8,32,12,5,4,True,0.3084051923304695
2025-01-07 19:45:28,persegiBiru,757,282,119,95,53,85,50,88,3,3,True,0.4340942519512857
2025-01-07 19:45:28,persegiBiru,757,279,121,97,129,77,130,78,1,1,True,0.322839390466146
2025-01-07 19:45:28,Fail to pick,757,279,0,0,0,0,0,0,0,0,False,0
2025-01-07 19:45:28,persegiBiru,745,286,118,94,151,73,148,73,3,0,True,0.39278144191542674
2025-01-07 19:45:28,persegiBiru,731,265,119,99,80,50,79,45,1,5,True,0.38866775204470716
2025-01-07 19:45:28,persegiBiru,729,265,119,101,1,60,1,61,0,1,True,0.2698895374843985
2025-01-07 19:45:28,Fail to pick,729,265,0,0,0,0,0,0,0,0,False,0
2025-01-07 19:45:29,persegiBiru,731,271,121,102,105,29,106,33,1,4,True,0.4254180240242804
2025-01-07 19:45:29,Fail to pick,731,271,0,0,0,0,0,0,0,0,False,0
2025-01-07 19:45:29,persegiBiru,728,267,118,99,165,90,165,93,0,3,False,0.359273166927248
2025-01-07 19:45:29,Fail to pick,728,267,0,0,0,0,0,0,0,0,False,0
2025-01-07 19:45:29,persegiBiru,751,284,121,95,114,86,116,88,2,2,False,0.17101897715495257
2025-01-07 19:45:29,persegiBiru,733,270,123,100,79,79,82,80,3,1,True,0.35372534934992095
2025-01-07 19:45:29,persegiBiru,747,284,119,96,78,37,79,33,1,4,True,0.3135033978263411
2025-01-07 19:45:29,persegiBiru,753,279,117,96,35,38,39,39,4,1,True,0.37750322927375923
2025-01-07 19:45:29,Fail to pick,753,279,0,0,0,0,0,0,0,0,False,0
2025-01-07 19:45:29,persegiBiru,740,264,122,100,150,64,145,66,5,2,True,0.4744430700040271
2025-01-07 19:45:29,persegiBiru,743,289,120,96,17,67,16,62,1,5,True,0.32538265897081375
2025-01-07 19:45:29,persegiBiru,736,265,121,100,54,35,58,36,4,1,True,0.16340523608364257
2025-01-07 19:45:30,persegiBiru,726,269,121,101,18,24,22,25,4,1,True,0.1587569689425589
2025-01-07 19:45:30,persegiBiru,738,265,122,100,117,73,114,74,3,1,True,0.1029213970463903
2025-01-07 19:45:30,persegiBiru,752,279,122,98,162,68,158,71,4,3,True,0.30139068963244053
2025-01-07 19:45:30,persegiBiru,728,273,122,102,185,25,184,27,1,2,True,0.2513869953745067
2025-01-07 19:45:30,persegiBiru,745,288,123,94,179,93,181,93,2,0,True,0.29977045769771715
2025-01-07 19:45:30,persegiBiru,734,265,127,99,99,67,96,62,3,5,True,0.2972396744327147
2025-01-07 19:45:30,persegiBiru,753,259,114,100,102,4,102,7,0,3,True,0.16152123771295607
2025-01-07 19:45:30,persegiBiru,757,284,116,97,98,16,94,12,4,4,True,0.14250606829597132
2025-01-07 19:45:30,persegiBiru,743,289,119,94,182,62,182,65,0,3,True,0.3296884090826625
2025-01-07 19:45:30,persegiBiru,727,267,122,100,89,91,84,86,5,5,True,0.4740862286643682
2025-01-07 19:45:31,persegiBiru,727,265,119,101,154,65,152,61,2,4,True,0.20368250486112968
2025-01-07 19:45:31,Fail to pick,727,265,0,0,0,0,0,0,0,0,False,0
2025-01-07 19:45:31,persegiBiru,746,288,122,93,101,88,100,90,1,2,True,0.10162365916270538
2025-01-07 19:45:31,persegiBiru,730,268,120,100,44,27,43,24,1,3,True,0.20034812384177472
2025-01-07 19:45:31,persegiBiru,754,282,116,95,3,8,6,9,3,1,True,0.32393196837105753
2025-01-07 19:45:31,persegiBiru,728,268,120,101,43,45,43,43,0,2,True,0.14927554654136618
2025-01-07 19:45:31,persegiBiru,731,268,120,99,29,40,29,42,0,2,False,0.4649616795563877
2025-01-07 19:45:31,Fail to pick,731,268,0,0,0,0,0,0,0,0,False,0
2025-01-07 19:45:31,persegiBiru,741,290,118,95,23,80,21,77,2,3,True,0.13485480644789571
2025-01-07 19:45:31,persegiBiru,755,279,117,96,95,37,94,32,1,5,True,0.1897176742557113
2025-01-07 19:45:31,persegiBiru,745,288,115,94,28,33,24,33,4,0,True,0.4641007011770184
2025-01-07 19:45:32,persegiBiru,747,283,112,95,29,10,29,11,0,1,True,0.22607545597227274
2025-01-07 19:45:32,Fail to pick,747,283,0,0,0,0,0,0,0,0,False,0
2025-01-07 19:45:32,persegiBiru,751,282,119,98,71,32,69,34,2,2,True,0.2700921128388579
2025-01-07 19:45:32,Fail to pick,751,282,0,0,0,0,0,0,0,0,False,0
2025-01-07 19:45:32,persegiBiru,729,266,121,99,25,25,29,24,4,1,True,0.36809617959987573
2025-01-07 19:45:32,persegiBiru,748,286,119,95,191,58,194,61,3,3,False,0.3830591154922972
2025-01-07 19:45:32,persegiBiru,731,270,122,102,195,4,194,1,1,3,True,0.4907324978425437
2025-01-07 19:45:32,persegiBiru,744,287,122,95,129,94,133,91,4,3,True,0.36090105352350144
2025-01-07 19:45:32,persegiBiru,726,271,119,103,150,38,150,34,0,4,True,0.2827126231803254
2025-01-07 19:45:32,persegiBiru,726,271,119,102,154,30,153,29,1,1,True,0.10952453939042561
2025-01-07 19:45:32,Fail to pick,726,271,0,0,0,0,0,0,0,0,False,0
2025-01-07 19:45:32,persegiBiru,728,267,123,101,118,28,113,31,5,3,True,0.4799751385928678
2025-01-07 19:45:32,Fail to pick,728,267,0,0,0,0,0,0,0,0,False,0
2025-01-07 19:45:32,persegiBiru,735,284,121,97,119,77,121,76,2,1,True,0.3512244883380793
2025-01-07 19:45:33,persegiBiru,744,288,123,94,43,57,40,54,3,3,True,0.218598358637914
2025-01-07 19:45:33,Fail to pick,744,288,0,0,0,0,0,0,0,0,False,0
2025-01-07 19:45:33,persegiBiru,744,288,124,95,163,65,163,68,0,3,True,0.3503110500955646
2025-01-07 19:45:33,Fail to pick,744,288,0,0,0,0,0,0,0,0,False,0
2025-01-07 19:45:33,persegiBiru,727,271,121,103,7,21,2,20,5,1,True,0.1681325841703848
2025-01-07 19:45:33,persegiBiru,727,272,120,102,142,22,137,21,5,1,True,0.39565085184328097
2025-01-07 19:45:33,Fail to pick,727,272,0,0,0,0,0,0,0,0,False,0
2025-01-07 19:45:33,persegiBiru,730,272,122,101,47,59,51,57,4,2,True,0.224737492398631
2025-01-07 19:45:33,Fail to pick,730,272,0,0,0,0,0,0,0,0,False,0
2025-01-07 19:45:34,persegiBiru,850,340,127,98,44,47,42,44,2,3,True,0.3057730058652689
2025-01-07 19:45:34,Biru,850,340,tensor(127.7220),tensor(98.8477),105,78,103,81,2,3,True,0.0
2025-01-07 19:45:34,persegiBiru,847,344,131,95,160,18,160,14,0,4,True,0.33294456971099007
2025-01-07 19:45:34,Fail to pick,847,344,0,0,0,0,0,0,0,0,False,0
2025-01-07 19:45:34,persegiBiru,858,359,125,94,44,10,48,9,4,1,True,0.1615430720272913
2025-01-07 19:45:34,persegiBiru,849,344,126,97,68,68,67,66,1,2,True,0.21160326558275044
2025-01-07 19:45:35,persegiBiru,857,339,121,98,151,5,152,8,1,3,True,0.3398554335325426
2025-01-07 19:45:35,Fail to pick,857,339,0,0,0,0,0,0,0,0,False,0
2025-01-07 19:45:35,persegiBiru,848,345,126,95,31,39,30,42,1,3,False,0.2674506732134385
2025-01-07 19:45:35,Fail to pick,848,345,0,0,0,0,0,0,0,0,False,0
2025-01-07 19:45:35,persegiBiru,864,359,120,95,194,38,192,41,2,3,True,0.47448827734358356
2025-01-07 19:45:35,persegiBiru,865,352,126,95,152,54,155,54,3,0,False,0.2675168270088777
2025-01-07 19:45:35,Fail to pick,865,352,0,0,0,0,0,0,0,0,False,0
2025-01-07 19:45:35,persegiBiru,848,335,126,98,135,61,132,58,3,3,True,0.4029017147344621
2025-01-07 19:45:35,persegiBiru,846,339,130,98,109,80,108,76,1,4,True,0.1408430491568181
2025-01-07 19:45:35,Fail to pick,846,339,0,0,0,0,0,0,0,0,False,0
2025-01-07 19:45:35,persegiBiru,848,340,128,96,7,35,6,36,1,1,True,0.16265963387507423
2025-01-07 19:45:35,Fail to pick,848,340,0,0,0,0,0,0,0,0,False,0
2025-01-07 19:45:35,persegiBiru,848,341,129,99,73,46,70,47,3,1,True,0.37608048151222817
2025-01-07 19:45:35,Fail to pick,848,341,0,0,0,0,0,0,0,0,False,0
2025-01-07 19:45:36,persegiBiru,875,362,118,95,44,44,39,41,5,3,True,0.46642748647827004
2025-01-07 19:45:36,persegiBiru,855,345,123,98,14,89,17,88,3,1,True,0.4112374340817373
2025-01-07 19:45:36,persegiBiru,847,341,129,97,186,10,187,12,1,2,True,0.39662494077225774
2025-01-07 19:45:36,Fail to pick,847,341,0,0,0,0,0,0,0,0,False,0
2025-01-07 19:45:36,persegiBiru,845,348,129,97,64,14,65,10,1,4,True,0.2570057744706554
2025-01-07 19:45:36,Fail to pick,845,348,0,0,0,0,0,0,0,0,False,0
2025-01-07 19:45:36,persegiBiru,847,353,133,101,20,18,22,15,2,3,True,0.4410261367943503
2025-01-07 19:45:36,Fail to pick,847,353,0,0,0,0,0,0,0,0,False,0
2025-01-07 19:45:36,persegiBiru,850,354,129,100,67,6,66,1,1,5,True,0.49935454912890465
2025-01-07 19:45:36,Fail to pick,850,354,0,0,0,0,0,0,0,0,False,0
2025-01-07 19:45:37,persegiBiru,843,365,130,104,112,71,114,70,2,1,True,0.32146678348782404
2025-01-07 19:45:37,persegiBiru,846,367,129,102,198,72,198,68,0,4,False,0.15202106605289087
2025-01-07 19:45:37,Fail to pick,846,367,0,0,0,0,0,0,0,0,False,0
2025-01-07 19:45:39,persegiMerah,276,428,125,107,45,44,45,45,0,1,True,0.32427540412422806
2025-01-07 19:45:39,Merah,276,428,tensor(125.5749),tensor(107.5653),81,25,78,25,3,0,True,0.0
2025-01-07 19:45:39,persegiBiru,269,417,122,102,39,77,40,80,1,3,True,0.45396859480200535
2025-01-07 19:45:39,persegiBiru,273,414,122,103,99,8,98,5,1,3,True,0.43622279717170354
2025-01-07 19:45:39,Fail to pick,273,414,0,0,0,0,0,0,0,0,False,0
2025-01-07 19:45:39,persegiBiru,296,414,126,104,45,94,45,98,0,4,True,0.4968317819832787
2025-01-07 19:45:40,persegiBiru,266,421,122,103,23,59,25,61,2,2,True,0.3446978001906378
2025-01-07 19:45:40,persegiBiru,258,420,121,101,22,75,26,73,4,2,True,0.41349225923871036
2025-01-07 19:45:40,Fail to pick,258,420,0,0,0,0,0,0,0,0,False,0
2025-01-07 19:45:40,persegiBiru,275,409,121,103,110,40,107,44,3,4,True,0.31156268620779326
2025-01-07 19:45:40,persegiBiru,260,421,120,100,143,18,138,16,5,2,True,0.15748469728201733
2025-01-07 19:45:40,persegiBiru,280,425,121,101,78,96,81,98,3,2,True,0.3415694398418485
2025-01-07 19:45:41,persegiBiru,264,417,118,103,35,47,33,50,2,3,True,0.14856314575525867
2025-01-07 19:45:41,persegiBiru,259,424,117,99,10,77,5,80,5,3,True,0.18589436573556833
2025-01-07 19:45:41,Fail to pick,259,424,0,0,0,0,0,0,0,0,False,0
2025-01-07 19:45:41,persegiBiru,272,413,120,102,97,58,92,59,5,1,True,0.4903692634138229
2025-01-07 19:45:41,persegiBiru,264,426,119,104,135,17,138,21,3,4,True,0.16600773427340654
2025-01-07 19:45:41,persegiBiru,271,410,123,103,87,9,84,8,3,1,False,0.24169944576168337
2025-01-07 19:45:41,persegiBiru,262,418,123,102,117,74,119,77,2,3,True,0.29320867977715814
2025-01-07 19:45:41,Fail to pick,262,418,0,0,0,0,0,0,0,0,False,0
2025-01-07 19:45:41,persegiBiru,251,419,123,102,90,17,85,20,5,3,True,0.19344098193839077
2025-01-07 19:45:41,persegiBiru,270,420,118,103,151,74,151,69,0,5,True,0.21960294877580538
2025-01-07 19:45:41,persegiBiru,255,418,118,104,89,49,89,53,0,4,False,0.29668988574256716
2025-01-07 19:45:42,persegiBiru,272,413,121,103,69,17,73,21,4,4,True,0.22271093884521653
2025-01-07 19:45:42,persegiBiru,268,417,122,104,48,94,45,96,3,2,True,0.15405823009441286
2025-01-07 19:45:42,Fail to pick,268,417,0,0,0,0,0,0,0,0,False,0
2025-01-07 19:45:42,persegiBiru,279,410,124,108,33,19,36,21,3,2,True,0.2202786915741093
2025-01-07 19:45:42,persegiBiru,274,419,121,103,68,22,67,19,1,3,True,0.44054119620869614
2025-01-07 19:45:42,Fail to pick,274,419,0,0,0,0,0,0,0,0,False,0
2025-01-07 19:45:42,persegiBiru,270,418,121,105,197,22,200,25,3,3,True,0.18207595434459584
2025-01-07 19:45:42,Fail to pick,270,418,0,0,0,0,0,0,0,0,False,0
2025-01-07 19:45:42,persegiBiru,279,400,124,104,137,74,139,71,2,3,True,0.3724035640749751
2025-01-07 19:45:42,persegiBiru,278,396,128,103,146,74,148,77,2,3,True,0.27299544614634796
2025-01-07 19:45:42,Fail to pick,278,396,0,0,0,0,0,0,0,0,False,0
2025-01-07 19:45:42,persegiBiru,249,423,124,109,136,71,135,66,1,5,True,0.16413161134636547
2025-01-07 19:45:44,persegiBiru,299,395,127,116,162,50,166,47,4,3,True,0.29987130995433253
2025-01-07 19:45:45,persegiBiru,306,395,130,111,125,22,129,23,4,1,True,0.3929795948132583
2025-01-07 19:45:45,Fail to pick,306,395,0,0,0,0,0,0,0,0,False,0
2025-01-07 19:45:45,persegiBiru,285,416,125,110,15,3,18,3,3,0,True,0.18296736066657193
2025-01-07 19:45:45,persegiBiru,299,410,128,112,126,4,121,5,5,1,True,0.4221467041860485
2025-01-07 19:45:46,persegiBiru,295,415,128,109,93,44,97,40,4,4,True,0.2045773327657856
2025-01-07 19:45:46,Fail to pick,295,415,0,0,0,0,0,0,0,0,False,0
2025-01-07 19:45:46,persegiBiru,306,410,134,114,192,89,194,93,2,4,True,0.3645723948537676
2025-01-07 19:45:46,persegiBiru,306,408,133,114,105,65,100,65,5,0,True,0.11242515075414242
2025-01-07 19:45:46,Fail to pick,306,408,0,0,0,0,0,0,0,0,False,0
2025-01-07 19:45:46,persegiBiru,300,414,130,112,118,7,114,7,4,0,True,0.28372098153461583
2025-01-07 19:45:46,Fail to pick,300,414,0,0,0,0,0,0,0,0,False,0
2025-01-07 19:45:46,persegiBiru,301,407,127,116,124,54,119,52,5,2,True,0.16947691777142038
2025-01-07 19:45:46,Fail to pick,301,407,0,0,0,0,0,0,0,0,False,0
2025-01-07 19:45:46,persegiBiru,296,410,120,113,117,1,121,-1,4,2,True,0.22584913855732347
2025-01-07 19:45:46,Fail to pick,296,410,0,0,0,0,0,0,0,0,False,0
2025-01-07 19:45:47,persegiBiru,280,409,127,114,2,70,3,72,1,2,False,0.2465402168392406
2025-01-07 19:45:47,persegiMerah,296,405,127,121,40,30,39,28,1,2,True,0.4417221526347582
2025-01-07 19:45:47,persegiMerah,298,405,128,119,26,91,29,91,3,0,True,0.4443256415795379
2025-01-07 19:45:47,Fail to pick,298,405,0,0,0,0,0,0,0,0,False,0
2025-01-07 19:45:47,persegiBiru,271,417,117,110,24,65,27,65,3,0,True,0.29978471639669363
2025-01-07 19:45:47,persegiBiru,276,413,123,121,90,49,94,44,4,5,True,0.1102874404628199
2025-01-07 19:45:47,Fail to pick,276,413,0,0,0,0,0,0,0,0,False,0
2025-01-07 19:45:47,persegiMerah,277,407,123,121,27,46,23,43,4,3,True,0.2798581222420116
2025-01-07 19:45:47,Fail to pick,277,407,0,0,0,0,0,0,0,0,False,0
2025-01-07 19:45:48,persegiBiru,302,410,126,112,151,2,151,6,0,4,False,0.17589802792869974
2025-01-07 19:45:48,persegiMerah,299,405,133,115,116,12,116,11,0,1,True,0.1399223904006402
2025-01-07 19:45:48,Fail to pick,299,405,0,0,0,0,0,0,0,0,False,0
2025-01-07 19:45:49,persegiMerah,286,404,123,115,133,9,128,6,5,3,True,0.19595261647987045
2025-01-07 19:45:49,persegiMerah,278,420,130,113,114,93,113,90,1,3,True,0.4589944491650303
2025-01-07 19:45:49,persegiMerah,278,405,125,116,30,27,26,25,4,2,True,0.25431371933816516
2025-01-07 19:45:49,persegiMerah,271,420,126,118,39,40,39,36,0,4,True,0.26081175624815606
2025-01-07 19:45:50,persegiMerah,268,421,130,110,7,10,10,6,3,4,True,0.2559786444564494
2025-01-07 19:45:50,Fail to pick,268,421,0,0,0,0,0,0,0,0,False,0
2025-01-07 19:45:50,persegiBiru,271,414,126,107,95,1,99,0,4,1,True,0.15186292386362
2025-01-07 19:45:50,Fail to pick,271,414,0,0,0,0,0,0,0,0,False,0
2025-01-07 19:45:51,persegiBiru,290,455,122,108,153,66,152,63,1,3,True,0.25815699646193613
2025-01-07 19:45:51,Biru,290,455,tensor(122.7430),tensor(108.8302),73,26,71,30,2,4,True,0.0
2025-01-07 19:45:52,persegiBiru,295,437,122,110,114,26,113,29,1,3,True,0.14881280575763045
2025-01-07 19:45:52,persegiBiru,280,442,121,106,60,15,56,13,4,2,True,0.17436862823855093
2025-01-07 19:45:52,persegiBiru,269,451,125,103,197,52,200,51,3,1,True,0.10481873427603948
2025-01-07 19:45:52,persegiBiru,278,448,128,103,158,14,161,18,3,4,True,0.1426290190293249
2025-01-07 19:45:52,Fail to pick,278,448,0,0,0,0,0,0,0,0,False,0
2025-01-07 19:45:52,persegiBiru,285,442,128,102,11,86,6,87,5,1,True,0.46036313272494767
2025-01-07 19:45:52,Fail to pick,285,442,0,0,0,0,0,0,0,0,False,0
2025-01-07 19:45:52,persegiBiru,272,450,125,102,97,16,93,20,4,4,True,0.3689207551168471
2025-01-07 19:45:52,persegiBiru,272,450,126,104,23,14,22,14,1,0,True,0.36842353229155
2025-01-07 19:45:52,Fail to pick,272,450,0,0,0,0,0,0,0,0,False,0
2025-01-07 19:45:53,persegiBiru,281,442,123,105,142,86,145,86,3,0,True,0.4495807529398398
2025-01-07 19:45:53,Fail to pick,281,442,0,0,0,0,0,0,0,0,False,0
2025-01-07 19:45:53,persegiBiru,268,453,124,101,185,12,181,8,4,4,True,0.32147080081866114
2025-01-07 19:45:53,persegiBiru,273,451,122,101,123,14,127,16,4,2,True,0.37880327597898233
2025-01-07 19:45:53,Fail to pick,273,451,0,0,0,0,0,0,0,0,False,0
2025-01-07 19:45:53,persegiBiru,281,445,125,104,113,42,111,43,2,1,True,0.3722082196181973
2025-01-07 19:45:53,Fail to pick,281,445,0,0,0,0,0,0,0,0,False,0
2025-01-07 19:45:53,persegiBiru,274,449,127,101,91,3,87,-1,4,4,True,0.36324487738566835
2025-01-07 19:45:53,Fail to pick,274,449,0,0,0,0,0,0,0,0,False,0
2025-01-07 19:45:53,persegiBiru,275,451,127,105,195,95,190,92,5,3,True,0.34799441639956924
2025-01-07 19:45:53,Fail to pick,275,451,0,0,0,0,0,0,0,0,False,0
2025-01-07 19:45:54,persegiBiru,291,439,121,105,190,2,185,4,5,2,True,0.2538269896987386
2025-01-07 19:45:54,persegiBiru,279,446,126,103,10,41,12,36,2,5,True,0.23287764974471195
2025-01-07 19:45:54,persegiBiru,289,446,125,104,6,15,3,18,3,3,True,0.24218993548605297
2025-01-07 19:45:54,persegiBiru,293,444,124,102,187,68,183,63,4,5,True,0.39728848662733274
2025-01-07 19:45:54,Fail to pick,293,444,0,0,0,0,0,0,0,0,False,0
2025-01-07 19:45:54,persegiBiru,278,449,128,101,36,37,36,38,0,1,True,0.262229713556108
2025-01-07 19:45:54,persegiBiru,297,435,122,104,130,87,127,88,3,1,True,0.19536874449316902
2025-01-07 19:45:55,persegiBiru,279,448,131,103,118,74,118,69,0,5,True,0.21581315237875645
2025-01-07 19:45:55,persegiBiru,283,446,128,104,17,32,14,33,3,1,True,0.4067124675670757
2025-01-07 19:45:55,Fail to pick,283,446,0,0,0,0,0,0,0,0,False,0
2025-01-07 19:45:55,persegiBiru,293,446,119,103,129,21,129,19,0,2,True,0.33882250816615744
2025-01-07 19:45:55,persegiBiru,285,444,119,105,11,41,7,37,4,4,True,0.16281340992525212
2025-01-07 19:45:55,Fail to pick,285,444,0,0,0,0,0,0,0,0,False,0
2025-01-07 19:45:55,persegiBiru,285,436,120,106,22,48,25,48,3,0,True,0.36623561592849485
2025-01-07 19:45:55,Fail to pick,285,436,0,0,0,0,0,0,0,0,False,0
2025-01-07 19:45:55,persegiBiru,276,450,126,104,84,2,81,2,3,0,True,0.36895624240000013
2025-01-07 19:45:56,persegiBiru,283,446,127,103,138,76,140,80,2,4,True,0.2860541337845302
2025-01-07 19:45:56,Fail to pick,283,446,0,0,0,0,0,0,0,0,False,0
2025-01-07 19:45:56,persegiBiru,281,449,120,102,127,15,127,19,0,4,True,0.14032677085917902
2025-01-07 19:45:56,Fail to pick,281,449,0,0,0,0,0,0,0,0,False,0
2025-01-07 19:45:56,persegiBiru,278,448,124,103,199,11,201,13,2,2,True,0.4740370208262902
2025-01-07 19:45:56,Fail to pick,278,448,0,0,0,0,0,0,0,0,False,0
2025-01-07 19:45:56,persegiBiru,284,448,125,103,147,26,148,29,1,3,True,0.4942647636398593
2025-01-07 19:45:56,Fail to pick,284,448,0,0,0,0,0,0,0,0,False,0
2025-01-07 19:45:56,persegiBiru,289,450,122,103,38,95,35,91,3,4,True,0.24974812088136808
2025-01-07 19:45:56,Fail to pick,289,450,0,0,0,0,0,0,0,0,False,0
2025-01-07 19:45:57,persegiBiru,293,446,115,103,93,4,89,2,4,2,True,0.11046596801809105
2025-01-07 19:45:57,Fail to pick,293,446,0,0,0,0,0,0,0,0,False,0
2025-01-07 19:45:57,persegiBiru,288,448,122,100,88,56,86,55,2,1,True,0.42451000154953855
2025-01-07 19:45:57,Fail to pick,288,448,0,0,0,0,0,0,0,0,False,0
2025-01-07 19:48:22,persegiMerah,240,198,122,125,178,39,182,39,4,0,True,0.32024309537573803
2025-01-07 19:48:22,Merah,240,198,tensor(122.4451),tensor(125.9278),145,22,145,26,0,4,True,0.0004987716674804688
2025-01-07 19:48:22,persegiMerah,233,198,125,123,143,45,147,43,4,2,True,0.18636741640051918
2025-01-07 19:48:22,Fail to pick,233,198,0,0,0,0,0,0,0,0,False,0
2025-01-07 19:48:23,persegiMerah,231,197,124,123,36,77,39,76,3,1,True,0.21123809397344773
2025-01-07 19:48:23,Fail to pick,231,197,0,0,0,0,0,0,0,0,False,0
2025-01-07 19:48:23,persegiMerah,232,199,122,124,59,83,57,82,2,1,True,0.3704612488749478
2025-01-07 19:48:23,Fail to pick,232,199,0,0,0,0,0,0,0,0,False,0
2025-01-07 19:48:23,persegiMerah,233,198,123,124,194,35,193,30,1,5,True,0.20037839145719405
2025-01-07 19:48:23,Fail to pick,233,198,0,0,0,0,0,0,0,0,False,0
2025-01-07 19:48:23,persegiMerah,241,199,125,124,92,84,87,81,5,3,True,0.34350315996355496
2025-01-07 19:48:23,Fail to pick,241,199,0,0,0,0,0,0,0,0,False,0
2025-01-07 19:48:23,persegiMerah,234,200,125,124,174,31,171,30,3,1,True,0.2492344705986961
2025-01-07 19:48:23,Fail to pick,234,200,0,0,0,0,0,0,0,0,False,0
2025-01-07 19:48:23,persegiMerah,234,198,125,124,147,45,149,48,2,3,True,0.16811278424481646
2025-01-07 19:48:23,Fail to pick,234,198,0,0,0,0,0,0,0,0,False,0
2025-01-07 19:48:23,persegiMerah,235,198,124,124,36,81,32,80,4,1,True,0.49758371083400654
2025-01-07 19:48:23,Fail to pick,235,198,0,0,0,0,0,0,0,0,False,0
2025-01-07 19:48:24,persegiMerah,234,199,122,123,107,83,106,78,1,5,True,0.29638778261051024
2025-01-07 19:48:24,Fail to pick,234,199,0,0,0,0,0,0,0,0,False,0
2025-01-07 19:48:24,persegiMerah,236,200,122,124,187,30,188,26,1,4,True,0.3685305456068241
2025-01-07 19:48:24,Fail to pick,236,200,0,0,0,0,0,0,0,0,False,0
2025-01-07 19:48:24,persegiMerah,231,202,122,124,42,24,41,20,1,4,True,0.34879622158895396
2025-01-07 19:48:24,Fail to pick,231,202,0,0,0,0,0,0,0,0,False,0
2025-01-07 19:48:24,persegiMerah,235,198,123,122,122,49,123,44,1,5,True,0.2782987297594744
2025-01-07 19:48:24,Fail to pick,235,198,0,0,0,0,0,0,0,0,False,0
2025-01-07 19:48:24,persegiMerah,239,197,121,124,188,63,188,62,0,1,True,0.2721841786975844
2025-01-07 19:48:24,Fail to pick,239,197,0,0,0,0,0,0,0,0,False,0
2025-01-07 19:48:24,persegiMerah,234,200,123,122,84,78,88,79,4,1,True,0.1880225829522508
2025-01-07 19:48:24,Fail to pick,234,200,0,0,0,0,0,0,0,0,False,0
2025-01-07 19:48:24,persegiMerah,232,203,124,123,25,85,27,83,2,2,True,0.4170768640159648
2025-01-07 19:48:24,Fail to pick,232,203,0,0,0,0,0,0,0,0,False,0
2025-01-07 19:48:25,persegiMerah,242,199,122,124,105,25,109,26,4,1,True,0.20624413916623305
2025-01-07 19:48:25,persegiMerah,230,199,121,123,78,55,78,58,0,3,True,0.3339255757209259
2025-01-07 19:48:25,persegiMerah,234,203,124,123,132,95,136,99,4,4,True,0.32162740352765506
2025-01-07 19:48:25,Fail to pick,234,203,0,0,0,0,0,0,0,0,False,0
2025-01-07 19:48:25,persegiMerah,237,200,123,125,21,96,23,92,2,4,True,0.3033492960907656
2025-01-07 19:48:25,Fail to pick,237,200,0,0,0,0,0,0,0,0,False,0
2025-01-07 19:48:25,persegiMerah,232,198,121,124,199,98,195,100,4,2,True,0.19580020991245975
2025-01-07 19:48:25,Fail to pick,232,198,0,0,0,0,0,0,0,0,False,0
2025-01-07 19:48:25,persegiMerah,232,205,125,124,117,74,119,73,2,1,True,0.38956150020746283
2025-01-07 19:48:25,Fail to pick,232,205,0,0,0,0,0,0,0,0,False,0
2025-01-07 19:48:25,persegiMerah,239,199,123,123,101,88,99,83,2,5,True,0.21778336527069683
2025-01-07 19:48:25,Fail to pick,239,199,0,0,0,0,0,0,0,0,False,0
2025-01-07 19:48:26,persegiMerah,239,196,124,123,164,99,163,94,1,5,True,0.3987691901800309
2025-01-07 19:48:26,Fail to pick,239,196,0,0,0,0,0,0,0,0,False,0
2025-01-07 19:48:26,persegiMerah,239,197,123,126,164,38,168,36,4,2,True,0.49321875283125916
2025-01-07 19:48:26,Fail to pick,239,197,0,0,0,0,0,0,0,0,False,0
2025-01-07 19:48:26,persegiMerah,234,200,122,121,28,60,31,57,3,3,True,0.12961533287898033
2025-01-07 19:48:26,Fail to pick,234,200,0,0,0,0,0,0,0,0,False,0
2025-01-07 19:48:26,persegiMerah,236,200,122,123,116,60,115,64,1,4,True,0.3918834163003121
2025-01-07 19:48:26,Fail to pick,236,200,0,0,0,0,0,0,0,0,False,0
2025-01-07 19:48:26,persegiMerah,237,197,123,124,16,67,14,67,2,0,True,0.2460377737623099
2025-01-07 19:48:26,Fail to pick,237,197,0,0,0,0,0,0,0,0,False,0
2025-01-07 19:48:26,persegiMerah,237,200,124,123,23,59,27,61,4,2,True,0.27757779746838174
2025-01-07 19:48:26,Fail to pick,237,200,0,0,0,0,0,0,0,0,False,0
2025-01-07 19:48:26,persegiMerah,234,200,125,123,159,50,159,54,0,4,True,0.3858023409923128
2025-01-07 19:48:26,Fail to pick,234,200,0,0,0,0,0,0,0,0,False,0
2025-01-07 19:48:27,persegiMerah,238,197,123,123,36,4,38,8,2,4,True,0.39840311476943757
2025-01-07 19:48:27,Fail to pick,238,197,0,0,0,0,0,0,0,0,False,0
2025-01-07 19:48:27,persegiMerah,235,204,125,125,158,23,153,19,5,4,True,0.17232300561177252
2025-01-07 19:48:27,Fail to pick,235,204,0,0,0,0,0,0,0,0,False,0
2025-01-07 19:48:27,persegiMerah,233,199,126,124,34,18,30,19,4,1,True,0.17140226157612787
2025-01-07 19:48:27,Fail to pick,233,199,0,0,0,0,0,0,0,0,False,0
2025-01-07 19:48:27,persegiMerah,229,202,119,123,38,92,34,87,4,5,False,0.317642930070216
2025-01-07 19:48:27,Fail to pick,229,202,0,0,0,0,0,0,0,0,False,0
2025-01-07 19:48:27,persegiMerah,233,208,124,124,169,33,172,34,3,1,True,0.4975599510718528
2025-01-07 19:48:27,Fail to pick,233,208,0,0,0,0,0,0,0,0,False,0
2025-01-07 19:48:27,persegiMerah,226,209,123,127,66,21,69,20,3,1,True,0.40029285797180336
2025-01-07 19:48:27,Fail to pick,226,209,0,0,0,0,0,0,0,0,False,0
2025-01-07 19:48:27,persegiMerah,234,209,125,128,133,21,132,16,1,5,True,0.14221798760180004
2025-01-07 19:48:27,Fail to pick,234,209,0,0,0,0,0,0,0,0,False,0
2025-01-07 19:48:27,persegiMerah,240,208,122,128,157,69,157,64,0,5,True,0.2381979493373236
2025-01-07 19:48:27,Fail to pick,240,208,0,0,0,0,0,0,0,0,False,0
2025-01-07 19:48:28,persegiMerah,233,210,126,130,114,94,118,96,4,2,True,0.43609104001261656
2025-01-07 19:48:28,Fail to pick,233,210,0,0,0,0,0,0,0,0,False,0
2025-01-07 19:48:28,persegiMerah,210,222,120,132,118,14,122,10,4,4,True,0.38946314241416735
2025-01-07 19:48:28,persegiMerah,234,208,121,127,12,48,10,50,2,2,True,0.19124359993210627
2025-01-07 19:48:28,persegiMerah,210,221,120,133,38,57,38,59,0,2,True,0.32197832353140343
2025-01-07 19:48:28,persegiMerah,213,221,121,131,113,58,110,59,3,1,True,0.43417875920044546
2025-01-07 19:48:28,Fail to pick,213,221,0,0,0,0,0,0,0,0,False,0
2025-01-07 19:48:28,persegiMerah,212,219,119,133,118,13,119,16,1,3,True,0.1295032472543353
2025-01-07 19:48:28,Fail to pick,212,219,0,0,0,0,0,0,0,0,False,0
2025-01-07 19:48:28,persegiMerah,216,219,121,132,101,49,103,48,2,1,True,0.3369372562394891
2025-01-07 19:48:28,Fail to pick,216,219,0,0,0,0,0,0,0,0,False,0
2025-01-07 19:48:28,persegiMerah,217,219,125,135,173,55,177,57,4,2,True,0.23502894780572078
2025-01-07 19:48:28,Fail to pick,217,219,0,0,0,0,0,0,0,0,False,0
2025-01-07 19:48:28,persegiMerah,213,222,123,130,131,73,130,70,1,3,False,0.3532956420872557
2025-01-07 19:48:28,Fail to pick,213,222,0,0,0,0,0,0,0,0,False,0
2025-01-07 19:48:29,persegiMerah,233,211,125,128,21,18,17,17,4,1,True,0.26422389869309826
2025-01-07 19:48:29,persegiMerah,235,205,125,126,127,19,128,15,1,4,True,0.37576904863413296
2025-01-07 19:48:29,Fail to pick,235,205,0,0,0,0,0,0,0,0,False,0
2025-01-07 19:48:29,persegiMerah,237,199,127,128,92,74,91,77,1,3,True,0.3580184498751776
2025-01-07 19:48:29,Fail to pick,237,199,0,0,0,0,0,0,0,0,False,0
2025-01-07 19:48:29,persegiMerah,236,207,130,129,42,4,44,0,2,4,True,0.3471477212182509
2025-01-07 19:48:29,Fail to pick,236,207,0,0,0,0,0,0,0,0,False,0
2025-01-07 19:48:29,persegiMerah,236,208,130,128,102,6,106,1,4,5,True,0.22169710752331928
2025-01-07 19:48:29,Fail to pick,236,208,0,0,0,0,0,0,0,0,False,0
2025-01-07 19:48:29,persegiMerah,233,206,130,129,166,69,164,67,2,2,True,0.19756035797779603
2025-01-07 19:48:29,Fail to pick,233,206,0,0,0,0,0,0,0,0,False,0
2025-01-07 19:48:29,persegiMerah,237,208,124,128,71,12,66,8,5,4,True,0.3976415087801668
2025-01-07 19:48:29,Fail to pick,237,208,0,0,0,0,0,0,0,0,False,0
2025-01-07 19:48:29,persegiMerah,235,207,127,125,136,74,135,78,1,4,True,0.43469567210086646
2025-01-07 19:48:29,Fail to pick,235,207,0,0,0,0,0,0,0,0,False,0
2025-01-07 19:48:30,persegiMerah,234,208,125,129,125,82,124,79,1,3,True,0.1597092422667804
2025-01-07 19:48:30,Fail to pick,234,208,0,0,0,0,0,0,0,0,False,0
2025-01-07 19:48:30,persegiMerah,229,208,125,129,144,1,146,0,2,1,True,0.2934001780053114
2025-01-07 19:48:30,Fail to pick,229,208,0,0,0,0,0,0,0,0,False,0
2025-01-07 19:48:30,persegiMerah,228,209,126,128,112,28,116,23,4,5,True,0.23076130791721217
2025-01-07 19:48:30,Fail to pick,228,209,0,0,0,0,0,0,0,0,False,0
2025-01-07 19:48:30,persegiMerah,229,208,127,127,102,93,98,96,4,3,False,0.36306998467259644
2025-01-07 19:48:30,Fail to pick,229,208,0,0,0,0,0,0,0,0,False,0
2025-01-07 19:48:30,persegiMerah,230,206,126,127,195,15,194,15,1,0,True,0.33298477662308895
2025-01-07 19:48:30,Fail to pick,230,206,0,0,0,0,0,0,0,0,False,0
2025-01-07 19:48:30,persegiMerah,237,208,124,125,133,69,137,69,4,0,False,0.3214892767750507
2025-01-07 19:48:30,Fail to pick,237,208,0,0,0,0,0,0,0,0,False,0
2025-01-07 19:48:30,persegiMerah,212,218,119,133,122,93,126,89,4,4,True,0.30699686543948135
2025-01-07 19:48:30,persegiMerah,215,220,123,132,153,42,149,46,4,4,True,0.4651007950527769
2025-01-07 19:48:30,Fail to pick,215,220,0,0,0,0,0,0,0,0,False,0
2025-01-07 19:48:31,persegiMerah,213,221,123,131,150,2,151,-2,1,4,True,0.39207158481441606
2025-01-07 19:48:31,Fail to pick,213,221,0,0,0,0,0,0,0,0,False,0
2025-01-07 19:48:31,persegiMerah,222,219,126,130,48,99,43,96,5,3,True,0.3528755402484839
2025-01-07 19:48:31,Fail to pick,222,219,0,0,0,0,0,0,0,0,False,0
2025-01-07 19:48:31,persegiMerah,217,218,125,132,141,27,141,29,0,2,True,0.2391596318069875
2025-01-07 19:48:31,Fail to pick,217,218,0,0,0,0,0,0,0,0,False,0
2025-01-07 19:48:31,persegiMerah,216,220,124,130,165,83,163,87,2,4,True,0.1445383800770327
2025-01-07 19:48:31,Fail to pick,216,220,0,0,0,0,0,0,0,0,False,0
2025-01-07 19:48:31,persegiMerah,215,222,121,132,144,21,146,20,2,1,True,0.38831064634793033
2025-01-07 19:48:31,Fail to pick,215,222,0,0,0,0,0,0,0,0,False,0
2025-01-07 19:48:31,persegiMerah,216,219,121,134,135,36,131,32,4,4,True,0.23382925253908785
2025-01-07 19:48:31,Fail to pick,216,219,0,0,0,0,0,0,0,0,False,0
2025-01-07 19:48:31,persegiMerah,214,220,123,133,28,2,24,5,4,3,True,0.1805848314766909
2025-01-07 19:48:31,Fail to pick,214,220,0,0,0,0,0,0,0,0,False,0
2025-01-07 19:48:31,persegiMerah,226,212,128,131,104,62,107,65,3,3,True,0.3829190296456023
2025-01-07 19:48:31,persegiMerah,209,217,121,134,147,19,150,17,3,2,True,0.4426457614236152
2025-01-07 19:48:32,persegiMerah,216,217,125,132,46,58,50,53,4,5,True,0.4150751693535777
2025-01-07 19:48:32,Fail to pick,216,217,0,0,0,0,0,0,0,0,False,0
2025-01-07 19:48:32,persegiMerah,211,226,124,130,93,28,95,26,2,2,False,0.298574852725922
2025-01-07 19:48:32,Fail to pick,211,226,0,0,0,0,0,0,0,0,False,0
2025-01-07 19:48:32,persegiMerah,223,215,128,132,88,55,91,50,3,5,True,0.11421913099715249
2025-01-07 19:48:32,persegiMerah,219,220,127,131,132,91,128,94,4,3,True,0.4195951839819505
2025-01-07 19:48:32,Fail to pick,219,220,0,0,0,0,0,0,0,0,False,0
2025-01-07 19:48:32,persegiMerah,214,221,122,132,177,30,174,32,3,2,True,0.4270065236287449
2025-01-07 19:48:32,Fail to pick,214,221,0,0,0,0,0,0,0,0,False,0
2025-01-07 19:48:32,persegiMerah,226,214,127,132,191,47,192,42,1,5,True,0.4062825845628356
2025-01-07 19:48:32,persegiMerah,212,220,123,134,131,41,134,43,3,2,True,0.23476066203499385
2025-01-07 19:48:32,persegiMerah,219,215,123,134,64,11,64,15,0,4,False,0.49210107953958315
2025-01-07 19:48:32,Fail to pick,219,215,0,0,0,0,0,0,0,0,False,0
2025-01-07 19:48:32,persegiMerah,215,220,126,132,140,88,141,88,1,0,True,0.1860368033926394
2025-01-07 19:48:32,Fail to pick,215,220,0,0,0,0,0,0,0,0,False,0
2025-01-07 19:48:32,persegiMerah,213,221,122,131,14,27,14,30,0,3,True,0.32811527725306533
2025-01-07 19:48:32,Fail to pick,213,221,0,0,0,0,0,0,0,0,False,0
2025-01-07 19:48:33,persegiMerah,212,222,122,131,30,59,31,59,1,0,True,0.37500866888407425
2025-01-07 19:48:33,Fail to pick,212,222,0,0,0,0,0,0,0,0,False,0
2025-01-07 19:48:33,persegiMerah,215,220,124,133,194,28,190,23,4,5,True,0.47825839681629434
2025-01-07 19:48:33,Fail to pick,215,220,0,0,0,0,0,0,0,0,False,0
2025-01-07 19:48:33,persegiMerah,222,216,126,133,34,88,31,91,3,3,True,0.4396523789561877
2025-01-07 19:48:33,Fail to pick,222,216,0,0,0,0,0,0,0,0,False,0
2025-01-07 19:48:33,persegiMerah,220,215,127,134,108,36,110,36,2,0,True,0.39739645352245967
2025-01-07 19:48:33,Fail to pick,220,215,0,0,0,0,0,0,0,0,False,0
2025-01-07 19:48:33,persegiMerah,225,211,127,133,17,9,19,13,2,4,True,0.3794212853578951
2025-01-07 19:48:33,Fail to pick,225,211,0,0,0,0,0,0,0,0,False,0
2025-01-07 19:48:33,persegiMerah,216,219,127,132,41,32,41,30,0,2,True,0.2572080005387847
2025-01-07 19:48:33,Fail to pick,216,219,0,0,0,0,0,0,0,0,False,0
2025-01-07 19:48:33,persegiMerah,213,220,123,131,177,3,180,-2,3,5,True,0.3031614614103203
2025-01-07 19:48:33,Fail to pick,213,220,0,0,0,0,0,0,0,0,False,0
2025-01-07 19:48:33,persegiMerah,217,221,129,131,153,63,148,66,5,3,False,0.2809498506982293
2025-01-07 19:48:33,Fail to pick,217,221,0,0,0,0,0,0,0,0,False,0
2025-01-07 19:48:33,persegiMerah,218,217,125,133,3,88,3,90,0,2,False,0.14226132986036497
2025-01-07 19:48:33,Fail to pick,218,217,0,0,0,0,0,0,0,0,False,0
2025-01-07 19:48:34,persegiMerah,222,216,128,131,72,13,67,8,5,5,True,0.1559671900617642
2025-01-07 19:48:34,Fail to pick,222,216,0,0,0,0,0,0,0,0,False,0
2025-01-07 19:48:34,persegiMerah,224,218,127,132,85,54,86,56,1,2,True,0.335153984417497
2025-01-07 19:48:34,Fail to pick,224,218,0,0,0,0,0,0,0,0,False,0
2025-01-07 19:48:34,persegiMerah,223,218,129,133,176,75,177,75,1,0,True,0.37530242145237913
2025-01-07 19:48:34,Fail to pick,223,218,0,0,0,0,0,0,0,0,False,0
2025-01-07 19:48:34,persegiMerah,216,222,126,130,131,71,132,72,1,1,True,0.1132023300594423
2025-01-07 19:48:34,Fail to pick,216,222,0,0,0,0,0,0,0,0,False,0
2025-01-07 19:48:34,persegiMerah,225,216,127,132,45,57,40,54,5,3,True,0.13371838157686233
2025-01-07 19:48:34,Fail to pick,225,216,0,0,0,0,0,0,0,0,False,0
2025-01-07 19:48:34,persegiMerah,220,220,125,130,12,77,7,74,5,3,True,0.20261342657579992
2025-01-07 19:48:34,Fail to pick,220,220,0,0,0,0,0,0,0,0,False,0
2025-01-07 19:48:34,persegiMerah,223,217,128,132,151,66,154,68,3,2,True,0.31594750076792855
2025-01-07 19:48:34,Fail to pick,223,217,0,0,0,0,0,0,0,0,False,0
2025-01-07 19:48:34,persegiMerah,214,223,124,130,54,73,52,72,2,1,True,0.33114453948650036
2025-01-07 19:48:34,Fail to pick,214,223,0,0,0,0,0,0,0,0,False,0
2025-01-07 19:48:34,persegiMerah,221,219,126,128,160,10,155,9,5,1,True,0.34639903704225744
2025-01-07 19:48:34,Fail to pick,221,219,0,0,0,0,0,0,0,0,False,0
2025-01-07 19:48:35,persegiMerah,215,221,125,131,178,55,173,56,5,1,False,0.28806387516854826
2025-01-07 19:48:35,Fail to pick,215,221,0,0,0,0,0,0,0,0,False,0
2025-01-07 19:48:35,persegiMerah,213,220,125,132,86,40,87,42,1,2,True,0.26824806998267947
2025-01-07 19:48:35,Fail to pick,213,220,0,0,0,0,0,0,0,0,False,0
2025-01-07 19:48:35,persegiMerah,221,224,123,128,136,41,138,45,2,4,True,0.3763929315428981
2025-01-07 19:48:35,Fail to pick,221,224,0,0,0,0,0,0,0,0,False,0
2025-01-07 19:48:36,persegiMerah,196,414,124,116,120,81,124,83,4,2,True,0.28273445904791117
2025-01-07 19:48:36,Merah,196,414,tensor(124.7048),tensor(116.8862),85,18,88,22,3,4,True,0.0
2025-01-07 19:48:36,persegiMerah,198,414,126,117,61,80,65,80,4,0,True,0.32764379627621487
2025-01-07 19:48:36,Fail to pick,198,414,0,0,0,0,0,0,0,0,False,0
2025-01-07 19:48:37,persegiMerah,199,417,125,116,2,61,0,59,2,2,True,0.36120005147800527
2025-01-07 19:48:37,Fail to pick,199,417,0,0,0,0,0,0,0,0,False,0
2025-01-07 19:48:37,persegiMerah,194,418,126,115,17,64,14,67,3,3,True,0.4927344037326339
2025-01-07 19:48:37,Fail to pick,194,418,0,0,0,0,0,0,0,0,False,0
2025-01-07 19:48:37,persegiMerah,197,418,126,115,155,65,156,62,1,3,True,0.16723058487799314
2025-01-07 19:48:37,Fail to pick,197,418,0,0,0,0,0,0,0,0,False,0
2025-01-07 19:48:37,persegiMerah,203,413,129,114,146,55,148,58,2,3,True,0.37712340820002577
2025-01-07 19:48:37,Fail to pick,203,413,0,0,0,0,0,0,0,0,False,0
2025-01-07 19:48:37,persegiMerah,191,418,124,116,159,75,159,76,0,1,True,0.275062590335786
2025-01-07 19:48:37,persegiMerah,190,422,122,114,70,7,65,2,5,5,True,0.41641899953371564
2025-01-07 19:48:37,Fail to pick,190,422,0,0,0,0,0,0,0,0,False,0
2025-01-07 19:48:37,persegiMerah,203,412,128,114,159,84,157,80,2,4,True,0.4857667009330887
2025-01-07 19:48:37,persegiMerah,201,415,127,116,102,55,101,50,1,5,True,0.3750658155423725
2025-01-07 19:48:37,Fail to pick,201,415,0,0,0,0,0,0,0,0,False,0
2025-01-07 19:48:38,persegiMerah,200,418,125,116,85,80,89,77,4,3,True,0.4095716224055529
2025-01-07 19:48:38,Fail to pick,200,418,0,0,0,0,0,0,0,0,False,0
2025-01-07 19:48:38,persegiMerah,198,415,125,116,13,44,14,41,1,3,True,0.3060415944462025
2025-01-07 19:48:38,Fail to pick,198,415,0,0,0,0,0,0,0,0,False,0
2025-01-07 19:48:38,persegiMerah,198,416,125,115,157,27,157,30,0,3,True,0.27745427252503596
2025-01-07 19:48:38,Fail to pick,198,416,0,0,0,0,0,0,0,0,False,0
2025-01-07 19:48:38,persegiMerah,197,418,125,115,59,21,57,22,2,1,True,0.21389186463418333
2025-01-07 19:48:38,Fail to pick,197,418,0,0,0,0,0,0,0,0,False,0
2025-01-07 19:48:38,persegiMerah,194,418,124,116,26,0,21,1,5,1,False,0.19511768446700897
2025-01-07 19:48:38,Fail to pick,194,418,0,0,0,0,0,0,0,0,False,0
2025-01-07 19:48:38,persegiMerah,200,412,127,114,90,13,88,16,2,3,True,0.2902182431678325
2025-01-07 19:48:38,Fail to pick,200,412,0,0,0,0,0,0,0,0,False,0
2025-01-07 19:48:38,persegiMerah,203,411,127,114,175,10,175,13,0,3,True,0.2595900954595537
2025-01-07 19:48:38,Fail to pick,203,411,0,0,0,0,0,0,0,0,False,0
2025-01-07 19:48:38,persegiMerah,198,416,122,115,0,61,2,58,2,3,True,0.2114296332958662
2025-01-07 19:48:38,Fail to pick,198,416,0,0,0,0,0,0,0,0,False,0
2025-01-07 19:48:39,persegiMerah,202,412,128,114,119,51,116,48,3,3,True,0.4111883639158064
2025-01-07 19:48:39,Fail to pick,202,412,0,0,0,0,0,0,0,0,False,0
2025-01-07 19:48:39,persegiMerah,208,412,126,114,33,87,37,83,4,4,True,0.37817466273404754
2025-01-07 19:48:39,Fail to pick,208,412,0,0,0,0,0,0,0,0,False,0
2025-01-07 19:48:39,persegiMerah,191,423,125,114,56,13,54,11,2,2,True,0.25764430686653683
2025-01-07 19:48:39,persegiMerah,205,413,128,115,102,47,98,43,4,4,True,0.40435106658072595
2025-01-07 19:48:39,persegiMerah,198,416,128,116,20,82,23,85,3,3,True,0.4822491817913598
2025-01-07 19:48:39,Fail to pick,198,416,0,0,0,0,0,0,0,0,False,0
2025-01-07 19:48:39,persegiMerah,197,416,125,116,169,21,168,19,1,2,True,0.11775069888258627
2025-01-07 19:48:39,Fail to pick,197,416,0,0,0,0,0,0,0,0,False,0
2025-01-07 19:48:39,persegiMerah,203,413,128,115,123,33,127,28,4,5,True,0.11189217574777
2025-01-07 19:48:39,Fail to pick,203,413,0,0,0,0,0,0,0,0,False,0
2025-01-07 19:48:39,persegiMerah,196,418,124,116,111,89,112,87,1,2,True,0.16552525082856745
2025-01-07 19:48:39,Fail to pick,196,418,0,0,0,0,0,0,0,0,False,0
2025-01-07 19:48:40,persegiMerah,203,415,129,114,12,79,12,80,0,1,True,0.44945230804012015
2025-01-07 19:48:40,Fail to pick,203,415,0,0,0,0,0,0,0,0,False,0
2025-01-07 19:48:40,persegiMerah,199,416,125,117,59,67,54,63,5,4,True,0.4101163856433213
2025-01-07 19:48:40,Fail to pick,199,416,0,0,0,0,0,0,0,0,False,0
2025-01-07 19:48:40,persegiMerah,205,411,128,114,140,16,141,18,1,2,False,0.4181129992202868
2025-01-07 19:48:40,Fail to pick,205,411,0,0,0,0,0,0,0,0,False,0
2025-01-07 19:48:40,persegiMerah,196,417,125,116,114,13,117,13,3,0,True,0.3053585912927177
2025-01-07 19:48:40,Fail to pick,196,417,0,0,0,0,0,0,0,0,False,0
2025-01-07 19:48:40,persegiMerah,198,417,124,116,119,64,117,59,2,5,True,0.4774205255329572
2025-01-07 19:48:40,Fail to pick,198,417,0,0,0,0,0,0,0,0,False,0
2025-01-07 19:48:40,persegiMerah,203,413,126,116,106,66,101,61,5,5,True,0.22764092151070586
2025-01-07 19:48:40,Fail to pick,203,413,0,0,0,0,0,0,0,0,False,0
2025-01-07 19:48:40,persegiMerah,204,414,128,115,172,78,172,75,0,3,True,0.16511795964324444
2025-01-07 19:48:40,Fail to pick,204,414,0,0,0,0,0,0,0,0,False,0
2025-01-07 19:48:40,persegiMerah,207,410,129,115,158,76,161,78,3,2,True,0.16424973468336895
2025-01-07 19:48:40,Fail to pick,207,410,0,0,0,0,0,0,0,0,False,0
2025-01-07 19:48:40,persegiMerah,203,414,125,115,36,83,40,83,4,0,True,0.2593053769551459
2025-01-07 19:48:40,Fail to pick,203,414,0,0,0,0,0,0,0,0,False,0
2025-01-07 19:48:41,persegiMerah,199,416,125,115,60,48,62,47,2,1,True,0.3293604884956882
2025-01-07 19:48:41,Fail to pick,199,416,0,0,0,0,0,0,0,0,False,0
2025-01-07 19:48:41,persegiMerah,202,412,128,115,125,58,127,60,2,2,True,0.23761394903917568
2025-01-07 19:48:41,Fail to pick,202,412,0,0,0,0,0,0,0,0,False,0
2025-01-07 19:48:41,persegiMerah,194,417,124,119,94,73,90,73,4,0,True,0.11024988478430392
2025-01-07 19:48:41,Fail to pick,194,417,0,0,0,0,0,0,0,0,False,0
2025-01-07 19:48:41,persegiMerah,187,424,121,117,70,57,68,61,2,4,True,0.14301186882544303
2025-01-07 19:48:41,Fail to pick,187,424,0,0,0,0,0,0,0,0,False,0
2025-01-07 19:48:41,persegiMerah,189,420,120,116,169,98,168,95,1,3,True,0.13758500312600927
2025-01-07 19:48:41,Fail to pick,189,420,0,0,0,0,0,0,0,0,False,0
2025-01-07 19:48:41,persegiMerah,190,421,121,116,149,57,150,52,1,5,True,0.4895719549609341
2025-01-07 19:48:41,Fail to pick,190,421,0,0,0,0,0,0,0,0,False,0
2025-01-07 19:48:41,persegiMerah,197,415,126,115,58,29,56,33,2,4,True,0.47910462890184813
2025-01-07 19:48:41,Fail to pick,197,415,0,0,0,0,0,0,0,0,False,0
2025-01-07 19:48:41,persegiMerah,203,416,129,115,22,77,25,74,3,3,True,0.26684859347856504
2025-01-07 19:48:41,Fail to pick,203,416,0,0,0,0,0,0,0,0,False,0
2025-01-07 19:48:41,persegiMerah,189,420,122,115,77,24,76,20,1,4,True,0.44360039971342236
2025-01-07 19:48:42,persegiMerah,198,418,125,116,10,83,7,84,3,1,True,0.2052093280272962
2025-01-07 19:48:42,Fail to pick,198,418,0,0,0,0,0,0,0,0,False,0
2025-01-07 19:48:42,persegiMerah,190,419,124,115,189,73,185,73,4,0,True,0.3309171109188722
2025-01-07 19:48:42,Fail to pick,190,419,0,0,0,0,0,0,0,0,False,0
2025-01-07 19:48:42,persegiMerah,197,416,125,115,68,25,65,24,3,1,True,0.3592637421601592
2025-01-07 19:48:42,Fail to pick,197,416,0,0,0,0,0,0,0,0,False,0
2025-01-07 19:48:42,persegiMerah,193,420,126,116,96,17,97,16,1,1,True,0.16541096743646666
2025-01-07 19:48:42,Fail to pick,193,420,0,0,0,0,0,0,0,0,False,0
2025-01-07 19:48:42,persegiMerah,197,421,123,116,112,41,113,38,1,3,True,0.25042001998676944
2025-01-07 19:48:42,Fail to pick,197,421,0,0,0,0,0,0,0,0,False,0
2025-01-07 19:48:42,persegiMerah,200,417,128,117,15,68,19,70,4,2,True,0.15931799389453621
2025-01-07 19:48:42,Fail to pick,200,417,0,0,0,0,0,0,0,0,False,0
2025-01-07 19:48:42,persegiMerah,202,416,124,115,24,1,22,-1,2,2,True,0.44226685584502357
2025-01-07 19:48:42,Fail to pick,202,416,0,0,0,0,0,0,0,0,False,0
2025-01-07 19:48:42,persegiMerah,199,417,125,117,93,4,97,0,4,4,True,0.3887544498300616
2025-01-07 19:48:42,Fail to pick,199,417,0,0,0,0,0,0,0,0,False,0
2025-01-07 19:48:42,persegiMerah,192,423,125,115,140,9,137,8,3,1,True,0.42176873680054794
2025-01-07 19:48:42,Fail to pick,192,423,0,0,0,0,0,0,0,0,False,0
2025-01-07 19:48:43,persegiMerah,198,417,125,116,173,18,171,14,2,4,True,0.48143928415692305
2025-01-07 19:48:43,Fail to pick,198,417,0,0,0,0,0,0,0,0,False,0
2025-01-07 19:48:43,persegiMerah,189,423,127,116,199,75,195,78,4,3,True,0.39979138394411673
2025-01-07 19:48:43,Fail to pick,189,423,0,0,0,0,0,0,0,0,False,0
2025-01-07 19:48:43,persegiMerah,191,420,126,117,115,69,117,66,2,3,True,0.12662468217647033
2025-01-07 19:48:43,Fail to pick,191,420,0,0,0,0,0,0,0,0,False,0
2025-01-07 19:48:43,persegiMerah,193,423,124,116,86,83,85,80,1,3,False,0.41567527625068246
2025-01-07 19:48:43,Fail to pick,193,423,0,0,0,0,0,0,0,0,False,0
2025-01-07 19:48:43,persegiMerah,190,421,124,117,8,28,8,29,0,1,True,0.27737294508552945
2025-01-07 19:48:43,Fail to pick,190,421,0,0,0,0,0,0,0,0,False,0
2025-01-07 19:48:43,persegiMerah,193,420,126,116,193,29,195,30,2,1,True,0.32257286819110054
2025-01-07 19:48:43,Fail to pick,193,420,0,0,0,0,0,0,0,0,False,0
2025-01-07 19:48:43,persegiMerah,190,423,125,115,54,11,53,12,1,1,True,0.17918683128810595
2025-01-07 19:48:43,Fail to pick,190,423,0,0,0,0,0,0,0,0,False,0
2025-01-07 19:48:43,persegiMerah,190,423,126,116,132,84,127,84,5,0,True,0.15520257069350152
2025-01-07 19:48:43,Fail to pick,190,423,0,0,0,0,0,0,0,0,False,0
2025-01-07 19:48:43,persegiMerah,197,420,126,115,49,5,46,8,3,3,True,0.25654393320582936
2025-01-07 19:48:43,Fail to pick,197,420,0,0,0,0,0,0,0,0,False,0
2025-01-07 19:48:43,persegiMerah,190,424,126,114,77,40,73,44,4,4,True,0.10716235198072091
2025-01-07 19:48:43,Fail to pick,190,424,0,0,0,0,0,0,0,0,False,0
2025-01-07 19:48:44,persegiMerah,198,417,126,116,56,72,57,71,1,1,True,0.34767987108645304
2025-01-07 19:48:44,Fail to pick,198,417,0,0,0,0,0,0,0,0,False,0
2025-01-07 19:48:44,persegiMerah,190,421,126,116,85,34,81,29,4,5,True,0.33843170390275523
2025-01-07 19:48:44,Fail to pick,190,421,0,0,0,0,0,0,0,0,False,0
2025-01-07 19:48:44,persegiMerah,191,421,125,115,146,43,146,42,0,1,True,0.20423311237509167
2025-01-07 19:48:44,Fail to pick,191,421,0,0,0,0,0,0,0,0,False,0
2025-01-07 19:48:44,persegiMerah,189,423,125,115,164,90,163,86,1,4,True,0.395719776349435
2025-01-07 19:48:44,Fail to pick,189,423,0,0,0,0,0,0,0,0,False,0
2025-01-07 19:48:44,persegiMerah,198,416,126,115,20,21,21,19,1,2,True,0.13490657270793252
2025-01-07 19:48:44,Fail to pick,198,416,0,0,0,0,0,0,0,0,False,0
2025-01-07 19:48:44,persegiMerah,187,422,123,114,69,89,67,91,2,2,True,0.4567588970425861
2025-01-07 19:48:44,persegiMerah,187,422,121,115,129,36,129,39,0,3,True,0.41146151705871203
2025-01-07 19:48:44,Fail to pick,187,422,0,0,0,0,0,0,0,0,False,0
2025-01-07 19:48:44,persegiMerah,188,423,123,115,130,30,129,34,1,4,True,0.24695282920738315
2025-01-07 19:48:44,Fail to pick,188,423,0,0,0,0,0,0,0,0,False,0
2025-01-07 19:48:44,persegiMerah,190,422,127,115,146,73,141,74,5,1,True,0.21392973918076363
2025-01-07 19:48:44,Fail to pick,190,422,0,0,0,0,0,0,0,0,False,0
2025-01-07 19:48:45,persegiMerah,187,422,121,115,39,3,36,-1,3,4,False,0.17497507974795745
2025-01-07 19:48:45,Fail to pick,187,422,0,0,0,0,0,0,0,0,False,0
2025-01-07 19:48:45,persegiMerah,187,421,122,114,194,37,195,41,1,4,True,0.35698299046042414
2025-01-07 19:48:45,Fail to pick,187,421,0,0,0,0,0,0,0,0,False,0
2025-01-07 19:48:45,persegiMerah,193,420,127,115,117,68,113,67,4,1,True,0.16297118917123132
2025-01-07 19:48:45,Fail to pick,193,420,0,0,0,0,0,0,0,0,False,0
2025-01-07 19:48:45,persegiMerah,189,421,125,115,35,43,34,44,1,1,True,0.30289594610828285
2025-01-07 19:48:45,Fail to pick,189,421,0,0,0,0,0,0,0,0,False,0
2025-01-07 19:48:45,persegiMerah,188,422,124,116,62,77,61,73,1,4,True,0.2528085724575373
2025-01-07 19:48:45,Fail to pick,188,422,0,0,0,0,0,0,0,0,False,0
2025-01-07 19:48:45,persegiMerah,197,417,125,115,1,36,1,38,0,2,True,0.254974454811695
2025-01-07 19:48:45,Fail to pick,197,417,0,0,0,0,0,0,0,0,False,0
2025-01-07 19:48:45,persegiMerah,188,425,124,112,83,91,78,92,5,1,False,0.41778515552778805
2025-01-07 19:48:45,Fail to pick,188,425,0,0,0,0,0,0,0,0,False,0
2025-01-07 19:48:45,persegiMerah,199,416,128,116,123,21,122,23,1,2,True,0.1775903838213108
2025-01-07 19:48:45,persegiMerah,195,418,128,115,82,11,82,13,0,2,True,0.4433516068557425
2025-01-07 19:48:45,Fail to pick,195,418,0,0,0,0,0,0,0,0,False,0
2025-01-07 19:48:46,persegiMerah,189,423,123,113,171,43,170,44,1,1,True,0.34643042646272093
2025-01-07 19:48:46,Fail to pick,189,423,0,0,0,0,0,0,0,0,False,0
2025-01-07 19:48:46,persegiMerah,192,421,126,115,145,16,147,12,2,4,True,0.4077701681637378
2025-01-07 19:48:46,Fail to pick,192,421,0,0,0,0,0,0,0,0,False,0
2025-01-07 19:48:46,persegiMerah,189,423,125,113,10,57,8,57,2,0,False,0.15445734336108422
2025-01-07 19:48:46,Fail to pick,189,423,0,0,0,0,0,0,0,0,False,0
2025-01-07 19:48:46,persegiMerah,197,417,125,114,101,91,97,94,4,3,True,0.42742476677484187
2025-01-07 19:48:46,Fail to pick,197,417,0,0,0,0,0,0,0,0,False,0
2025-01-07 19:48:46,persegiMerah,191,421,125,116,176,46,178,50,2,4,True,0.26058307552151017
2025-01-07 19:48:46,Fail to pick,191,421,0,0,0,0,0,0,0,0,False,0
2025-01-07 19:48:46,persegiMerah,193,418,124,115,108,85,112,88,4,3,True,0.4472855311132389
2025-01-07 19:48:46,Fail to pick,193,418,0,0,0,0,0,0,0,0,False,0
2025-01-07 19:48:46,persegiMerah,196,413,129,114,188,17,188,20,0,3,True,0.2200096091155234
2025-01-07 19:48:46,Fail to pick,196,413,0,0,0,0,0,0,0,0,False,0
2025-01-07 19:48:46,persegiMerah,195,422,124,114,160,33,162,36,2,3,True,0.28283272042358104
2025-01-07 19:48:46,Fail to pick,195,422,0,0,0,0,0,0,0,0,False,0
2025-01-07 19:48:46,persegiMerah,192,422,127,114,62,8,61,9,1,1,True,0.20181650135009355
2025-01-07 19:48:46,Fail to pick,192,422,0,0,0,0,0,0,0,0,False,0
2025-01-07 19:48:47,persegiMerah,190,421,126,116,14,6,16,9,2,3,True,0.26632659618347687
2025-01-07 19:48:47,Fail to pick,190,421,0,0,0,0,0,0,0,0,False,0
2025-01-07 19:48:47,persegiMerah,193,415,128,116,102,92,100,88,2,4,True,0.25179860201828774
2025-01-07 19:48:47,Fail to pick,193,415,0,0,0,0,0,0,0,0,False,0
2025-01-07 19:48:47,persegiMerah,191,423,128,114,100,24,97,27,3,3,True,0.473119380234882
2025-01-07 19:48:47,Fail to pick,191,423,0,0,0,0,0,0,0,0,False,0
2025-01-07 19:48:47,persegiMerah,189,422,124,114,176,8,180,12,4,4,True,0.35966296645592755
2025-01-07 19:48:47,Fail to pick,189,422,0,0,0,0,0,0,0,0,False,0
2025-01-07 19:48:47,persegiMerah,191,423,126,115,23,45,25,47,2,2,True,0.2634801212245471
2025-01-07 19:48:47,Fail to pick,191,423,0,0,0,0,0,0,0,0,False,0
2025-01-07 19:48:47,persegiMerah,191,423,127,114,125,95,122,92,3,3,True,0.4388330049932937
2025-01-07 19:48:47,Fail to pick,191,423,0,0,0,0,0,0,0,0,False,0
2025-01-07 19:48:47,persegiMerah,200,416,124,115,89,23,93,26,4,3,True,0.2833515558587171
2025-01-07 19:48:47,Fail to pick,200,416,0,0,0,0,0,0,0,0,False,0
2025-01-07 19:48:47,persegiMerah,194,422,125,113,162,58,162,56,0,2,True,0.29392632112026185
2025-01-07 19:48:47,Fail to pick,194,422,0,0,0,0,0,0,0,0,False,0
2025-01-07 19:48:47,persegiMerah,188,422,126,113,33,27,31,24,2,3,True,0.30890638261146575
2025-01-07 19:48:47,Fail to pick,188,422,0,0,0,0,0,0,0,0,False,0
2025-01-07 19:48:48,persegiMerah,195,419,128,114,185,83,184,86,1,3,True,0.11621406833514564
2025-01-07 19:48:48,Fail to pick,195,419,0,0,0,0,0,0,0,0,False,0
2025-01-07 19:48:48,persegiMerah,193,420,125,115,85,82,81,84,4,2,False,0.42728919429608625
2025-01-07 19:48:48,Fail to pick,193,420,0,0,0,0,0,0,0,0,False,0
2025-01-07 19:48:48,persegiMerah,189,423,124,113,179,75,180,75,1,0,True,0.402785728677563
2025-01-07 19:48:48,Fail to pick,189,423,0,0,0,0,0,0,0,0,False,0
2025-01-07 19:48:48,persegiMerah,188,423,123,114,53,24,55,25,2,1,False,0.15928050219930473
2025-01-07 19:48:48,Fail to pick,188,423,0,0,0,0,0,0,0,0,False,0
2025-01-07 19:48:48,persegiMerah,189,423,124,113,83,72,78,72,5,0,True,0.19800831735035018
2025-01-07 19:48:48,Fail to pick,189,423,0,0,0,0,0,0,0,0,False,0
2025-01-07 19:48:48,persegiMerah,189,424,126,114,96,26,92,22,4,4,True,0.3102276205388741
2025-01-07 19:48:48,Fail to pick,189,424,0,0,0,0,0,0,0,0,False,0
2025-01-07 19:48:48,persegiMerah,192,422,125,115,105,6,102,7,3,1,True,0.2607266838471207
2025-01-07 19:48:48,Fail to pick,192,422,0,0,0,0,0,0,0,0,False,0
2025-01-07 19:48:48,persegiMerah,198,419,124,114,148,16,146,12,2,4,True,0.4229894362744361
2025-01-07 19:48:48,Fail to pick,198,419,0,0,0,0,0,0,0,0,False,0
2025-01-07 19:48:48,persegiMerah,195,421,122,115,12,70,12,72,0,2,True,0.4778167653701154
2025-01-07 19:48:48,Fail to pick,195,421,0,0,0,0,0,0,0,0,False,0
2025-01-07 19:48:48,persegiMerah,195,420,125,115,5,31,8,32,3,1,True,0.4237076255543696
2025-01-07 19:48:48,Fail to pick,195,420,0,0,0,0,0,0,0,0,False,0
2025-01-07 19:48:49,persegiMerah,196,417,126,117,20,19,22,15,2,4,True,0.32898588531763884
2025-01-07 19:48:49,Fail to pick,196,417,0,0,0,0,0,0,0,0,False,0
2025-01-07 19:48:49,persegiMerah,189,421,121,117,13,80,15,75,2,5,True,0.42616210254250253
2025-01-07 19:48:49,Fail to pick,189,421,0,0,0,0,0,0,0,0,False,0
2025-01-07 19:48:49,persegiMerah,193,420,124,116,181,85,181,86,0,1,True,0.4220090742149919
2025-01-07 19:48:49,Fail to pick,193,420,0,0,0,0,0,0,0,0,False,0
2025-01-07 19:48:49,persegiMerah,193,422,126,115,6,28,8,23,2,5,True,0.13904816305906997
2025-01-07 19:48:49,Fail to pick,193,422,0,0,0,0,0,0,0,0,False,0
2025-01-07 19:48:49,persegiMerah,194,421,127,115,13,42,12,40,1,2,True,0.41490542099639105
2025-01-07 19:48:49,Fail to pick,194,421,0,0,0,0,0,0,0,0,False,0
2025-01-07 19:48:49,persegiMerah,191,423,125,115,52,99,53,95,1,4,True,0.40006093602328685
2025-01-07 19:48:49,Fail to pick,191,423,0,0,0,0,0,0,0,0,False,0
2025-01-07 19:48:49,persegiMerah,196,420,126,115,128,37,124,40,4,3,True,0.2137124760595875
2025-01-07 19:48:49,Fail to pick,196,420,0,0,0,0,0,0,0,0,False,0
2025-01-07 19:48:49,persegiMerah,190,424,126,114,22,53,23,55,1,2,True,0.3283290576476382
2025-01-07 19:48:49,Fail to pick,190,424,0,0,0,0,0,0,0,0,False,0
2025-01-07 19:48:49,persegiMerah,191,422,127,115,4,62,6,63,2,1,True,0.2481790634367389
2025-01-07 19:48:49,Fail to pick,191,422,0,0,0,0,0,0,0,0,False,0
2025-01-07 19:48:50,persegiMerah,190,423,125,114,191,0,188,4,3,4,True,0.39430415385595496
2025-01-07 19:48:50,Fail to pick,190,423,0,0,0,0,0,0,0,0,False,0
2025-01-07 19:48:50,persegiMerah,190,421,124,115,62,17,65,13,3,4,True,0.26204278052989005
2025-01-07 19:48:50,Fail to pick,190,421,0,0,0,0,0,0,0,0,False,0
2025-01-07 19:48:50,persegiMerah,205,410,130,115,162,34,163,38,1,4,True,0.10399838069121424
2025-01-07 19:48:50,persegiMerah,191,423,126,114,15,73,13,74,2,1,True,0.40513419727572697
2025-01-07 19:48:50,persegiMerah,200,414,126,113,39,79,43,77,4,2,True,0.4001384812461024
2025-01-07 19:48:50,Fail to pick,200,414,0,0,0,0,0,0,0,0,False,0
2025-01-07 19:48:50,persegiMerah,201,414,127,113,32,53,33,57,1,4,True,0.43287978523218607
2025-01-07 19:48:50,Fail to pick,201,414,0,0,0,0,0,0,0,0,False,0
2025-01-07 19:48:50,persegiMerah,203,412,128,114,166,80,162,84,4,4,True,0.32985774799481593
2025-01-07 19:48:50,Fail to pick,203,412,0,0,0,0,0,0,0,0,False,0
2025-01-07 19:48:50,persegiMerah,198,413,126,114,186,74,189,73,3,1,False,0.4424958044721996
2025-01-07 19:48:50,Fail to pick,198,413,0,0,0,0,0,0,0,0,False,0
2025-01-07 19:48:51,persegiMerah,203,414,128,113,51,34,46,32,5,2,True,0.4850857093904364
2025-01-07 19:48:51,Fail to pick,203,414,0,0,0,0,0,0,0,0,False,0
2025-01-07 19:48:51,persegiMerah,200,413,125,114,123,4,119,3,4,1,True,0.3794239779151589
2025-01-07 19:48:51,Fail to pick,200,413,0,0,0,0,0,0,0,0,False,0
2025-01-07 19:48:51,persegiMerah,192,422,124,114,175,10,174,8,1,2,True,0.1700426087924515
2025-01-07 19:48:51,Fail to pick,192,422,0,0,0,0,0,0,0,0,False,0
2025-01-07 19:48:52,persegiMerah,203,410,129,116,163,93,166,93,3,0,True,0.14451329617943373
2025-01-07 19:48:52,persegiMerah,205,411,127,115,114,67,112,62,2,5,True,0.4279950180318257
2025-01-07 19:48:52,Fail to pick,205,411,0,0,0,0,0,0,0,0,False,0
2025-01-07 19:48:52,persegiMerah,198,412,125,115,182,54,185,52,3,2,True,0.33122679214302553
2025-01-07 19:48:52,Fail to pick,198,412,0,0,0,0,0,0,0,0,False,0
2025-01-07 19:48:52,persegiMerah,205,408,131,116,104,23,103,18,1,5,True,0.13751572124264497
2025-01-07 19:48:52,Fail to pick,205,408,0,0,0,0,0,0,0,0,False,0
2025-01-07 19:48:52,persegiMerah,195,418,125,115,120,64,117,59,3,5,False,0.2962698553957266
2025-01-07 19:48:53,persegiMerah,197,417,124,117,31,45,28,43,3,2,True,0.2154624217026498
2025-01-07 19:48:53,Fail to pick,197,417,0,0,0,0,0,0,0,0,False,0
2025-01-07 19:48:53,persegiMerah,194,423,124,115,92,60,96,64,4,4,True,0.15926722223114936
2025-01-07 19:48:53,Fail to pick,194,423,0,0,0,0,0,0,0,0,False,0
2025-01-07 19:48:53,persegiMerah,203,411,127,115,89,55,86,53,3,2,True,0.10107140236111523
2025-01-07 19:48:53,persegiMerah,201,413,127,112,58,4,58,2,0,2,True,0.18237733734400552
2025-01-07 19:48:53,Fail to pick,201,413,0,0,0,0,0,0,0,0,False,0
2025-01-07 19:48:53,persegiMerah,197,417,124,117,113,47,110,43,3,4,True,0.11808710625801476
2025-01-07 19:48:53,Fail to pick,197,417,0,0,0,0,0,0,0,0,False,0
2025-01-07 19:48:54,persegiMerah,197,410,124,116,5,96,5,92,0,4,True,0.4436127584255176
2025-01-07 19:48:54,Fail to pick,197,410,0,0,0,0,0,0,0,0,False,0
2025-01-07 19:48:55,persegiMerah,200,414,124,112,21,90,24,88,3,2,True,0.3814599616711214
2025-01-07 19:48:55,Fail to pick,200,414,0,0,0,0,0,0,0,0,False,0
2025-01-07 19:48:55,persegiMerah,200,417,127,114,36,86,34,89,2,3,True,0.4910568864693162
2025-01-07 19:48:55,Fail to pick,200,417,0,0,0,0,0,0,0,0,False,0
2025-01-07 19:48:55,persegiMerah,200,415,123,113,166,63,166,63,0,0,True,0.16924583811295146
2025-01-07 19:48:55,Fail to pick,200,415,0,0,0,0,0,0,0,0,False,0
2025-01-07 19:48:56,persegiMerah,203,414,126,113,16,81,14,77,2,4,True,0.2904625385087008
2025-01-07 19:48:56,Fail to pick,203,414,0,0,0,0,0,0,0,0,False,0
2025-01-07 19:48:56,persegiMerah,200,415,125,114,172,42,174,46,2,4,True,0.4678981286873217
2025-01-07 19:48:56,Fail to pick,200,415,0,0,0,0,0,0,0,0,False,0
2025-01-07 19:48:56,persegiMerah,199,416,122,114,185,52,184,54,1,2,True,0.4494849870708636
2025-01-07 19:48:56,Fail to pick,199,416,0,0,0,0,0,0,0,0,False,0
2025-01-07 19:48:57,persegiMerah,198,418,124,112,59,22,58,25,1,3,True,0.23460642576898585
2025-01-07 19:48:57,Fail to pick,198,418,0,0,0,0,0,0,0,0,False,0
2025-01-07 19:48:58,persegiMerah,204,417,126,112,29,59,24,62,5,3,True,0.1317767618390062
2025-01-07 19:48:58,Fail to pick,204,417,0,0,0,0,0,0,0,0,False,0
2025-01-07 19:51:17,persegiMerah,228,467,135,131,52,55,55,53,3,2,True,0.393756442712323
2025-01-07 19:51:17,Merah,228,467,tensor(135.7970),tensor(131.3044),70,21,72,24,2,3,True,0.000499725341796875
2025-01-07 19:51:20,persegiMerah,210,412,129,112,101,36,102,37,1,1,True,0.12077756370367076
2025-01-07 19:51:20,Merah,210,412,tensor(129.3492),tensor(112.5721),85,19,88,23,3,4,True,0.0005042552947998047
2025-01-07 19:51:21,persegiMerah,208,411,126,112,117,32,121,33,4,1,True,0.299148139200608
2025-01-07 19:51:21,Fail to pick,208,411,0,0,0,0,0,0,0,0,False,0
2025-01-07 19:51:21,persegiMerah,202,414,123,112,24,85,23,82,1,3,True,0.47687955094691414
2025-01-07 19:51:21,Fail to pick,202,414,0,0,0,0,0,0,0,0,False,0
2025-01-07 19:51:21,persegiMerah,206,414,123,112,11,18,11,21,0,3,True,0.3682148546654239
2025-01-07 19:51:21,Fail to pick,206,414,0,0,0,0,0,0,0,0,False,0
2025-01-07 19:51:21,persegiMerah,204,413,128,112,150,85,145,80,5,5,True,0.38856521025054136
2025-01-07 19:51:21,Fail to pick,204,413,0,0,0,0,0,0,0,0,False,0
2025-01-07 19:51:21,persegiMerah,207,413,125,113,124,88,125,88,1,0,True,0.4058442765504705
2025-01-07 19:51:21,Fail to pick,207,413,0,0,0,0,0,0,0,0,False,0
2025-01-07 19:51:21,persegiMerah,204,410,129,114,173,9,173,13,0,4,False,0.4348373377190101
2025-01-07 19:51:21,Fail to pick,204,410,0,0,0,0,0,0,0,0,False,0
2025-01-07 19:51:21,persegiMerah,206,412,127,114,186,49,190,46,4,3,True,0.21657567127301564
2025-01-07 19:51:21,Fail to pick,206,412,0,0,0,0,0,0,0,0,False,0
2025-01-07 19:51:22,persegiMerah,204,412,128,115,170,31,170,29,0,2,True,0.3857731464180477
2025-01-07 19:51:22,Fail to pick,204,412,0,0,0,0,0,0,0,0,False,0
2025-01-07 19:51:22,persegiMerah,206,411,128,114,142,17,140,18,2,1,True,0.31647145797326537
2025-01-07 19:51:22,Fail to pick,206,411,0,0,0,0,0,0,0,0,False,0
2025-01-07 19:51:22,persegiMerah,205,413,129,113,6,35,5,30,1,5,True,0.36558558768504046
2025-01-07 19:51:22,Fail to pick,205,413,0,0,0,0,0,0,0,0,False,0
2025-01-07 19:51:22,persegiMerah,207,412,128,111,87,33,82,33,5,0,True,0.1955339977683145
2025-01-07 19:51:22,Fail to pick,207,412,0,0,0,0,0,0,0,0,False,0
2025-01-07 19:51:22,persegiMerah,203,414,126,112,62,51,63,50,1,1,True,0.15158633441408087
2025-01-07 19:51:22,Fail to pick,203,414,0,0,0,0,0,0,0,0,False,0
2025-01-07 19:51:22,persegiMerah,203,412,125,111,184,98,185,97,1,1,True,0.4310243259463893
2025-01-07 19:51:22,Fail to pick,203,412,0,0,0,0,0,0,0,0,False,0
2025-01-07 19:51:22,persegiMerah,204,412,129,111,102,61,97,57,5,4,True,0.1717716756330984
2025-01-07 19:51:22,Fail to pick,204,412,0,0,0,0,0,0,0,0,False,0
2025-01-07 19:51:23,persegiMerah,207,410,129,115,16,85,15,86,1,1,True,0.4706608328984262
2025-01-07 19:51:23,Fail to pick,207,410,0,0,0,0,0,0,0,0,False,0
2025-01-07 19:51:23,persegiMerah,201,415,124,113,158,21,162,23,4,2,True,0.2657507233584928
2025-01-07 19:51:23,Fail to pick,201,415,0,0,0,0,0,0,0,0,False,0
2025-01-07 19:51:23,persegiMerah,203,414,127,114,139,4,140,4,1,0,True,0.37837868368070016
2025-01-07 19:51:23,Fail to pick,203,414,0,0,0,0,0,0,0,0,False,0
2025-01-07 19:51:23,persegiMerah,208,410,127,115,129,28,125,24,4,4,True,0.4806739319782144
2025-01-07 19:51:23,Fail to pick,208,410,0,0,0,0,0,0,0,0,False,0
2025-01-07 19:51:24,persegiMerah,201,413,125,111,33,8,37,3,4,5,True,0.4959277137074193
2025-01-07 19:51:24,Fail to pick,201,413,0,0,0,0,0,0,0,0,False,0
2025-01-07 19:51:24,persegiMerah,205,411,127,114,84,73,87,77,3,4,True,0.17769672569669237
2025-01-07 19:51:24,Fail to pick,205,411,0,0,0,0,0,0,0,0,False,0
2025-01-07 19:51:24,persegiMerah,205,409,128,115,136,4,138,8,2,4,True,0.30472633235035573
2025-01-07 19:51:24,Fail to pick,205,409,0,0,0,0,0,0,0,0,False,0
2025-01-07 19:51:24,persegiMerah,198,416,126,112,119,63,122,61,3,2,True,0.38771798943430424
2025-01-07 19:51:24,Fail to pick,198,416,0,0,0,0,0,0,0,0,False,0
2025-01-07 19:51:24,persegiMerah,202,414,124,114,93,34,90,32,3,2,True,0.3482028023585728
2025-01-07 19:51:24,Fail to pick,202,414,0,0,0,0,0,0,0,0,False,0
2025-01-07 19:51:24,persegiMerah,203,412,126,113,64,62,65,66,1,4,False,0.276538708782179
2025-01-07 19:51:24,Fail to pick,203,412,0,0,0,0,0,0,0,0,False,0
2025-01-07 19:51:24,persegiMerah,196,419,124,112,37,92,40,96,3,4,True,0.3681746374271323
2025-01-07 19:51:24,Fail to pick,196,419,0,0,0,0,0,0,0,0,False,0
2025-01-07 19:51:25,persegiMerah,202,414,125,114,22,43,21,42,1,1,False,0.3497617792635166
2025-01-07 19:51:25,Fail to pick,202,414,0,0,0,0,0,0,0,0,False,0
2025-01-07 19:51:25,persegiMerah,198,415,125,115,46,31,42,30,4,1,True,0.14848350737355648
2025-01-07 19:51:25,Fail to pick,198,415,0,0,0,0,0,0,0,0,False,0
2025-01-07 19:51:25,persegiMerah,204,410,129,115,4,21,0,20,4,1,True,0.3766302678856539
2025-01-07 19:51:25,Fail to pick,204,410,0,0,0,0,0,0,0,0,False,0
2025-01-07 19:51:25,persegiMerah,203,417,128,113,172,44,170,40,2,4,True,0.218675667329934
2025-01-07 19:51:25,Fail to pick,203,417,0,0,0,0,0,0,0,0,False,0
2025-01-07 19:51:25,persegiMerah,203,415,126,113,16,90,15,86,1,4,True,0.2990251920409846
2025-01-07 19:51:25,Fail to pick,203,415,0,0,0,0,0,0,0,0,False,0
2025-01-07 19:51:25,persegiMerah,201,416,124,115,125,7,128,4,3,3,True,0.37345646680637834
2025-01-07 19:51:25,Fail to pick,201,416,0,0,0,0,0,0,0,0,False,0
2025-01-07 19:51:26,persegiMerah,199,414,125,113,146,58,146,56,0,2,True,0.37807737978356337
2025-01-07 19:51:26,Fail to pick,199,414,0,0,0,0,0,0,0,0,False,0
2025-01-07 19:51:26,persegiMerah,203,414,129,113,83,40,78,43,5,3,True,0.2572379704663965
2025-01-07 19:51:26,Fail to pick,203,414,0,0,0,0,0,0,0,0,False,0
2025-01-07 19:51:26,persegiMerah,202,415,126,114,112,52,109,55,3,3,False,0.2869352781262141
2025-01-07 19:51:26,Fail to pick,202,415,0,0,0,0,0,0,0,0,False,0
2025-01-07 19:51:26,persegiMerah,203,417,126,112,172,36,172,31,0,5,True,0.17584256068742454
2025-01-07 19:51:26,Fail to pick,203,417,0,0,0,0,0,0,0,0,False,0
2025-01-07 19:51:26,persegiMerah,202,414,126,114,164,45,163,45,1,0,False,0.438108999141792
2025-01-07 19:51:26,Fail to pick,202,414,0,0,0,0,0,0,0,0,False,0
2025-01-07 19:51:27,persegiMerah,205,415,130,113,177,59,174,54,3,5,True,0.33322517420262987
2025-01-07 19:51:27,Fail to pick,205,415,0,0,0,0,0,0,0,0,False,0
2025-01-07 19:51:27,persegiMerah,203,416,127,113,198,85,195,84,3,1,True,0.25614703870147887
2025-01-07 19:51:27,Fail to pick,203,416,0,0,0,0,0,0,0,0,False,0
2025-01-07 19:51:27,persegiMerah,198,415,126,113,193,28,194,26,1,2,True,0.3412700071807083
2025-01-07 19:51:27,Fail to pick,198,415,0,0,0,0,0,0,0,0,False,0
2025-01-07 19:51:28,persegiMerah,202,413,129,112,50,2,52,5,2,3,True,0.2297815054067666
2025-01-07 19:51:28,Fail to pick,202,413,0,0,0,0,0,0,0,0,False,0
2025-01-07 19:51:28,persegiMerah,198,419,124,112,110,80,108,80,2,0,True,0.2989889839908835
2025-01-07 19:51:28,Fail to pick,198,419,0,0,0,0,0,0,0,0,False,0
2025-01-07 19:51:28,persegiMerah,212,411,122,114,119,97,121,101,2,4,True,0.2434271296357412
2025-01-07 19:51:28,persegiMerah,206,412,128,114,152,96,153,100,1,4,True,0.2155173911081743
2025-01-07 19:51:28,Fail to pick,206,412,0,0,0,0,0,0,0,0,False,0
2025-01-07 19:51:29,persegiMerah,199,420,123,113,162,33,161,33,1,0,True,0.4201575240726153
2025-01-07 19:51:29,Fail to pick,199,420,0,0,0,0,0,0,0,0,False,0
2025-01-07 19:51:29,persegiMerah,200,414,125,112,159,79,162,82,3,3,True,0.2626499610877421
2025-01-07 19:51:29,Fail to pick,200,414,0,0,0,0,0,0,0,0,False,0
2025-01-07 19:51:29,persegiMerah,202,415,126,113,50,23,51,25,1,2,True,0.16461064883212534
2025-01-07 19:51:29,Fail to pick,202,415,0,0,0,0,0,0,0,0,False,0
2025-01-07 19:51:29,persegiMerah,202,415,126,114,86,73,89,73,3,0,True,0.43867977341861975
2025-01-07 19:51:29,Fail to pick,202,415,0,0,0,0,0,0,0,0,False,0
2025-01-07 19:51:29,persegiMerah,207,414,123,113,197,71,197,69,0,2,True,0.23407123457685872
2025-01-07 19:51:29,Fail to pick,207,414,0,0,0,0,0,0,0,0,False,0
2025-01-07 19:51:29,persegiMerah,200,414,127,113,155,46,154,44,1,2,False,0.4888585711514556
2025-01-07 19:51:29,Fail to pick,200,414,0,0,0,0,0,0,0,0,False,0
2025-01-07 19:51:30,persegiMerah,203,414,126,115,81,96,81,100,0,4,True,0.48442715195613995
2025-01-07 19:51:30,Fail to pick,203,414,0,0,0,0,0,0,0,0,False,0
2025-01-07 19:51:30,persegiMerah,201,416,125,115,82,34,80,32,2,2,False,0.2676021440641899
2025-01-07 19:51:30,Fail to pick,201,416,0,0,0,0,0,0,0,0,False,0
2025-01-07 19:51:30,persegiMerah,204,414,127,114,12,92,12,91,0,1,True,0.4150159653064558
2025-01-07 19:51:30,Fail to pick,204,414,0,0,0,0,0,0,0,0,False,0
2025-01-07 19:51:30,persegiMerah,203,415,126,115,15,81,11,77,4,4,True,0.34396864051421927
2025-01-07 19:51:30,Fail to pick,203,415,0,0,0,0,0,0,0,0,False,0
2025-01-07 19:51:30,persegiMerah,203,415,127,114,78,83,76,84,2,1,True,0.1932392571159099
2025-01-07 19:51:30,Fail to pick,203,415,0,0,0,0,0,0,0,0,False,0
2025-01-07 19:51:30,persegiMerah,202,416,127,114,52,61,56,61,4,0,True,0.14725349465587573
2025-01-07 19:51:30,Fail to pick,202,416,0,0,0,0,0,0,0,0,False,0
2025-01-07 19:51:31,persegiMerah,203,412,128,111,188,66,187,68,1,2,True,0.1397629122965507
2025-01-07 19:51:31,Fail to pick,203,412,0,0,0,0,0,0,0,0,False,0
2025-01-07 19:51:31,persegiMerah,209,411,126,113,61,19,59,22,2,3,False,0.1938424769779891
2025-01-07 19:51:31,Fail to pick,209,411,0,0,0,0,0,0,0,0,False,0
2025-01-07 19:51:31,persegiMerah,210,412,125,113,110,47,111,49,1,2,True,0.30283293248824283
2025-01-07 19:51:31,Fail to pick,210,412,0,0,0,0,0,0,0,0,False,0
2025-01-07 19:51:31,persegiMerah,207,413,126,113,140,78,138,75,2,3,True,0.3039834927561272
2025-01-07 19:51:31,Fail to pick,207,413,0,0,0,0,0,0,0,0,False,0
2025-01-07 19:51:31,persegiMerah,208,413,129,113,121,38,121,42,0,4,True,0.14166610672344593
2025-01-07 19:51:31,Fail to pick,208,413,0,0,0,0,0,0,0,0,False,0
2025-01-07 19:51:31,persegiMerah,206,411,129,114,133,54,130,52,3,2,False,0.45085659431935043
2025-01-07 19:51:31,Fail to pick,206,411,0,0,0,0,0,0,0,0,False,0
2025-01-07 19:51:32,persegiMerah,205,412,131,112,56,74,58,73,2,1,True,0.12164379716903234
2025-01-07 19:51:32,Fail to pick,205,412,0,0,0,0,0,0,0,0,False,0
2025-01-07 19:51:32,persegiMerah,205,415,130,112,152,85,147,87,5,2,True,0.3516833693752033
2025-01-07 19:51:32,Fail to pick,205,415,0,0,0,0,0,0,0,0,False,0
2025-01-07 19:51:32,persegiMerah,209,414,126,115,42,84,41,79,1,5,True,0.4549050069228039
2025-01-07 19:51:32,Fail to pick,209,414,0,0,0,0,0,0,0,0,False,0
2025-01-07 19:51:32,persegiMerah,209,410,126,114,150,84,147,85,3,1,True,0.32427477820682393
2025-01-07 19:51:32,Fail to pick,209,410,0,0,0,0,0,0,0,0,False,0
2025-01-07 19:51:32,persegiMerah,204,417,128,115,42,78,37,80,5,2,True,0.14599145849156037
2025-01-07 19:51:32,Fail to pick,204,417,0,0,0,0,0,0,0,0,False,0
2025-01-07 19:51:32,persegiMerah,198,417,123,116,107,67,106,68,1,1,True,0.1620159034463749
2025-01-07 19:51:32,Fail to pick,198,417,0,0,0,0,0,0,0,0,False,0
2025-01-07 19:51:32,persegiMerah,205,411,128,113,50,78,54,78,4,0,True,0.11785067725739595
2025-01-07 19:51:32,Fail to pick,205,411,0,0,0,0,0,0,0,0,False,0
2025-01-07 19:51:33,persegiMerah,193,409,127,116,68,33,69,33,1,0,True,0.47980362475045735
2025-01-07 19:51:33,persegiMerah,196,407,124,119,48,74,52,74,4,0,True,0.2566135324916821
2025-01-07 19:51:33,Fail to pick,196,407,0,0,0,0,0,0,0,0,False,0
2025-01-07 19:51:33,persegiMerah,195,408,125,117,148,75,149,77,1,2,True,0.18197583957051466
2025-01-07 19:51:33,Fail to pick,195,408,0,0,0,0,0,0,0,0,False,0
2025-01-07 19:51:33,persegiMerah,203,415,127,114,96,74,97,78,1,4,True,0.39334168517453294
2025-01-07 19:51:33,Fail to pick,203,415,0,0,0,0,0,0,0,0,False,0
2025-01-07 19:51:33,persegiMerah,204,412,127,114,139,46,139,41,0,5,True,0.12213102448707809
2025-01-07 19:51:33,Fail to pick,204,412,0,0,0,0,0,0,0,0,False,0
2025-01-07 19:51:33,persegiMerah,201,416,129,116,124,1,123,-3,1,4,True,0.4028070663011746
2025-01-07 19:51:33,Fail to pick,201,416,0,0,0,0,0,0,0,0,False,0
2025-01-07 19:51:34,persegiMerah,207,412,128,114,58,33,55,37,3,4,True,0.34061052692855315
2025-01-07 19:51:34,Fail to pick,207,412,0,0,0,0,0,0,0,0,False,0
2025-01-07 19:51:34,persegiMerah,206,410,129,116,38,46,37,43,1,3,True,0.11448955408824008
2025-01-07 19:51:34,Fail to pick,206,410,0,0,0,0,0,0,0,0,False,0
2025-01-07 19:51:34,persegiMerah,196,417,127,117,5,92,4,96,1,4,False,0.4126406573197755
2025-01-07 19:51:34,persegiMerah,214,407,127,117,63,85,58,88,5,3,True,0.40688129986283816
2025-01-07 19:51:34,persegiMerah,207,410,127,115,38,14,34,11,4,3,False,0.1578614117723363
2025-01-07 19:51:34,Fail to pick,207,410,0,0,0,0,0,0,0,0,False,0
2025-01-07 19:51:34,persegiMerah,207,412,130,113,56,51,59,51,3,0,True,0.44093163214078557
2025-01-07 19:51:34,Fail to pick,207,412,0,0,0,0,0,0,0,0,False,0
2025-01-07 19:51:34,persegiMerah,205,412,128,114,3,50,0,53,3,3,True,0.11444755634603064
2025-01-07 19:51:34,Fail to pick,205,412,0,0,0,0,0,0,0,0,False,0
2025-01-07 19:51:35,persegiMerah,205,411,127,114,51,85,51,86,0,1,True,0.11328004676443251
2025-01-07 19:51:35,Fail to pick,205,411,0,0,0,0,0,0,0,0,False,0
2025-01-07 19:51:35,persegiMerah,202,410,126,114,50,0,49,-2,1,2,True,0.10973358773141113
2025-01-07 19:51:35,Fail to pick,202,410,0,0,0,0,0,0,0,0,False,0
2025-01-07 19:51:35,persegiMerah,205,414,129,114,198,7,202,3,4,4,True,0.22347065243860031
2025-01-07 19:51:35,Fail to pick,205,414,0,0,0,0,0,0,0,0,False,0
2025-01-07 19:51:35,persegiMerah,201,412,126,114,107,43,107,38,0,5,True,0.14055161122885731
2025-01-07 19:51:35,Fail to pick,201,412,0,0,0,0,0,0,0,0,False,0
2025-01-07 19:51:35,persegiMerah,198,412,126,114,158,89,154,92,4,3,True,0.19799811112042065
2025-01-07 19:51:35,Fail to pick,198,412,0,0,0,0,0,0,0,0,False,0
2025-01-07 19:51:35,persegiMerah,203,410,129,115,83,14,86,10,3,4,True,0.4494404287515351
2025-01-07 19:51:35,Fail to pick,203,410,0,0,0,0,0,0,0,0,False,0
2025-01-07 19:51:35,persegiMerah,205,410,130,116,161,50,162,47,1,3,True,0.38434177045170037
2025-01-07 19:51:35,Fail to pick,205,410,0,0,0,0,0,0,0,0,False,0
2025-01-07 19:51:35,persegiMerah,202,414,126,115,168,91,166,88,2,3,True,0.21561190602227157
2025-01-07 19:51:35,Fail to pick,202,414,0,0,0,0,0,0,0,0,False,0
2025-01-07 19:51:36,persegiMerah,203,413,128,114,132,84,130,86,2,2,True,0.36822311212115355
2025-01-07 19:51:36,Fail to pick,203,413,0,0,0,0,0,0,0,0,False,0
2025-01-07 19:51:36,persegiMerah,205,410,130,116,22,81,23,85,1,4,True,0.46500869536898704
2025-01-07 19:51:36,Fail to pick,205,410,0,0,0,0,0,0,0,0,False,0
2025-01-07 19:51:37,persegiMerah,184,566,131,115,191,5,189,6,2,1,True,0.41812806243911393
2025-01-07 19:51:37,Merah,184,566,tensor(131.4993),tensor(115.7650),42,17,37,14,5,3,True,0.0
2025-01-07 19:51:37,persegiMerah,194,557,132,117,198,37,194,37,4,0,True,0.48875272056621144
2025-01-07 19:51:37,persegiMerah,187,564,130,114,35,38,36,33,1,5,True,0.30786129642778315
2025-01-07 19:51:37,persegiBiru,188,564,129,113,157,49,159,49,2,0,True,0.36773195675519244
2025-01-07 19:51:37,Fail to pick,187,564,0,0,0,0,0,0,0,0,False,0
2025-01-07 19:51:37,Fail to pick,188,564,0,0,0,0,0,0,0,0,False,0
2025-01-07 19:51:37,persegiMerah,183,565,128,115,137,92,134,88,3,4,True,0.1613336359833759
2025-01-07 19:51:37,Fail to pick,183,565,0,0,0,0,0,0,0,0,False,0
2025-01-07 19:51:37,persegiMerah,183,563,128,113,63,31,61,28,2,3,True,0.1921159801536211
2025-01-07 19:51:37,Fail to pick,183,563,0,0,0,0,0,0,0,0,False,0
2025-01-07 19:51:37,persegiMerah,189,564,131,113,170,2,171,4,1,2,True,0.1524455200530715
2025-01-07 19:51:37,Fail to pick,189,564,0,0,0,0,0,0,0,0,False,0
2025-01-07 19:51:38,persegiMerah,183,560,129,113,179,76,183,71,4,5,True,0.44179975760792367
2025-01-07 19:51:38,Fail to pick,183,560,0,0,0,0,0,0,0,0,False,0
2025-01-07 19:51:38,persegiMerah,184,562,126,114,159,55,158,51,1,4,True,0.11648186107990971
2025-01-07 19:51:38,Fail to pick,184,562,0,0,0,0,0,0,0,0,False,0
2025-01-07 19:51:38,persegiMerah,182,562,128,113,195,9,196,4,1,5,True,0.32480525609723887
2025-01-07 19:51:38,Fail to pick,182,562,0,0,0,0,0,0,0,0,False,0
2025-01-07 19:51:38,persegiMerah,186,564,129,113,47,16,46,16,1,0,True,0.13158022496439098
2025-01-07 19:51:38,Fail to pick,186,564,0,0,0,0,0,0,0,0,False,0
2025-01-07 19:51:38,persegiMerah,185,564,130,114,79,29,75,24,4,5,True,0.2587515112349859
2025-01-07 19:51:38,Fail to pick,185,564,0,0,0,0,0,0,0,0,False,0
2025-01-07 19:51:41,persegiMerah,264,62,124,124,71,58,73,60,2,2,True,0.25686324871768185
2025-01-07 19:51:41,Merah,264,62,tensor(124.4401),tensor(124.0600),182,24,180,27,2,3,True,0.0004987716674804688
2025-01-07 19:51:41,persegiMerah,251,61,128,122,94,47,91,47,3,0,True,0.37454698298091527
2025-01-07 19:51:41,persegiMerah,256,64,125,129,51,73,48,75,3,2,True,0.18510282527890626
2025-01-07 19:51:41,Fail to pick,256,64,0,0,0,0,0,0,0,0,False,0
2025-01-07 19:51:41,persegiMerah,244,65,128,129,38,28,33,26,5,2,True,0.33507658122546624
2025-01-07 19:51:41,persegiMerah,260,63,128,127,123,29,126,28,3,1,True,0.4695614019778892
2025-01-07 19:51:41,persegiMerah,258,63,129,126,156,56,160,53,4,3,True,0.13056208951543802
2025-01-07 19:51:41,Fail to pick,258,63,0,0,0,0,0,0,0,0,False,0
2025-01-07 19:51:41,persegiMerah,256,63,129,127,198,60,199,64,1,4,True,0.1763592747668791
2025-01-07 19:51:41,Fail to pick,256,63,0,0,0,0,0,0,0,0,False,0
2025-01-07 19:51:41,persegiMerah,260,61,131,123,105,47,105,43,0,4,False,0.18615780974325952
2025-01-07 19:51:41,Fail to pick,260,61,0,0,0,0,0,0,0,0,False,0
2025-01-07 19:51:42,persegiMerah,251,65,125,128,66,41,63,41,3,0,False,0.3531877993006345
2025-01-07 19:51:42,Fail to pick,251,65,0,0,0,0,0,0,0,0,False,0
2025-01-07 19:51:42,persegiMerah,251,63,125,126,172,86,173,86,1,0,True,0.305804818905278
2025-01-07 19:51:42,Fail to pick,251,63,0,0,0,0,0,0,0,0,False,0
2025-01-07 19:51:42,persegiMerah,248,63,126,127,124,30,125,29,1,1,True,0.21006060016919254
2025-01-07 19:51:42,Fail to pick,248,63,0,0,0,0,0,0,0,0,False,0
2025-01-07 19:51:42,persegiMerah,248,71,126,130,41,69,45,70,4,1,True,0.224322724718249
2025-01-07 19:51:42,Fail to pick,248,71,0,0,0,0,0,0,0,0,False,0
2025-01-07 19:51:42,persegiMerah,250,67,123,129,122,57,120,56,2,1,True,0.32850100021068906
2025-01-07 19:51:42,Fail to pick,250,67,0,0,0,0,0,0,0,0,False,0
2025-01-07 19:51:42,persegiMerah,259,65,128,128,199,50,202,52,3,2,True,0.20121627743964945
2025-01-07 19:51:42,Fail to pick,259,65,0,0,0,0,0,0,0,0,False,0
2025-01-07 19:51:42,persegiMerah,246,75,129,130,30,42,30,39,0,3,True,0.22229454298708703
2025-01-07 19:51:43,persegiMerah,257,65,127,128,21,56,24,51,3,5,True,0.34832332600780835
2025-01-07 19:51:43,persegiMerah,244,67,129,130,77,83,75,82,2,1,True,0.20029336120295663
2025-01-07 19:51:43,persegiMerah,247,70,131,131,170,91,171,86,1,5,True,0.2184308663283667
2025-01-07 19:51:43,Fail to pick,247,70,0,0,0,0,0,0,0,0,False,0
2025-01-07 19:51:43,persegiMerah,245,69,129,130,197,50,200,51,3,1,True,0.2690548146495407
2025-01-07 19:51:43,Fail to pick,245,69,0,0,0,0,0,0,0,0,False,0
2025-01-07 19:51:43,persegiMerah,251,69,130,131,85,87,82,89,3,2,True,0.4820944525355483
2025-01-07 19:51:43,Fail to pick,251,69,0,0,0,0,0,0,0,0,False,0
2025-01-07 19:51:43,persegiMerah,247,65,128,129,16,5,12,5,4,0,True,0.12379817503881108
2025-01-07 19:51:43,Fail to pick,247,65,0,0,0,0,0,0,0,0,False,0
2025-01-07 19:51:43,persegiMerah,252,64,126,128,168,39,168,37,0,2,True,0.3320288974761929
2025-01-07 19:51:43,Fail to pick,252,64,0,0,0,0,0,0,0,0,False,0
2025-01-07 19:51:43,persegiMerah,246,69,131,132,18,20,13,16,5,4,True,0.11910762667630759
2025-01-07 19:51:43,Fail to pick,246,69,0,0,0,0,0,0,0,0,False,0
2025-01-07 19:51:44,persegiMerah,247,67,130,131,63,59,59,63,4,4,True,0.19998091360004155
2025-01-07 19:51:44,Fail to pick,247,67,0,0,0,0,0,0,0,0,False,0
2025-01-07 19:51:44,persegiMerah,249,66,125,130,193,31,189,33,4,2,False,0.2502348653716644
2025-01-07 19:51:44,Fail to pick,249,66,0,0,0,0,0,0,0,0,False,0
2025-01-07 19:51:44,persegiMerah,246,66,130,129,38,96,42,96,4,0,True,0.305910487449089
2025-01-07 19:51:44,Fail to pick,246,66,0,0,0,0,0,0,0,0,False,0
2025-01-07 19:51:44,persegiMerah,245,69,131,132,65,86,62,82,3,4,True,0.41481668622057566
2025-01-07 19:51:44,Fail to pick,245,69,0,0,0,0,0,0,0,0,False,0
2025-01-07 19:51:44,persegiMerah,248,66,130,130,179,0,181,1,2,1,True,0.3251778601877951
2025-01-07 19:51:44,Fail to pick,248,66,0,0,0,0,0,0,0,0,False,0
2025-01-07 19:51:44,persegiMerah,248,65,132,129,4,66,7,70,3,4,True,0.384318659828222
2025-01-07 19:51:44,Fail to pick,248,65,0,0,0,0,0,0,0,0,False,0
2025-01-07 19:51:45,persegiMerah,242,69,126,130,144,22,142,21,2,1,True,0.3087202832469552
2025-01-07 19:51:45,Fail to pick,242,69,0,0,0,0,0,0,0,0,False,0
2025-01-07 19:51:45,persegiMerah,247,67,130,132,73,26,69,27,4,1,True,0.4869378649426723
2025-01-07 19:51:45,Fail to pick,247,67,0,0,0,0,0,0,0,0,False,0
2025-01-07 19:51:45,persegiMerah,247,68,128,130,127,18,124,16,3,2,True,0.26016327584752064
2025-01-07 19:51:45,Fail to pick,247,68,0,0,0,0,0,0,0,0,False,0
2025-01-07 19:51:45,persegiMerah,253,70,129,132,176,74,180,70,4,4,True,0.47319556380380345
2025-01-07 19:51:45,Fail to pick,253,70,0,0,0,0,0,0,0,0,False,0
2025-01-07 19:51:45,persegiMerah,245,68,127,131,33,77,34,75,1,2,True,0.4973165966444292
2025-01-07 19:51:45,Fail to pick,245,68,0,0,0,0,0,0,0,0,False,0
2025-01-07 19:51:45,persegiMerah,254,66,127,130,134,85,130,80,4,5,True,0.3100087303048197
2025-01-07 19:51:45,Fail to pick,254,66,0,0,0,0,0,0,0,0,False,0
2025-01-07 19:51:46,persegiMerah,250,67,126,129,173,20,171,15,2,5,True,0.3989106685449505
2025-01-07 19:51:46,Fail to pick,250,67,0,0,0,0,0,0,0,0,False,0
2025-01-07 19:51:46,persegiMerah,248,67,128,131,32,49,29,52,3,3,True,0.14520239605013982
2025-01-07 19:51:46,Fail to pick,248,67,0,0,0,0,0,0,0,0,False,0
2025-01-07 19:51:46,persegiMerah,248,66,131,129,4,72,4,70,0,2,True,0.3895824862219418
2025-01-07 19:51:46,Fail to pick,248,66,0,0,0,0,0,0,0,0,False,0
2025-01-07 19:51:46,persegiMerah,240,70,126,132,79,50,83,50,4,0,False,0.2889355118184548
2025-01-07 19:51:46,Fail to pick,240,70,0,0,0,0,0,0,0,0,False,0
2025-01-07 19:51:46,persegiMerah,247,66,128,129,67,36,70,37,3,1,False,0.21252689064095437
2025-01-07 19:51:46,Fail to pick,247,66,0,0,0,0,0,0,0,0,False,0
2025-01-07 19:51:46,persegiMerah,245,66,130,130,149,53,151,52,2,1,True,0.16691886659368682
2025-01-07 19:51:46,Fail to pick,245,66,0,0,0,0,0,0,0,0,False,0
2025-01-07 19:51:47,persegiMerah,396,260,133,133,148,15,148,10,0,5,True,0.13526317873460636
2025-01-07 19:51:47,Merah,396,260,tensor(133.3359),tensor(133.5974),127,36,125,35,2,1,True,0.0
2025-01-07 19:51:47,persegiMerah,397,257,132,136,93,43,88,39,5,4,False,0.34039693957030376
2025-01-07 19:51:47,Fail to pick,397,257,0,0,0,0,0,0,0,0,False,0
2025-01-07 19:51:47,persegiMerah,396,261,132,133,26,4,28,2,2,2,True,0.4690289176754959
2025-01-07 19:51:47,Fail to pick,396,261,0,0,0,0,0,0,0,0,False,0
2025-01-07 19:51:48,persegiMerah,396,261,133,134,146,90,142,87,4,3,True,0.33717762582404376
2025-01-07 19:51:48,Fail to pick,396,261,0,0,0,0,0,0,0,0,False,0
2025-01-07 19:51:48,persegiMerah,397,258,133,133,29,4,29,0,0,4,True,0.3805434940567094
2025-01-07 19:51:48,Fail to pick,397,258,0,0,0,0,0,0,0,0,False,0
2025-01-07 19:51:48,persegiMerah,405,260,134,133,161,99,160,99,1,0,True,0.34098486194463506
2025-01-07 19:51:48,Fail to pick,405,260,0,0,0,0,0,0,0,0,False,0
2025-01-07 19:51:48,persegiMerah,398,262,134,132,112,25,109,24,3,1,True,0.3103977672863748
2025-01-07 19:51:48,Fail to pick,398,262,0,0,0,0,0,0,0,0,False,0
2025-01-07 19:51:48,persegiMerah,392,262,135,130,79,29,76,25,3,4,True,0.2949258293356659
2025-01-07 19:51:48,Fail to pick,392,262,0,0,0,0,0,0,0,0,False,0
2025-01-07 19:51:49,persegiMerah,392,262,136,133,69,18,68,15,1,3,True,0.38311409477834046
2025-01-07 19:51:49,Fail to pick,392,262,0,0,0,0,0,0,0,0,False,0
2025-01-07 19:51:49,persegiMerah,394,257,132,132,28,90,23,92,5,2,True,0.4496533052234729
2025-01-07 19:51:49,Fail to pick,394,257,0,0,0,0,0,0,0,0,False,0
2025-01-07 19:51:49,persegiMerah,394,263,132,130,176,30,172,33,4,3,True,0.3181877424063831
2025-01-07 19:51:49,Fail to pick,394,263,0,0,0,0,0,0,0,0,False,0
2025-01-07 19:51:49,persegiMerah,394,262,134,130,95,47,91,48,4,1,True,0.4728275970024646
2025-01-07 19:51:49,Fail to pick,394,262,0,0,0,0,0,0,0,0,False,0
2025-01-07 19:51:50,persegiMerah,397,262,136,129,46,62,50,60,4,2,True,0.33793972724749344
2025-01-07 19:51:50,Fail to pick,397,262,0,0,0,0,0,0,0,0,False,0
2025-01-07 19:51:50,persegiMerah,397,252,131,128,138,52,140,55,2,3,True,0.3227212408004848
2025-01-07 19:51:50,persegiMerah,393,257,133,129,75,62,75,60,0,2,True,0.38619558578048774
2025-01-07 19:51:50,Fail to pick,393,257,0,0,0,0,0,0,0,0,False,0
2025-01-07 19:51:50,persegiMerah,399,261,133,131,190,81,191,78,1,3,True,0.10375916137085905
2025-01-07 19:51:50,Fail to pick,399,261,0,0,0,0,0,0,0,0,False,0
2025-01-07 19:51:50,persegiMerah,398,258,132,131,97,48,101,43,4,5,True,0.40221652821219067
2025-01-07 19:51:50,Fail to pick,398,258,0,0,0,0,0,0,0,0,False,0
2025-01-07 19:51:51,persegiMerah,398,258,135,131,137,84,133,85,4,1,True,0.31144654841715136
2025-01-07 19:51:51,Fail to pick,398,258,0,0,0,0,0,0,0,0,False,0
2025-01-07 19:51:51,persegiMerah,398,262,135,131,29,15,24,18,5,3,True,0.14342438375567626
2025-01-07 19:51:51,Fail to pick,398,262,0,0,0,0,0,0,0,0,False,0
2025-01-07 19:51:51,persegiMerah,396,257,133,132,81,67,78,66,3,1,True,0.20059297750765023
2025-01-07 19:51:51,Fail to pick,396,257,0,0,0,0,0,0,0,0,False,0
2025-01-07 19:51:51,persegiMerah,393,259,132,132,54,56,54,55,0,1,True,0.20845914701616552
2025-01-07 19:51:51,Fail to pick,393,259,0,0,0,0,0,0,0,0,False,0
2025-01-07 19:51:52,persegiMerah,399,260,133,133,81,3,83,-2,2,5,True,0.4551405579126042
2025-01-07 19:51:52,Fail to pick,399,260,0,0,0,0,0,0,0,0,False,0
2025-01-07 19:51:52,persegiMerah,393,265,135,133,196,21,197,18,1,3,True,0.2065978053464026
2025-01-07 19:51:52,Fail to pick,393,265,0,0,0,0,0,0,0,0,False,0
2025-01-07 19:51:52,persegiMerah,392,265,137,132,139,94,138,96,1,2,True,0.41144198786302266
2025-01-07 19:51:52,Fail to pick,392,265,0,0,0,0,0,0,0,0,False,0
2025-01-07 19:51:52,persegiMerah,397,264,135,132,92,8,94,7,2,1,True,0.12317209003121349
2025-01-07 19:51:52,Fail to pick,397,264,0,0,0,0,0,0,0,0,False,0
2025-01-07 19:51:53,persegiMerah,394,263,137,132,167,69,166,71,1,2,True,0.2402300383180742
2025-01-07 19:51:53,Fail to pick,394,263,0,0,0,0,0,0,0,0,False,0
2025-01-07 19:51:53,persegiMerah,394,266,135,132,197,28,201,24,4,4,True,0.21518256427168347
2025-01-07 19:51:53,Fail to pick,394,266,0,0,0,0,0,0,0,0,False,0
2025-01-07 19:51:53,persegiMerah,396,263,135,131,183,56,184,54,1,2,True,0.11923226716007324
2025-01-07 19:51:53,Fail to pick,396,263,0,0,0,0,0,0,0,0,False,0
2025-01-07 19:51:53,persegiMerah,395,263,136,131,165,90,162,89,3,1,True,0.23366642367959584
2025-01-07 19:51:53,Fail to pick,395,263,0,0,0,0,0,0,0,0,False,0
2025-01-07 19:51:54,persegiMerah,404,260,135,132,93,82,88,83,5,1,False,0.24236133648643096
2025-01-07 19:51:54,Fail to pick,404,260,0,0,0,0,0,0,0,0,False,0
2025-01-07 19:51:54,persegiMerah,395,264,134,131,164,75,167,79,3,4,True,0.45332746844000926
2025-01-07 19:51:54,Fail to pick,395,264,0,0,0,0,0,0,0,0,False,0
2025-01-07 19:51:54,persegiMerah,398,262,133,131,85,34,83,31,2,3,True,0.4829441994867194
2025-01-07 19:51:54,Fail to pick,398,262,0,0,0,0,0,0,0,0,False,0
2025-01-07 19:51:54,persegiMerah,392,265,135,132,105,34,100,29,5,5,True,0.20527178676979482
2025-01-07 19:51:54,Fail to pick,392,265,0,0,0,0,0,0,0,0,False,0
2025-01-07 19:51:55,persegiMerah,401,261,134,131,38,40,35,44,3,4,True,0.44806498886639945
2025-01-07 19:51:55,Fail to pick,401,261,0,0,0,0,0,0,0,0,False,0
2025-01-07 19:51:55,persegiMerah,400,260,134,132,167,11,171,9,4,2,False,0.22845069723368125
2025-01-07 19:51:55,Fail to pick,400,260,0,0,0,0,0,0,0,0,False,0
2025-01-07 19:51:55,persegiMerah,398,261,134,132,75,41,70,40,5,1,True,0.22885391213122697
2025-01-07 19:51:55,Fail to pick,398,261,0,0,0,0,0,0,0,0,False,0
2025-01-07 19:51:55,persegiMerah,399,260,134,129,18,41,21,41,3,0,True,0.3531611029678021
2025-01-07 19:51:55,Fail to pick,399,260,0,0,0,0,0,0,0,0,False,0
2025-01-07 19:51:56,persegiMerah,398,262,134,130,131,87,126,88,5,1,True,0.3751795454394218
2025-01-07 19:51:56,Fail to pick,398,262,0,0,0,0,0,0,0,0,False,0
2025-01-07 19:51:56,persegiMerah,398,261,132,131,185,81,188,82,3,1,True,0.3802790443211139
2025-01-07 19:51:56,Fail to pick,398,261,0,0,0,0,0,0,0,0,False,0
2025-01-07 19:51:56,persegiMerah,400,258,131,131,148,72,150,75,2,3,True,0.40479135282167733
2025-01-07 19:51:56,Fail to pick,400,258,0,0,0,0,0,0,0,0,False,0
2025-01-07 19:51:56,persegiMerah,395,260,133,132,48,96,50,91,2,5,True,0.45179243858989804
2025-01-07 19:51:56,Fail to pick,395,260,0,0,0,0,0,0,0,0,False,0
2025-01-07 19:51:57,persegiMerah,392,260,135,132,21,56,19,55,2,1,True,0.18879890608962124
2025-01-07 19:51:57,Fail to pick,392,260,0,0,0,0,0,0,0,0,False,0
2025-01-07 19:51:57,persegiMerah,392,260,137,131,122,73,125,71,3,2,True,0.3466599076300203
2025-01-07 19:51:57,Fail to pick,392,260,0,0,0,0,0,0,0,0,False,0
2025-01-07 19:51:57,persegiMerah,397,259,133,132,111,5,111,3,0,2,True,0.4693450547028476
2025-01-07 19:51:57,Fail to pick,397,259,0,0,0,0,0,0,0,0,False,0
2025-01-07 19:51:57,persegiMerah,392,262,137,131,149,83,153,86,4,3,True,0.38900666906485415
2025-01-07 19:51:57,Fail to pick,392,262,0,0,0,0,0,0,0,0,False,0
2025-01-07 19:51:57,persegiMerah,397,259,133,132,154,25,151,22,3,3,False,0.4091339892375736
2025-01-07 19:51:57,Fail to pick,397,259,0,0,0,0,0,0,0,0,False,0
2025-01-07 19:51:57,persegiMerah,401,259,136,131,89,30,88,28,1,2,True,0.2878130512871293
2025-01-07 19:51:57,Fail to pick,401,259,0,0,0,0,0,0,0,0,False,0
2025-01-07 19:51:57,persegiMerah,401,261,133,130,184,69,179,73,5,4,True,0.4139408967765119
2025-01-07 19:51:57,Fail to pick,401,261,0,0,0,0,0,0,0,0,False,0
2025-01-07 19:51:57,persegiMerah,404,259,135,133,94,40,98,44,4,4,True,0.4799110033918589
2025-01-07 19:51:57,Fail to pick,404,259,0,0,0,0,0,0,0,0,False,0
2025-01-07 19:54:52,persegiMerah,426,260,134,139,195,12,190,14,5,2,False,0.29688981996103225
2025-01-07 19:54:52,Merah,426,260,tensor(134.3522),tensor(139.6644),127,39,131,38,4,1,True,0.0
2025-01-07 19:54:52,persegiMerah,221,303,134,136,86,32,89,33,3,1,True,0.14662622402149614
2025-01-07 19:54:52,persegiMerah,224,305,132,133,164,53,159,50,5,3,True,0.2321947523127292
2025-01-07 19:54:52,Fail to pick,224,305,0,0,0,0,0,0,0,0,False,0
2025-01-07 19:54:52,persegiMerah,220,307,130,130,144,89,148,85,4,4,True,0.3892399512358059
2025-01-07 19:54:52,Fail to pick,220,307,0,0,0,0,0,0,0,0,False,0
2025-01-07 19:54:52,persegiMerah,220,308,129,130,98,38,98,36,0,2,True,0.13317371591627125
2025-01-07 19:54:52,Fail to pick,220,308,0,0,0,0,0,0,0,0,False,0
2025-01-07 19:54:52,persegiMerah,248,294,137,133,101,21,103,24,2,3,True,0.15131128994195409
2025-01-07 19:54:52,persegiMerah,247,292,137,133,157,62,154,59,3,3,True,0.2473976237142566
2025-01-07 19:54:52,Fail to pick,247,292,0,0,0,0,0,0,0,0,False,0
2025-01-07 19:54:53,persegiMerah,248,286,138,132,53,2,50,3,3,1,True,0.333163749482696
2025-01-07 19:54:53,Fail to pick,248,286,0,0,0,0,0,0,0,0,False,0
2025-01-07 19:54:53,persegiMerah,250,287,138,131,99,94,101,95,2,1,True,0.25558515325843667
2025-01-07 19:54:53,Fail to pick,250,287,0,0,0,0,0,0,0,0,False,0
2025-01-07 19:54:53,persegiMerah,249,287,137,130,181,80,181,76,0,4,False,0.41121362475582013
2025-01-07 19:54:53,Fail to pick,249,287,0,0,0,0,0,0,0,0,False,0
2025-01-07 19:54:53,persegiMerah,222,305,128,130,86,15,82,11,4,4,True,0.2849401976073463
2025-01-07 19:54:53,persegiMerah,248,288,136,129,131,7,126,4,5,3,True,0.4459431320506235
2025-01-07 19:54:53,persegiMerah,249,290,138,130,87,20,90,22,3,2,True,0.14638683056543675
2025-01-07 19:54:53,Fail to pick,249,290,0,0,0,0,0,0,0,0,False,0
2025-01-07 19:54:54,persegiMerah,247,291,136,133,22,90,18,87,4,3,True,0.2848284888787812
2025-01-07 19:54:54,Fail to pick,247,291,0,0,0,0,0,0,0,0,False,0
2025-01-07 19:54:54,persegiMerah,250,291,138,130,89,6,91,1,2,5,False,0.2018913139944547
2025-01-07 19:54:54,Fail to pick,250,291,0,0,0,0,0,0,0,0,False,0
2025-01-07 19:54:55,persegiMerah,246,286,143,130,137,49,133,46,4,3,True,0.20423346619914384
2025-01-07 19:54:55,Fail to pick,246,286,0,0,0,0,0,0,0,0,False,0
2025-01-07 19:54:55,persegiMerah,249,281,137,128,43,41,38,41,5,0,True,0.42989469731953045
2025-01-07 19:54:55,Fail to pick,249,281,0,0,0,0,0,0,0,0,False,0
2025-01-07 19:54:56,persegiMerah,248,282,136,126,17,75,19,73,2,2,True,0.42611594106368944
2025-01-07 19:54:56,Fail to pick,248,282,0,0,0,0,0,0,0,0,False,0
2025-01-07 19:54:57,persegiMerah,250,283,138,133,82,98,79,95,3,3,True,0.11683994623512102
2025-01-07 19:54:57,Fail to pick,250,283,0,0,0,0,0,0,0,0,False,0
2025-01-07 19:54:57,persegiMerah,247,282,136,127,177,91,172,90,5,1,True,0.10218728957934152
2025-01-07 19:54:57,Fail to pick,247,282,0,0,0,0,0,0,0,0,False,0
2025-01-07 19:54:57,persegiMerah,249,284,138,130,32,74,35,72,3,2,True,0.1027929334981081
2025-01-07 19:54:57,Fail to pick,249,284,0,0,0,0,0,0,0,0,False,0
2025-01-07 19:54:58,persegiMerah,249,287,139,127,93,90,93,89,0,1,True,0.23677213113200324
2025-01-07 19:54:58,Fail to pick,249,287,0,0,0,0,0,0,0,0,False,0
2025-01-07 19:54:58,persegiMerah,248,283,138,126,134,50,136,51,2,1,True,0.21868482146728574
2025-01-07 19:54:58,Fail to pick,248,283,0,0,0,0,0,0,0,0,False,0
2025-01-07 19:54:59,persegiMerah,249,282,136,126,10,56,6,60,4,4,True,0.4633672287346805
2025-01-07 19:54:59,Fail to pick,249,282,0,0,0,0,0,0,0,0,False,0
2025-01-07 19:54:59,persegiMerah,250,287,139,129,118,78,114,73,4,5,False,0.40088064813990487
2025-01-07 19:54:59,Fail to pick,250,287,0,0,0,0,0,0,0,0,False,0
2025-01-07 19:55:00,persegiMerah,251,277,138,129,134,18,132,13,2,5,True,0.18159857268990245
2025-01-07 19:55:00,persegiMerah,255,278,141,129,64,33,63,31,1,2,True,0.48054392625920517
2025-01-07 19:55:00,Fail to pick,255,278,0,0,0,0,0,0,0,0,False,0
2025-01-07 19:55:00,persegiMerah,253,277,142,129,87,60,86,63,1,3,True,0.4699829276463364
2025-01-07 19:55:00,Fail to pick,253,277,0,0,0,0,0,0,0,0,False,0
2025-01-07 19:55:00,persegiMerah,254,277,140,129,163,40,161,42,2,2,True,0.38023996949806815
2025-01-07 19:55:00,Fail to pick,254,277,0,0,0,0,0,0,0,0,False,0
2025-01-07 19:55:01,persegiMerah,251,277,140,129,183,81,183,85,0,4,True,0.45112518549345704
2025-01-07 19:55:01,Fail to pick,251,277,0,0,0,0,0,0,0,0,False,0
2025-01-07 19:55:01,persegiMerah,250,278,140,127,114,99,115,103,1,4,True,0.41750234555902754
2025-01-07 19:55:01,Fail to pick,250,278,0,0,0,0,0,0,0,0,False,0
2025-01-07 19:55:03,persegiMerah,252,280,142,126,195,18,190,16,5,2,True,0.4839986039569464
2025-01-07 19:55:03,Fail to pick,252,280,0,0,0,0,0,0,0,0,False,0
2025-01-07 19:55:03,persegiMerah,231,304,129,130,86,62,87,59,1,3,True,0.47143498101048475
2025-01-07 19:55:04,persegiMerah,225,303,126,129,167,23,165,21,2,2,True,0.37731620566589863
2025-01-07 19:55:04,Fail to pick,225,303,0,0,0,0,0,0,0,0,False,0
2025-01-07 19:55:04,persegiMerah,222,307,127,126,117,27,112,31,5,4,True,0.48132688349357045
2025-01-07 19:55:04,Fail to pick,222,307,0,0,0,0,0,0,0,0,False,0
2025-01-07 19:55:04,persegiMerah,224,303,126,130,139,88,138,85,1,3,True,0.4811028704913485
2025-01-07 19:55:04,Fail to pick,224,303,0,0,0,0,0,0,0,0,False,0
2025-01-07 19:55:04,persegiMerah,244,295,135,129,140,51,135,54,5,3,True,0.2814257295710222
2025-01-07 19:55:05,persegiMerah,220,305,129,130,6,85,7,81,1,4,True,0.23460816663065676
2025-01-07 19:55:05,persegiMerah,223,307,127,128,134,86,136,89,2,3,True,0.4468760609533752
2025-01-07 19:55:05,Fail to pick,223,307,0,0,0,0,0,0,0,0,False,0
2025-01-07 19:55:05,persegiMerah,230,307,132,128,167,18,164,19,3,1,True,0.30412583490312906
2025-01-07 19:55:05,Fail to pick,230,307,0,0,0,0,0,0,0,0,False,0
2025-01-07 19:55:05,persegiMerah,224,307,129,129,34,8,38,7,4,1,True,0.2758075498234854
2025-01-07 19:55:05,Fail to pick,224,307,0,0,0,0,0,0,0,0,False,0
2025-01-07 19:55:06,persegiMerah,229,298,133,133,110,73,114,74,4,1,True,0.10207129997217779
2025-01-07 19:55:06,Fail to pick,229,298,0,0,0,0,0,0,0,0,False,0
2025-01-07 19:55:06,persegiMerah,133,361,147,124,115,89,114,93,1,4,True,0.4746105152650355
2025-01-07 19:55:06,Merah,133,361,tensor(147.2759),tensor(124.6569),99,12,97,9,2,3,True,0.0004985332489013672
2025-01-07 19:55:06,persegiMerah,223,307,129,125,111,8,114,6,3,2,True,0.4938587595517272
2025-01-07 19:55:07,persegiMerah,226,306,129,128,41,65,39,67,2,2,True,0.3764176830634055
2025-01-07 19:55:07,Fail to pick,226,306,0,0,0,0,0,0,0,0,False,0
2025-01-07 19:55:07,persegiMerah,227,307,131,126,98,76,94,78,4,2,True,0.13295743615560665
2025-01-07 19:55:07,Fail to pick,227,307,0,0,0,0,0,0,0,0,False,0
2025-01-07 19:55:07,persegiMerah,231,307,131,128,30,90,32,85,2,5,True,0.39909934060795604
2025-01-07 19:55:07,Fail to pick,231,307,0,0,0,0,0,0,0,0,False,0
2025-01-07 19:55:07,persegiMerah,223,305,131,128,166,81,162,85,4,4,False,0.46709047660741954
2025-01-07 19:55:07,Fail to pick,223,305,0,0,0,0,0,0,0,0,False,0
2025-01-07 19:55:07,persegiMerah,224,304,127,129,110,74,107,73,3,1,True,0.4473324885700368
2025-01-07 19:55:07,Fail to pick,224,304,0,0,0,0,0,0,0,0,False,0
2025-01-07 19:55:08,persegiMerah,239,299,133,123,134,83,136,86,2,3,True,0.28682961220323044
2025-01-07 19:55:08,persegiMerah,230,306,128,127,92,20,96,20,4,0,True,0.38273696822849057
2025-01-07 19:55:08,Fail to pick,230,306,0,0,0,0,0,0,0,0,False,0
2025-01-07 19:55:08,persegiMerah,237,300,133,125,47,12,48,13,1,1,True,0.18198592917029438
2025-01-07 19:55:08,Fail to pick,237,300,0,0,0,0,0,0,0,0,False,0
2025-01-07 19:55:09,persegiMerah,245,292,131,128,98,78,97,76,1,2,True,0.3532449074924109
2025-01-07 19:55:09,Fail to pick,245,292,0,0,0,0,0,0,0,0,False,0
2025-01-07 19:55:09,persegiMerah,225,308,127,125,118,23,113,25,5,2,True,0.149719103943978
2025-01-07 19:55:09,persegiMerah,235,304,132,125,85,96,84,100,1,4,True,0.1383498307790757
2025-01-07 19:55:09,persegiMerah,244,296,134,125,186,44,187,39,1,5,True,0.4328062156293816
2025-01-07 19:55:09,Fail to pick,244,296,0,0,0,0,0,0,0,0,False,0
2025-01-07 19:55:09,persegiMerah,225,308,129,126,53,1,54,3,1,2,False,0.36630700884676237
2025-01-07 19:55:10,persegiMerah,226,308,128,126,25,55,28,56,3,1,True,0.36066354013776347
2025-01-07 19:55:10,Fail to pick,226,308,0,0,0,0,0,0,0,0,False,0
2025-01-07 19:55:10,persegiMerah,164,342,151,127,153,66,155,63,2,3,True,0.42613431607003927
2025-01-07 19:55:10,persegiMerah,220,307,128,128,186,55,181,52,5,3,True,0.3191842923247843
2025-01-07 19:55:10,persegiMerah,224,308,126,128,33,52,34,47,1,5,True,0.18666158644807396
2025-01-07 19:55:10,Fail to pick,224,308,0,0,0,0,0,0,0,0,False,0
2025-01-07 19:55:11,persegiMerah,268,305,118,124,122,43,118,39,4,4,True,0.20185169175835427
2025-01-07 19:55:11,persegiMerah,133,468,150,126,108,33,109,37,1,4,False,0.31595342017299954
2025-01-07 19:55:11,Merah,133,468,tensor(150.0071),tensor(126.7664),70,12,71,12,1,0,True,0.0004994869232177734
2025-01-07 19:55:11,persegiMerah,140,468,151,127,106,19,103,17,3,2,False,0.11230919723515292
2025-01-07 19:55:11,Fail to pick,140,468,0,0,0,0,0,0,0,0,False,0
2025-01-07 19:55:12,persegiMerah,138,468,151,127,26,38,29,40,3,2,True,0.3515856349981823
2025-01-07 19:55:12,Fail to pick,138,468,0,0,0,0,0,0,0,0,False,0
2025-01-07 19:55:12,persegiMerah,141,466,150,128,98,31,94,32,4,1,True,0.3066943154767865
2025-01-07 19:55:12,Fail to pick,141,466,0,0,0,0,0,0,0,0,False,0
2025-01-07 19:55:12,persegiMerah,145,462,150,128,88,86,84,88,4,2,True,0.21802111672695246
2025-01-07 19:55:12,Fail to pick,145,462,0,0,0,0,0,0,0,0,False,0
2025-01-07 19:55:12,persegiMerah,143,463,151,129,33,93,29,88,4,5,False,0.49131615099108317
2025-01-07 19:55:12,Fail to pick,143,463,0,0,0,0,0,0,0,0,False,0
2025-01-07 19:55:16,persegiMerah,276,656,121,108,170,73,174,77,4,4,True,0.19898584233232028
2025-01-07 19:55:16,Merah,276,656,tensor(121.5471),tensor(108.8441),17,25,18,23,1,2,True,0.0004987716674804688
2025-01-07 19:55:16,persegiMerah,279,656,119,108,3,10,7,9,4,1,False,0.17569810217054066
2025-01-07 19:55:16,Fail to pick,279,656,0,0,0,0,0,0,0,0,False,0
2025-01-07 19:55:17,persegiMerah,278,656,120,107,27,50,22,49,5,1,True,0.4200234281533287
2025-01-07 19:55:17,Fail to pick,278,656,0,0,0,0,0,0,0,0,False,0
2025-01-07 19:55:17,persegiMerah,283,653,119,108,104,7,107,7,3,0,True,0.14364484154824378
2025-01-07 19:55:17,Fail to pick,283,653,0,0,0,0,0,0,0,0,False,0
2025-01-07 19:55:17,persegiMerah,286,652,119,111,95,93,90,89,5,4,True,0.3100503574821337
2025-01-07 19:55:17,Fail to pick,286,652,0,0,0,0,0,0,0,0,False,0
2025-01-07 19:55:17,persegiMerah,293,650,120,114,134,17,132,20,2,3,True,0.15285020297491125
2025-01-07 19:55:17,Fail to pick,293,650,0,0,0,0,0,0,0,0,False,0
2025-01-07 19:55:17,persegiMerah,283,655,119,108,117,21,118,19,1,2,True,0.2537778624114678
2025-01-07 19:55:17,persegiMerah,296,650,121,114,132,86,129,83,3,3,True,0.3130836564857362
2025-01-07 19:55:17,persegiMerah,291,651,119,112,43,50,46,46,3,4,True,0.2504993637794769
2025-01-07 19:55:17,Fail to pick,291,651,0,0,0,0,0,0,0,0,False,0
2025-01-07 19:55:17,persegiMerah,283,654,118,108,71,27,67,28,4,1,True,0.2538103532888071
2025-01-07 19:55:17,Fail to pick,283,654,0,0,0,0,0,0,0,0,False,0
2025-01-07 19:55:18,persegiMerah,280,656,118,108,79,5,78,1,1,4,True,0.18521016762737924
2025-01-07 19:55:18,Fail to pick,280,656,0,0,0,0,0,0,0,0,False,0
2025-01-07 19:55:18,persegiMerah,279,656,119,108,189,92,184,89,5,3,True,0.3320664509306974
2025-01-07 19:55:18,Fail to pick,279,656,0,0,0,0,0,0,0,0,False,0
2025-01-07 19:55:18,persegiMerah,280,654,119,109,147,21,151,18,4,3,True,0.3299634274554408
2025-01-07 19:55:18,Fail to pick,280,654,0,0,0,0,0,0,0,0,False,0
2025-01-07 19:55:18,persegiMerah,280,655,118,107,22,37,23,34,1,3,True,0.10085253372532837
2025-01-07 19:55:18,Fail to pick,280,655,0,0,0,0,0,0,0,0,False,0
2025-01-07 19:55:18,persegiMerah,281,654,119,108,50,84,50,82,0,2,False,0.15186989682873497
2025-01-07 19:55:18,Fail to pick,281,654,0,0,0,0,0,0,0,0,False,0
2025-01-07 19:55:18,persegiMerah,284,654,118,107,176,89,179,92,3,3,False,0.20641801851584704
2025-01-07 19:55:18,Fail to pick,284,654,0,0,0,0,0,0,0,0,False,0
2025-01-07 19:55:18,persegiMerah,283,654,120,108,89,59,88,61,1,2,True,0.4602846516372652
2025-01-07 19:55:18,Fail to pick,283,654,0,0,0,0,0,0,0,0,False,0
2025-01-07 19:55:18,persegiMerah,284,654,117,108,171,52,175,49,4,3,False,0.3655329979114088
2025-01-07 19:55:18,Fail to pick,284,654,0,0,0,0,0,0,0,0,False,0
2025-01-07 19:55:19,persegiMerah,282,654,118,109,96,76,97,75,1,1,True,0.18349728661873896
2025-01-07 19:55:19,Fail to pick,282,654,0,0,0,0,0,0,0,0,False,0
2025-01-07 19:55:19,persegiMerah,282,656,119,106,92,26,88,21,4,5,True,0.29883620318641096
2025-01-07 19:55:19,Fail to pick,282,656,0,0,0,0,0,0,0,0,False,0
2025-01-07 19:55:19,persegiMerah,283,653,118,110,82,29,84,27,2,2,True,0.2000567318501535
2025-01-07 19:55:19,Fail to pick,283,653,0,0,0,0,0,0,0,0,False,0
2025-01-07 19:55:19,persegiMerah,283,654,120,107,89,14,86,14,3,0,True,0.4913338124707347
2025-01-07 19:55:19,Fail to pick,283,654,0,0,0,0,0,0,0,0,False,0
2025-01-07 19:55:19,persegiMerah,283,655,119,108,164,66,161,64,3,2,True,0.3705249260514528
2025-01-07 19:55:19,Fail to pick,283,655,0,0,0,0,0,0,0,0,False,0
2025-01-07 19:55:19,persegiMerah,282,656,121,107,17,14,20,13,3,1,True,0.2971499797511138
2025-01-07 19:55:19,Fail to pick,282,656,0,0,0,0,0,0,0,0,False,0
2025-01-07 19:55:19,persegiMerah,283,654,119,109,86,87,87,82,1,5,True,0.4559351943198616
2025-01-07 19:55:19,Fail to pick,283,654,0,0,0,0,0,0,0,0,False,0
2025-01-07 19:55:19,persegiMerah,284,653,120,109,156,6,159,10,3,4,True,0.2328197450703191
2025-01-07 19:55:19,Fail to pick,284,653,0,0,0,0,0,0,0,0,False,0
2025-01-07 19:55:20,persegiMerah,279,655,119,107,163,83,161,85,2,2,False,0.47161822869268377
2025-01-07 19:55:20,Fail to pick,279,655,0,0,0,0,0,0,0,0,False,0
2025-01-07 19:55:20,persegiMerah,281,655,120,107,88,39,86,40,2,1,True,0.11684006093097549
2025-01-07 19:55:20,Fail to pick,281,655,0,0,0,0,0,0,0,0,False,0
2025-01-07 19:55:20,persegiMerah,278,657,120,107,131,56,132,53,1,3,True,0.49939149720997056
2025-01-07 19:55:20,Fail to pick,278,657,0,0,0,0,0,0,0,0,False,0
2025-01-07 19:55:20,persegiMerah,281,657,119,105,85,97,85,93,0,4,False,0.28543950851840383
2025-01-07 19:55:20,Fail to pick,281,657,0,0,0,0,0,0,0,0,False,0
2025-01-07 19:55:20,persegiMerah,279,656,119,108,176,67,173,71,3,4,True,0.21310129582523718
2025-01-07 19:55:20,Fail to pick,279,656,0,0,0,0,0,0,0,0,False,0
2025-01-07 19:55:20,persegiMerah,277,656,121,108,135,17,130,20,5,3,True,0.2671886459763607
2025-01-07 19:55:20,Fail to pick,277,656,0,0,0,0,0,0,0,0,False,0
2025-01-07 19:55:20,persegiMerah,280,656,119,107,33,82,32,81,1,1,True,0.1639459924335998
2025-01-07 19:55:20,Fail to pick,280,656,0,0,0,0,0,0,0,0,False,0
2025-01-07 19:55:20,persegiMerah,279,655,119,108,181,84,178,80,3,4,False,0.18477576067167534
2025-01-07 19:55:20,Fail to pick,279,655,0,0,0,0,0,0,0,0,False,0
2025-01-07 19:55:21,persegiMerah,279,655,120,107,62,15,57,16,5,1,True,0.45292460922531785
2025-01-07 19:55:21,Fail to pick,279,655,0,0,0,0,0,0,0,0,False,0
2025-01-07 19:55:21,persegiMerah,278,654,120,107,57,17,57,15,0,2,True,0.40759622971059173
2025-01-07 19:55:21,Fail to pick,278,654,0,0,0,0,0,0,0,0,False,0
2025-01-07 19:55:21,persegiMerah,280,654,120,108,176,31,179,30,3,1,True,0.47241324029083487
2025-01-07 19:55:21,Fail to pick,280,654,0,0,0,0,0,0,0,0,False,0
2025-01-07 19:55:21,persegiMerah,279,654,120,107,60,83,55,81,5,2,True,0.1819396467943849
2025-01-07 19:55:21,Fail to pick,279,654,0,0,0,0,0,0,0,0,False,0
2025-01-07 19:55:21,persegiMerah,278,654,120,107,72,84,72,87,0,3,True,0.2914351301677969
2025-01-07 19:55:21,Fail to pick,278,654,0,0,0,0,0,0,0,0,False,0
2025-01-07 19:55:22,persegiMerah,283,655,121,108,107,45,110,40,3,5,True,0.20952697473556872
2025-01-07 19:55:22,Fail to pick,283,655,0,0,0,0,0,0,0,0,False,0
2025-01-07 19:55:22,persegiMerah,279,655,120,108,180,17,179,12,1,5,True,0.4169753276278607
2025-01-07 19:55:22,Fail to pick,279,655,0,0,0,0,0,0,0,0,False,0
2025-01-07 19:55:22,persegiMerah,280,656,119,107,100,56,95,60,5,4,True,0.2114719621830292
2025-01-07 19:55:22,Fail to pick,280,656,0,0,0,0,0,0,0,0,False,0
2025-01-07 19:55:22,persegiMerah,282,654,119,109,119,41,119,44,0,3,True,0.1750558331355352
2025-01-07 19:55:22,Fail to pick,282,654,0,0,0,0,0,0,0,0,False,0
2025-01-07 19:55:22,persegiMerah,277,656,120,109,108,12,103,13,5,1,True,0.36610754849960825
2025-01-07 19:55:22,Fail to pick,277,656,0,0,0,0,0,0,0,0,False,0
2025-01-07 19:55:22,persegiMerah,279,654,121,108,121,64,124,67,3,3,False,0.12170348388598402
2025-01-07 19:55:22,Fail to pick,279,654,0,0,0,0,0,0,0,0,False,0
2025-01-07 19:55:22,persegiMerah,278,655,121,108,181,13,185,14,4,1,True,0.3835660408887437
2025-01-07 19:55:22,Fail to pick,278,655,0,0,0,0,0,0,0,0,False,0
2025-01-07 19:55:23,persegiMerah,278,656,121,107,121,46,123,47,2,1,False,0.22700311379065347
2025-01-07 19:55:23,Fail to pick,278,656,0,0,0,0,0,0,0,0,False,0
2025-01-07 19:55:23,persegiMerah,280,655,121,108,190,79,193,83,3,4,True,0.1557408292107704
2025-01-07 19:55:23,Fail to pick,280,655,0,0,0,0,0,0,0,0,False,0
2025-01-07 19:55:23,persegiMerah,279,655,120,108,47,51,48,49,1,2,False,0.34220516840128845
2025-01-07 19:55:23,Fail to pick,279,655,0,0,0,0,0,0,0,0,False,0
2025-01-07 19:55:23,persegiMerah,284,651,119,111,142,31,139,33,3,2,True,0.27502115062369614
2025-01-07 19:55:23,Fail to pick,284,651,0,0,0,0,0,0,0,0,False,0
2025-01-07 19:55:23,persegiMerah,282,652,120,109,34,94,32,98,2,4,True,0.36212239761176623
2025-01-07 19:55:23,Fail to pick,282,652,0,0,0,0,0,0,0,0,False,0
2025-01-07 19:55:23,persegiMerah,284,651,116,109,99,76,99,71,0,5,True,0.13175481527485236
2025-01-07 19:55:23,Fail to pick,284,651,0,0,0,0,0,0,0,0,False,0
2025-01-07 19:55:23,persegiMerah,285,650,117,110,0,63,-2,58,2,5,True,0.24766965745206704
2025-01-07 19:55:23,Fail to pick,285,650,0,0,0,0,0,0,0,0,False,0
2025-01-07 19:55:24,persegiMerah,285,651,118,110,33,66,35,69,2,3,False,0.46816046968385394
2025-01-07 19:55:24,Fail to pick,285,651,0,0,0,0,0,0,0,0,False,0
2025-01-07 19:55:24,persegiMerah,284,652,117,107,72,81,73,82,1,1,True,0.17494329643033005
2025-01-07 19:55:24,Fail to pick,284,652,0,0,0,0,0,0,0,0,False,0
2025-01-07 19:55:24,persegiMerah,306,637,125,108,53,1,52,-3,1,4,True,0.12345364351240318
2025-01-07 19:55:24,persegiBiru,300,638,122,105,43,46,41,45,2,1,True,0.4074942125070786
2025-01-07 19:55:24,Fail to pick,300,638,0,0,0,0,0,0,0,0,False,0
2025-01-07 19:55:25,persegiMerah,316,638,125,105,150,55,154,59,4,4,True,0.420003988839905
2025-01-07 19:55:26,persegiMerah,317,630,127,112,122,14,120,18,2,4,True,0.38181153692458947
2025-01-07 19:55:26,Fail to pick,317,630,0,0,0,0,0,0,0,0,False,0
2025-01-07 19:55:27,persegiMerah,296,642,122,109,120,90,120,91,0,1,True,0.3406973494329292
2025-01-07 19:55:27,persegiMerah,293,646,122,113,65,99,66,101,1,2,True,0.2468053453952048
2025-01-07 19:55:27,Fail to pick,293,646,0,0,0,0,0,0,0,0,False,0
2025-01-07 19:55:27,persegiMerah,282,651,118,112,0,43,-1,40,1,3,False,0.37617971801851524
2025-01-07 19:55:27,persegiMerah,285,652,120,112,49,21,51,21,2,0,True,0.14636997961775589
2025-01-07 19:55:27,Fail to pick,285,652,0,0,0,0,0,0,0,0,False,0
2025-01-07 19:55:27,persegiMerah,292,645,123,112,28,73,31,68,3,5,True,0.11846770584808444
2025-01-07 19:55:27,Fail to pick,292,645,0,0,0,0,0,0,0,0,False,0
2025-01-07 19:55:27,persegiMerah,279,652,121,111,34,74,31,71,3,3,True,0.1502154194959161
2025-01-07 19:55:27,persegiMerah,286,648,122,112,117,87,121,88,4,1,True,0.14667507695507634
2025-01-07 19:55:27,Fail to pick,286,648,0,0,0,0,0,0,0,0,False,0
2025-01-07 19:55:27,persegiMerah,281,651,119,111,145,9,149,8,4,1,True,0.1981995303828873
2025-01-07 19:55:27,Fail to pick,281,651,0,0,0,0,0,0,0,0,False,0
2025-01-07 19:55:28,persegiMerah,289,648,122,112,66,20,66,23,0,3,True,0.42072542172096705
2025-01-07 19:55:28,Fail to pick,289,648,0,0,0,0,0,0,0,0,False,0
2025-01-07 19:55:28,persegiMerah,290,648,120,114,37,64,36,63,1,1,True,0.14693412990815113
2025-01-07 19:55:28,Fail to pick,290,648,0,0,0,0,0,0,0,0,False,0
2025-01-07 19:55:28,persegiMerah,288,648,120,113,62,57,62,57,0,0,True,0.22380706583719745
2025-01-07 19:55:28,Fail to pick,288,648,0,0,0,0,0,0,0,0,False,0
2025-01-07 19:55:28,persegiMerah,291,646,122,111,131,80,128,81,3,1,True,0.33584046198275797
2025-01-07 19:55:28,Fail to pick,291,646,0,0,0,0,0,0,0,0,False,0
2025-01-07 19:55:28,persegiMerah,302,635,124,112,37,10,33,12,4,2,True,0.3501361376171973
2025-01-07 19:55:28,persegiMerah,301,639,124,108,173,37,177,40,4,3,True,0.30189260451400657
2025-01-07 19:55:28,Fail to pick,301,639,0,0,0,0,0,0,0,0,False,0
2025-01-07 19:55:28,persegiMerah,304,637,126,110,123,25,120,26,3,1,True,0.2423219564318813
2025-01-07 19:55:28,Fail to pick,304,637,0,0,0,0,0,0,0,0,False,0
2025-01-07 19:55:28,persegiMerah,297,641,121,110,68,23,72,26,4,3,True,0.4697317629413169
2025-01-07 19:55:28,Fail to pick,297,641,0,0,0,0,0,0,0,0,False,0
2025-01-07 19:55:29,persegiMerah,285,649,120,114,45,63,47,58,2,5,True,0.147173151183152
2025-01-07 19:55:29,persegiMerah,295,647,120,112,199,94,202,94,3,0,True,0.27529523920897914
2025-01-07 19:55:29,persegiMerah,297,645,121,112,153,44,151,46,2,2,True,0.14232104643046167
2025-01-07 19:55:29,Fail to pick,297,645,0,0,0,0,0,0,0,0,False,0
2025-01-07 19:55:29,persegiMerah,294,648,122,111,162,83,163,84,1,1,False,0.13654461164081444
2025-01-07 19:55:29,Fail to pick,294,648,0,0,0,0,0,0,0,0,False,0
2025-01-07 19:55:29,persegiMerah,294,644,122,111,129,68,133,67,4,1,True,0.30119499242859327
2025-01-07 19:55:29,Fail to pick,294,644,0,0,0,0,0,0,0,0,False,0
2025-01-07 19:55:29,persegiMerah,253,668,120,92,65,56,67,52,2,4,True,0.1356934583843391
2025-01-07 19:55:29,persegiMerah,297,642,121,109,122,99,125,99,3,0,False,0.31215930736703845
2025-01-07 19:55:29,persegiMerah,297,643,121,111,83,99,80,101,3,2,True,0.49275512442506886
2025-01-07 19:55:29,Fail to pick,297,643,0,0,0,0,0,0,0,0,False,0
2025-01-07 19:55:30,persegiMerah,283,652,119,113,76,46,76,50,0,4,True,0.40212908682433635
2025-01-07 19:55:30,persegiMerah,289,648,121,112,167,62,163,63,4,1,True,0.21305801016276102
2025-01-07 19:55:30,Fail to pick,289,648,0,0,0,0,0,0,0,0,False,0
2025-01-07 19:55:30,persegiMerah,286,648,121,112,129,87,129,90,0,3,True,0.2730651297843132
2025-01-07 19:55:30,Fail to pick,286,648,0,0,0,0,0,0,0,0,False,0
2025-01-07 19:55:30,persegiMerah,295,647,122,111,78,71,81,71,3,0,True,0.24320684389868866
2025-01-07 19:55:30,Fail to pick,295,647,0,0,0,0,0,0,0,0,False,0
2025-01-07 19:55:30,persegiMerah,254,666,122,91,150,42,148,38,2,4,True,0.20088353808321543
2025-01-07 19:55:30,persegiMerah,291,653,121,111,48,4,46,4,2,0,True,0.4702390299519015
2025-01-07 19:55:30,persegiMerah,304,649,125,111,145,11,141,8,4,3,True,0.43538991241660074
2025-01-07 19:55:30,persegiMerah,300,652,125,110,7,19,11,21,4,2,True,0.2813811643474734
2025-01-07 19:55:30,Fail to pick,300,652,0,0,0,0,0,0,0,0,False,0
2025-01-07 19:55:31,persegiMerah,303,654,126,111,64,93,65,90,1,3,False,0.41030811675456225
2025-01-07 19:55:31,Fail to pick,303,654,0,0,0,0,0,0,0,0,False,0
2025-01-07 19:55:31,persegiMerah,285,664,119,104,2,6,1,7,1,1,True,0.21238294406712757
2025-01-07 19:55:31,persegiMerah,295,657,122,108,8,35,3,39,5,4,True,0.1576466236193957
2025-01-07 19:55:31,persegiMerah,291,660,121,106,43,50,39,47,4,3,True,0.18220872334661542
2025-01-07 19:55:31,Fail to pick,291,660,0,0,0,0,0,0,0,0,False,0
2025-01-07 19:55:31,persegiMerah,288,661,120,105,140,45,135,41,5,4,True,0.4834005744500609
2025-01-07 19:55:31,Fail to pick,288,661,0,0,0,0,0,0,0,0,False,0
2025-01-07 19:55:31,persegiMerah,289,661,120,104,16,97,12,99,4,2,True,0.45595914331611875
2025-01-07 19:55:31,Fail to pick,289,661,0,0,0,0,0,0,0,0,False,0
2025-01-07 19:55:31,persegiMerah,292,658,124,108,19,12,19,13,0,1,True,0.44714224562931004
2025-01-07 19:55:31,Fail to pick,292,658,0,0,0,0,0,0,0,0,False,0
2025-01-07 19:55:31,persegiMerah,284,658,122,107,111,85,115,86,4,1,True,0.4942618928950069
2025-01-07 19:55:31,Fail to pick,284,658,0,0,0,0,0,0,0,0,False,0
2025-01-07 19:55:32,persegiMerah,249,675,119,88,159,30,156,27,3,3,False,0.4249378197618624
2025-01-07 19:55:32,persegiMerah,291,655,121,110,7,90,5,92,2,2,True,0.22841102601049226
2025-01-07 19:55:32,persegiMerah,286,651,117,112,167,55,169,54,2,1,True,0.3802071267594168
2025-01-07 19:55:32,Fail to pick,286,651,0,0,0,0,0,0,0,0,False,0
2025-01-07 19:55:32,persegiMerah,301,641,126,111,102,11,97,10,5,1,True,0.14206995825188057
2025-01-07 19:55:32,persegiMerah,286,650,121,113,136,2,131,2,5,0,True,0.3767042211263312
2025-01-07 19:55:32,persegiMerah,288,650,120,111,85,4,84,7,1,3,True,0.2508898236271099
2025-01-07 19:55:32,Fail to pick,288,650,0,0,0,0,0,0,0,0,False,0
2025-01-07 19:55:32,persegiMerah,293,651,121,114,146,65,144,62,2,3,True,0.18757671888771257
2025-01-07 19:55:32,Fail to pick,293,651,0,0,0,0,0,0,0,0,False,0
2025-01-07 19:55:32,persegiMerah,281,651,120,111,60,55,62,58,2,3,True,0.19248574851270367
2025-01-07 19:55:32,persegiMerah,297,645,121,113,161,76,162,73,1,3,True,0.3369220749116556
2025-01-07 19:55:33,persegiMerah,286,652,121,112,128,14,130,10,2,4,True,0.15809036107625288
2025-01-07 19:55:33,persegiMerah,292,651,121,111,123,31,121,27,2,4,False,0.19860775139263842
2025-01-07 19:55:33,Fail to pick,292,651,0,0,0,0,0,0,0,0,False,0
2025-01-07 19:55:33,persegiMerah,307,635,125,110,114,7,113,2,1,5,False,0.4917646932770662
2025-01-07 19:55:33,persegiMerah,301,635,126,111,189,52,192,53,3,1,True,0.12304651230575576
2025-01-07 19:55:33,Fail to pick,301,635,0,0,0,0,0,0,0,0,False,0
2025-01-07 19:55:33,persegiMerah,291,648,121,111,1,31,3,29,2,2,False,0.3081549017196199
2025-01-07 19:55:33,persegiMerah,290,649,119,111,198,90,199,92,1,2,True,0.23812954616821164
2025-01-07 19:55:33,Fail to pick,290,649,0,0,0,0,0,0,0,0,False,0
2025-01-07 19:55:33,persegiMerah,290,652,120,111,185,17,181,19,4,2,True,0.3877491500334449
2025-01-07 19:55:33,Fail to pick,290,652,0,0,0,0,0,0,0,0,False,0
2025-01-07 19:55:33,persegiMerah,293,647,122,112,98,17,94,17,4,0,True,0.3692094099632981
2025-01-07 19:55:33,Fail to pick,293,647,0,0,0,0,0,0,0,0,False,0
2025-01-07 19:55:34,persegiMerah,290,647,121,111,43,50,38,49,5,1,True,0.3213735181748716
2025-01-07 19:55:34,Fail to pick,290,647,0,0,0,0,0,0,0,0,False,0
2025-01-07 19:55:34,persegiMerah,292,648,121,113,132,93,136,97,4,4,True,0.4953548996916174
2025-01-07 19:55:34,Fail to pick,292,648,0,0,0,0,0,0,0,0,False,0
2025-01-07 19:55:34,persegiMerah,283,651,119,111,124,55,124,55,0,0,True,0.4338813888494196
2025-01-07 19:55:34,Fail to pick,283,651,0,0,0,0,0,0,0,0,False,0
2025-01-07 19:55:34,persegiMerah,282,652,119,111,176,26,177,28,1,2,True,0.3804239692756749
2025-01-07 19:55:34,Fail to pick,282,652,0,0,0,0,0,0,0,0,False,0
2025-01-07 19:55:34,persegiMerah,283,653,119,112,4,84,-1,88,5,4,True,0.13606351297058641
2025-01-07 19:55:34,Fail to pick,283,653,0,0,0,0,0,0,0,0,False,0
2025-01-07 19:55:34,persegiMerah,282,652,121,111,29,49,31,53,2,4,True,0.2614257678012193
2025-01-07 19:55:34,Fail to pick,282,652,0,0,0,0,0,0,0,0,False,0
2025-01-07 19:55:34,persegiMerah,246,668,117,91,164,39,160,36,4,3,True,0.3672233831002628
2025-01-07 19:55:34,persegiMerah,285,650,120,111,153,95,148,98,5,3,True,0.3689586039187328
2025-01-07 19:55:35,persegiMerah,289,649,120,111,154,82,154,77,0,5,True,0.27689278135008255
2025-01-07 19:55:35,Fail to pick,289,649,0,0,0,0,0,0,0,0,False,0
2025-01-07 19:55:35,persegiMerah,244,671,117,92,129,5,130,6,1,1,True,0.1487311384148705
2025-01-07 19:55:35,persegiMerah,290,650,121,111,47,47,48,46,1,1,True,0.4408418200222938
2025-01-07 19:55:35,persegiMerah,283,653,121,110,70,51,71,53,1,2,True,0.16626347824858068
2025-01-07 19:55:35,Fail to pick,283,653,0,0,0,0,0,0,0,0,False,0
2025-01-07 19:55:35,persegiMerah,286,646,120,113,101,72,102,67,1,5,False,0.39314951180112445
2025-01-07 19:55:35,Fail to pick,286,646,0,0,0,0,0,0,0,0,False,0
2025-01-07 19:55:35,persegiMerah,282,648,120,115,70,0,68,-2,2,2,True,0.24368504555326684
2025-01-07 19:55:35,Fail to pick,282,648,0,0,0,0,0,0,0,0,False,0
2025-01-07 19:55:35,persegiMerah,281,653,121,110,198,53,195,54,3,1,False,0.3017545396211339
2025-01-07 19:55:35,Fail to pick,281,653,0,0,0,0,0,0,0,0,False,0
2025-01-07 19:55:36,persegiMerah,281,650,122,112,166,91,170,93,4,2,True,0.3800339039417229
2025-01-07 19:55:36,Fail to pick,281,650,0,0,0,0,0,0,0,0,False,0
2025-01-07 19:55:36,persegiMerah,281,652,121,111,7,22,11,22,4,0,False,0.10435525392964502
2025-01-07 19:55:36,Fail to pick,281,652,0,0,0,0,0,0,0,0,False,0
2025-01-07 19:55:36,persegiMerah,276,650,123,112,78,74,79,77,1,3,True,0.311541018188098
2025-01-07 19:55:36,Fail to pick,276,650,0,0,0,0,0,0,0,0,False,0
2025-01-07 19:55:36,persegiMerah,289,646,118,111,38,62,41,64,3,2,True,0.42627073509722235
2025-01-07 19:55:36,persegiMerah,273,652,120,111,52,62,55,60,3,2,True,0.17246155767429744
2025-01-07 19:55:36,persegiMerah,246,622,116,115,168,84,163,84,5,0,True,0.1951612796030957
2025-01-07 19:56:21,persegiBiru,358,514,126,111,50,73,49,77,1,4,True,0.3234500752886552
2025-01-07 19:56:21,Biru,358,514,tensor(126.6736),tensor(111.6352),57,33,53,34,4,1,True,0.0
2025-01-07 19:56:21,persegiKuning,347,516,123,111,75,79,79,75,4,4,True,0.1691677619024034
2025-01-07 19:56:22,persegiBiru,353,515,125,111,8,6,10,6,2,0,True,0.18158060829937406
2025-01-07 19:56:22,Fail to pick,353,515,0,0,0,0,0,0,0,0,False,0
2025-01-07 19:56:22,persegiBiru,351,516,121,110,51,76,51,75,0,1,True,0.37472873401793627
2025-01-07 19:56:22,Fail to pick,351,516,0,0,0,0,0,0,0,0,False,0
2025-01-07 19:56:23,persegiBiru,328,532,113,109,162,42,159,37,3,5,True,0.25377061543893376
2025-01-07 19:56:23,persegiBiru,329,537,114,110,73,46,77,41,4,5,True,0.17016565698448644
2025-01-07 19:56:23,Fail to pick,329,537,0,0,0,0,0,0,0,0,False,0
2025-01-07 19:56:23,persegiBiru,328,532,115,109,193,8,194,5,1,3,True,0.41446765332528446
2025-01-07 19:56:23,Fail to pick,328,532,0,0,0,0,0,0,0,0,False,0
2025-01-07 19:56:23,persegiBiru,326,535,114,109,171,73,174,75,3,2,True,0.490214760722657
2025-01-07 19:56:23,Fail to pick,326,535,0,0,0,0,0,0,0,0,False,0
2025-01-07 19:56:24,persegiBiru,332,532,115,109,123,35,125,35,2,0,True,0.112245007453738
2025-01-07 19:56:24,Fail to pick,332,532,0,0,0,0,0,0,0,0,False,0
2025-01-07 19:56:24,persegiBiru,326,535,113,110,79,77,79,73,0,4,True,0.4588117941515787
2025-01-07 19:56:24,Fail to pick,326,535,0,0,0,0,0,0,0,0,False,0
2025-01-07 19:56:24,persegiBiru,328,535,115,111,89,19,84,16,5,3,True,0.11026714018860213
2025-01-07 19:56:24,Fail to pick,328,535,0,0,0,0,0,0,0,0,False,0
2025-01-07 19:56:24,persegiBiru,329,532,115,110,135,67,135,64,0,3,True,0.1799881848990551
2025-01-07 19:56:24,Fail to pick,329,532,0,0,0,0,0,0,0,0,False,0
2025-01-07 19:56:25,persegiBiru,333,530,117,108,156,93,159,92,3,1,False,0.44412084500419646
2025-01-07 19:56:25,Fail to pick,333,530,0,0,0,0,0,0,0,0,False,0
2025-01-07 19:56:25,persegiBiru,327,532,116,110,58,6,57,9,1,3,True,0.15153207237127075
2025-01-07 19:56:25,Fail to pick,327,532,0,0,0,0,0,0,0,0,False,0
2025-01-07 19:56:25,persegiBiru,327,532,114,109,174,55,178,52,4,3,True,0.3172990833740974
2025-01-07 19:56:25,Fail to pick,327,532,0,0,0,0,0,0,0,0,False,0
2025-01-07 19:56:25,persegiBiru,327,531,115,109,173,97,175,100,2,3,True,0.494635407274967
2025-01-07 19:56:25,Fail to pick,327,531,0,0,0,0,0,0,0,0,False,0
2025-01-07 19:56:25,persegiBiru,326,537,113,109,105,60,105,63,0,3,True,0.4814863280038967
2025-01-07 19:56:25,Fail to pick,326,537,0,0,0,0,0,0,0,0,False,0
2025-01-07 19:56:26,persegiBiru,327,535,115,110,166,16,161,12,5,4,True,0.2099950687968415
2025-01-07 19:56:26,Fail to pick,327,535,0,0,0,0,0,0,0,0,False,0
2025-01-07 19:56:26,persegiBiru,329,534,114,109,138,57,133,56,5,1,True,0.4698959587252647
2025-01-07 19:56:26,Fail to pick,329,534,0,0,0,0,0,0,0,0,False,0
2025-01-07 19:56:26,persegiBiru,327,532,116,109,89,93,90,90,1,3,True,0.1335262459354629
2025-01-07 19:56:26,Fail to pick,327,532,0,0,0,0,0,0,0,0,False,0
2025-01-07 19:56:26,persegiBiru,328,532,113,108,150,16,148,16,2,0,True,0.15714112901698452
2025-01-07 19:56:26,Fail to pick,328,532,0,0,0,0,0,0,0,0,False,0
2025-01-07 19:56:26,persegiBiru,327,534,114,108,142,77,140,80,2,3,False,0.19151348231462426
2025-01-07 19:56:26,Fail to pick,327,534,0,0,0,0,0,0,0,0,False,0
2025-01-07 19:56:27,persegiBiru,328,532,114,109,147,92,151,88,4,4,False,0.4114702595895765
2025-01-07 19:56:27,Fail to pick,328,532,0,0,0,0,0,0,0,0,False,0
2025-01-07 19:56:27,persegiBiru,327,531,115,111,51,94,54,89,3,5,True,0.2694124209645453
2025-01-07 19:56:27,Fail to pick,327,531,0,0,0,0,0,0,0,0,False,0
2025-01-07 19:56:28,persegiBiru,329,532,115,110,122,95,123,95,1,0,True,0.43820806350007
2025-01-07 19:56:28,Fail to pick,329,532,0,0,0,0,0,0,0,0,False,0
2025-01-07 19:56:28,persegiBiru,328,531,116,110,13,62,9,58,4,4,True,0.10730028033771576
2025-01-07 19:56:28,Fail to pick,328,531,0,0,0,0,0,0,0,0,False,0
2025-01-07 19:56:28,persegiBiru,326,532,113,109,61,82,65,78,4,4,True,0.12838393221175606
2025-01-07 19:56:28,Fail to pick,326,532,0,0,0,0,0,0,0,0,False,0
2025-01-07 19:56:28,persegiBiru,325,533,115,109,144,90,144,89,0,1,True,0.47922952062847324
2025-01-07 19:56:28,Fail to pick,325,533,0,0,0,0,0,0,0,0,False,0
2025-01-07 19:56:29,persegiBiru,327,533,117,110,16,24,15,21,1,3,False,0.2959281540365919
2025-01-07 19:56:29,Fail to pick,327,533,0,0,0,0,0,0,0,0,False,0
2025-01-07 19:56:29,persegiBiru,326,530,115,110,51,51,54,53,3,2,True,0.24019407536005324
2025-01-07 19:56:29,Fail to pick,326,530,0,0,0,0,0,0,0,0,False,0
2025-01-07 19:56:29,persegiBiru,329,533,118,110,131,55,126,59,5,4,True,0.28475487099381724
2025-01-07 19:56:29,Fail to pick,329,533,0,0,0,0,0,0,0,0,False,0
2025-01-07 19:56:30,persegiMerah,321,531,116,115,68,30,65,32,3,2,True,0.39676450400200614
2025-01-07 19:56:30,Fail to pick,321,531,0,0,0,0,0,0,0,0,False,0
2025-01-07 19:56:30,persegiMerah,323,534,119,116,18,97,21,99,3,2,True,0.3102263254836236
2025-01-07 19:56:30,Fail to pick,323,534,0,0,0,0,0,0,0,0,False,0
2025-01-07 19:56:30,persegiMerah,318,534,119,116,127,57,125,61,2,4,True,0.20883294970402774
2025-01-07 19:56:30,Fail to pick,318,534,0,0,0,0,0,0,0,0,False,0
2025-01-07 19:56:31,persegiMerah,236,279,150,141,199,16,196,20,3,4,True,0.42692787403124477
2025-01-07 19:56:31,Merah,236,279,tensor(150.5618),tensor(141.3851),122,21,119,23,3,2,True,0.0
2025-01-07 19:56:31,persegiMerah,235,284,142,140,164,92,161,93,3,1,True,0.20500865839561913
2025-01-07 19:56:31,Fail to pick,235,284,0,0,0,0,0,0,0,0,False,0
2025-01-07 19:56:31,persegiMerah,239,285,143,136,187,66,183,69,4,3,True,0.418041097382178
2025-01-07 19:56:31,Fail to pick,239,285,0,0,0,0,0,0,0,0,False,0
2025-01-07 19:56:32,persegiMerah,254,277,144,133,152,83,148,78,4,5,True,0.3332695464640292
2025-01-07 19:56:32,persegiMerah,255,275,143,136,113,45,114,47,1,2,True,0.42825666731424394
2025-01-07 19:56:32,Fail to pick,255,275,0,0,0,0,0,0,0,0,False,0
2025-01-07 19:56:32,persegiMerah,248,279,141,133,98,95,96,93,2,2,True,0.26964178613905665
2025-01-07 19:56:32,Fail to pick,248,279,0,0,0,0,0,0,0,0,False,0
2025-01-07 19:56:32,persegiMerah,248,276,143,136,4,37,-1,41,5,4,True,0.14428138129970758
2025-01-07 19:56:32,Fail to pick,248,276,0,0,0,0,0,0,0,0,False,0
2025-01-07 19:56:32,persegiMerah,235,285,145,139,183,86,180,83,3,3,True,0.4649947636503243
2025-01-07 19:56:32,persegiMerah,234,283,138,139,194,43,195,45,1,2,True,0.1649824728927775
2025-01-07 19:56:32,Fail to pick,234,283,0,0,0,0,0,0,0,0,False,0
2025-01-07 19:56:32,persegiMerah,241,282,143,138,91,40,87,37,4,3,True,0.4432948874344026
2025-01-07 19:56:32,Fail to pick,241,282,0,0,0,0,0,0,0,0,False,0
2025-01-07 19:56:32,persegiMerah,240,283,146,139,153,82,156,81,3,1,True,0.46300728704222194
2025-01-07 19:56:32,Fail to pick,240,283,0,0,0,0,0,0,0,0,False,0
2025-01-07 19:56:33,persegiMerah,235,285,143,140,199,22,201,24,2,2,False,0.25974932052282507
2025-01-07 19:56:33,Fail to pick,235,285,0,0,0,0,0,0,0,0,False,0
2025-01-07 19:56:33,persegiMerah,246,274,153,144,104,20,108,24,4,4,True,0.13177793946106464
2025-01-07 19:56:33,persegiMerah,230,287,145,139,93,47,97,42,4,5,True,0.2786511656500261
2025-01-07 19:56:33,persegiMerah,232,284,148,141,100,67,101,64,1,3,True,0.3398383873018862
2025-01-07 19:56:33,Fail to pick,232,284,0,0,0,0,0,0,0,0,False,0
2025-01-07 19:56:33,persegiMerah,237,279,145,139,86,75,89,77,3,2,True,0.27655413961768194
2025-01-07 19:56:33,Fail to pick,237,279,0,0,0,0,0,0,0,0,False,0
2025-01-07 19:56:33,persegiMerah,245,272,153,139,188,35,189,39,1,4,True,0.14854012779672632
2025-01-07 19:56:33,Fail to pick,245,272,0,0,0,0,0,0,0,0,False,0
2025-01-07 19:56:34,persegiMerah,243,273,151,138,105,66,104,64,1,2,True,0.17262474386982088
2025-01-07 19:56:34,Fail to pick,243,273,0,0,0,0,0,0,0,0,False,0
2025-01-07 19:56:34,persegiMerah,243,274,151,140,89,84,89,88,0,4,True,0.3752868344986434
2025-01-07 19:56:34,Fail to pick,243,274,0,0,0,0,0,0,0,0,False,0
2025-01-07 19:56:34,persegiMerah,248,269,149,140,40,64,38,59,2,5,True,0.305675011936158
2025-01-07 19:56:34,Fail to pick,248,269,0,0,0,0,0,0,0,0,False,0
2025-01-07 19:56:34,persegiMerah,245,267,152,142,42,96,37,93,5,3,True,0.4918926934827553
2025-01-07 19:56:34,Fail to pick,245,267,0,0,0,0,0,0,0,0,False,0
2025-01-07 19:56:34,persegiMerah,241,271,152,144,16,19,19,19,3,0,False,0.14308167358634788
2025-01-07 19:56:34,Fail to pick,241,271,0,0,0,0,0,0,0,0,False,0
2025-01-07 19:56:34,persegiMerah,240,267,146,141,198,83,197,80,1,3,True,0.4638963345532461
2025-01-07 19:56:34,Fail to pick,240,267,0,0,0,0,0,0,0,0,False,0
2025-01-07 19:56:34,persegiMerah,239,275,151,138,50,51,53,47,3,4,True,0.13778742086716844
2025-01-07 19:56:34,Fail to pick,239,275,0,0,0,0,0,0,0,0,False,0
2025-01-07 19:56:35,persegiMerah,240,268,150,147,50,17,52,19,2,2,True,0.124640065122891
2025-01-07 19:56:35,Fail to pick,240,268,0,0,0,0,0,0,0,0,False,0
2025-01-07 19:56:35,persegiMerah,245,266,152,136,50,28,47,29,3,1,True,0.3928796791388892
2025-01-07 19:56:35,Fail to pick,245,266,0,0,0,0,0,0,0,0,False,0
2025-01-07 19:56:35,persegiMerah,223,263,146,138,84,63,81,61,3,2,False,0.43828148877530737
2025-01-07 19:56:35,persegiMerah,223,265,142,139,182,11,183,11,1,0,True,0.19898757156235655
2025-01-07 19:56:35,Fail to pick,223,265,0,0,0,0,0,0,0,0,False,0
2025-01-07 19:56:38,persegiMerah,219,285,158,145,18,93,16,97,2,4,False,0.48726760061599117
2025-01-07 19:56:38,persegiMerah,225,282,156,144,163,38,159,37,4,1,False,0.3312497264748605
2025-01-07 19:56:38,Fail to pick,225,282,0,0,0,0,0,0,0,0,False,0
2025-01-07 19:56:38,persegiMerah,226,284,159,146,135,19,136,23,1,4,True,0.43615702742965046
2025-01-07 19:56:38,Fail to pick,226,284,0,0,0,0,0,0,0,0,False,0
2025-01-07 19:56:38,persegiMerah,223,283,157,151,29,35,30,37,1,2,True,0.23576095164584776
2025-01-07 19:56:38,Fail to pick,223,283,0,0,0,0,0,0,0,0,False,0
2025-01-07 19:56:39,persegiMerah,232,282,160,148,95,1,95,1,0,0,True,0.4642760123247448
2025-01-07 19:56:39,Fail to pick,232,282,0,0,0,0,0,0,0,0,False,0
2025-01-07 19:56:39,persegiMerah,229,279,154,147,106,80,104,77,2,3,True,0.21797996593392008
2025-01-07 19:56:39,Fail to pick,229,279,0,0,0,0,0,0,0,0,False,0
2025-01-07 19:56:39,persegiMerah,228,282,155,145,199,85,198,86,1,1,True,0.49061366816556806
2025-01-07 19:56:39,Fail to pick,228,282,0,0,0,0,0,0,0,0,False,0
2025-01-07 19:56:39,persegiMerah,230,286,154,145,43,70,43,66,0,4,True,0.13605215416039196
2025-01-07 19:56:39,Fail to pick,230,286,0,0,0,0,0,0,0,0,False,0
2025-01-07 19:56:39,persegiMerah,240,287,156,146,175,5,175,7,0,2,True,0.32568712484251205
2025-01-07 19:56:40,persegiMerah,244,278,156,137,186,40,185,40,1,0,False,0.16691654721852306
2025-01-07 19:56:40,Fail to pick,244,278,0,0,0,0,0,0,0,0,False,0
2025-01-07 19:56:40,persegiMerah,235,287,139,138,123,51,120,46,3,5,True,0.45496959577354534
2025-01-07 19:56:40,Fail to pick,235,287,0,0,0,0,0,0,0,0,False,0
2025-01-07 19:56:40,persegiMerah,238,281,140,142,132,46,130,41,2,5,True,0.20300444534842887
2025-01-07 19:56:40,Fail to pick,238,281,0,0,0,0,0,0,0,0,False,0
2025-01-07 19:56:40,persegiMerah,239,280,144,144,163,21,162,23,1,2,True,0.4656009408348595
2025-01-07 19:56:40,Fail to pick,239,280,0,0,0,0,0,0,0,0,False,0
2025-01-07 19:56:40,persegiMerah,241,275,147,146,1,90,0,93,1,3,True,0.4579982887337538
2025-01-07 19:56:40,Fail to pick,241,275,0,0,0,0,0,0,0,0,False,0
2025-01-07 19:56:41,persegiMerah,239,279,147,139,159,25,161,29,2,4,True,0.12348873950120232
2025-01-07 19:56:41,Fail to pick,239,279,0,0,0,0,0,0,0,0,False,0
2025-01-07 19:56:41,persegiMerah,238,279,144,136,161,80,161,82,0,2,True,0.33147833301996943
2025-01-07 19:56:41,Fail to pick,238,279,0,0,0,0,0,0,0,0,False,0
2025-01-07 19:56:41,persegiMerah,246,278,150,137,160,66,162,66,2,0,True,0.2937118613618638
2025-01-07 19:56:41,Fail to pick,246,278,0,0,0,0,0,0,0,0,False,0
2025-01-07 19:56:41,persegiMerah,232,286,146,140,193,14,190,16,3,2,True,0.3345917894431064
2025-01-07 19:56:41,persegiMerah,242,279,151,140,195,98,196,102,1,4,True,0.2506514139266627
2025-01-07 19:56:41,persegiMerah,240,284,146,138,161,9,165,6,4,3,False,0.1331784183498
2025-01-07 19:56:41,Fail to pick,240,284,0,0,0,0,0,0,0,0,False,0
2025-01-07 19:56:41,persegiMerah,252,278,151,137,146,37,143,36,3,1,False,0.11175410418006138
2025-01-07 19:56:41,persegiMerah,238,284,147,139,45,42,43,37,2,5,True,0.383299098665811
2025-01-07 19:56:42,persegiMerah,245,278,149,142,96,95,96,90,0,5,True,0.3653523647769954
2025-01-07 19:56:42,Fail to pick,245,278,0,0,0,0,0,0,0,0,False,0
2025-01-07 19:56:42,persegiMerah,239,287,143,139,188,27,186,28,2,1,False,0.14776160857333767
2025-01-07 19:56:42,Fail to pick,239,287,0,0,0,0,0,0,0,0,False,0
2025-01-07 19:56:42,persegiMerah,247,285,151,140,177,7,177,7,0,0,True,0.25890601053093887
2025-01-07 19:56:42,Fail to pick,247,285,0,0,0,0,0,0,0,0,False,0
2025-01-07 19:56:42,persegiMerah,245,283,152,140,149,94,144,95,5,1,True,0.158041319704189
2025-01-07 19:56:42,Fail to pick,245,283,0,0,0,0,0,0,0,0,False,0
2025-01-07 19:56:42,persegiMerah,236,289,148,144,94,69,96,70,2,1,True,0.42451549061457927
2025-01-07 19:56:42,Fail to pick,236,289,0,0,0,0,0,0,0,0,False,0
2025-01-07 19:56:42,persegiMerah,233,291,146,143,160,80,160,77,0,3,True,0.3722712075096225
2025-01-07 19:56:42,Fail to pick,233,291,0,0,0,0,0,0,0,0,False,0
2025-01-07 19:56:42,persegiMerah,242,282,148,152,122,34,126,37,4,3,True,0.12373611746635378
2025-01-07 19:56:42,Fail to pick,242,282,0,0,0,0,0,0,0,0,False,0
2025-01-07 19:56:42,persegiMerah,228,297,147,140,191,43,193,43,2,0,True,0.3211403478533786
2025-01-07 19:56:43,persegiMerah,230,287,147,143,55,98,55,94,0,4,True,0.4769015463560745
2025-01-07 19:56:43,persegiMerah,237,281,144,139,180,34,176,34,4,0,True,0.38183115691984515
2025-01-07 19:56:43,Fail to pick,237,281,0,0,0,0,0,0,0,0,False,0
2025-01-07 19:56:43,persegiMerah,237,283,149,144,39,72,37,68,2,4,False,0.2871645233596931
2025-01-07 19:56:43,Fail to pick,237,283,0,0,0,0,0,0,0,0,False,0
2025-01-07 19:56:43,persegiMerah,234,285,148,140,119,74,117,77,2,3,False,0.1569488221448157
2025-01-07 19:56:43,Fail to pick,234,285,0,0,0,0,0,0,0,0,False,0
2025-01-07 19:56:43,persegiMerah,238,284,146,144,50,93,47,97,3,4,True,0.4157757406951037
2025-01-07 19:56:43,Fail to pick,238,284,0,0,0,0,0,0,0,0,False,0
2025-01-07 19:56:43,persegiMerah,232,284,144,140,39,67,39,62,0,5,True,0.3400137140206028
2025-01-07 19:56:43,Fail to pick,232,284,0,0,0,0,0,0,0,0,False,0
2025-01-07 19:56:43,persegiMerah,238,286,145,142,112,32,111,27,1,5,True,0.1346960069682461
2025-01-07 19:56:43,Fail to pick,238,286,0,0,0,0,0,0,0,0,False,0
2025-01-07 19:56:44,persegiMerah,237,284,147,140,99,69,100,69,1,0,True,0.4934936937152834
2025-01-07 19:56:44,Fail to pick,237,284,0,0,0,0,0,0,0,0,False,0
2025-01-07 19:56:44,persegiMerah,239,274,152,142,108,35,108,39,0,4,True,0.4381977013466486
2025-01-07 19:56:44,persegiMerah,236,286,148,140,181,1,181,-1,0,2,True,0.21660823914163194
2025-01-07 19:56:44,persegiMerah,232,286,150,140,157,47,152,48,5,1,True,0.1333470047310546
2025-01-07 19:56:44,Fail to pick,232,286,0,0,0,0,0,0,0,0,False,0
2025-01-07 19:56:44,persegiMerah,237,280,146,140,20,68,23,69,3,1,True,0.12432827945861696
2025-01-07 19:56:44,Fail to pick,237,280,0,0,0,0,0,0,0,0,False,0
2025-01-07 19:56:44,persegiMerah,228,280,144,141,116,58,119,53,3,5,True,0.35376845187261474
2025-01-07 19:56:44,Fail to pick,228,280,0,0,0,0,0,0,0,0,False,0
2025-01-07 19:56:44,persegiMerah,234,282,144,141,13,89,12,86,1,3,True,0.34843275758218384
2025-01-07 19:56:44,Fail to pick,234,282,0,0,0,0,0,0,0,0,False,0
2025-01-07 19:56:44,persegiMerah,244,274,149,141,1,22,-1,17,2,5,True,0.3530392300920504
2025-01-07 19:56:45,persegiMerah,228,280,145,142,5,19,4,18,1,1,True,0.34288612958176734
2025-01-07 19:56:45,persegiMerah,236,281,146,141,134,33,133,29,1,4,True,0.4640260045086857
2025-01-07 19:56:45,Fail to pick,236,281,0,0,0,0,0,0,0,0,False,0
2025-01-07 19:56:45,persegiMerah,233,280,148,143,63,80,58,81,5,1,True,0.12867020788810724
2025-01-07 19:56:45,Fail to pick,233,280,0,0,0,0,0,0,0,0,False,0
2025-01-07 19:56:45,persegiMerah,241,275,157,146,82,11,83,8,1,3,True,0.30603979887186006
2025-01-07 19:56:45,Fail to pick,241,275,0,0,0,0,0,0,0,0,False,0
2025-01-07 19:56:45,persegiMerah,230,281,144,144,104,25,106,28,2,3,True,0.4951724603774561
2025-01-07 19:56:45,persegiMerah,230,282,145,143,126,92,128,87,2,5,True,0.12983070544334502
2025-01-07 19:56:45,Fail to pick,230,282,0,0,0,0,0,0,0,0,False,0
2025-01-07 19:56:45,persegiMerah,243,280,152,141,76,40,78,43,2,3,True,0.17931855709577682
2025-01-07 19:56:45,persegiMerah,234,287,146,142,113,62,109,57,4,5,True,0.23325756435395242
2025-01-07 19:56:45,Fail to pick,234,287,0,0,0,0,0,0,0,0,False,0
2025-01-07 19:56:46,persegiMerah,236,283,149,141,50,28,54,29,4,1,True,0.17928659052446527
2025-01-07 19:56:46,Fail to pick,236,283,0,0,0,0,0,0,0,0,False,0
2025-01-07 19:56:46,persegiMerah,242,284,149,140,9,83,13,87,4,4,True,0.36214469448213693
2025-01-07 19:56:46,Fail to pick,242,284,0,0,0,0,0,0,0,0,False,0
2025-01-07 19:56:46,persegiMerah,235,279,143,147,29,68,32,63,3,5,True,0.4844027275015925
2025-01-07 19:56:46,Fail to pick,235,279,0,0,0,0,0,0,0,0,False,0
2025-01-07 19:56:46,persegiMerah,238,278,147,143,193,70,188,72,5,2,True,0.3623375892226096
2025-01-07 19:56:46,Fail to pick,238,278,0,0,0,0,0,0,0,0,False,0
2025-01-07 19:56:46,persegiMerah,232,282,143,138,162,29,160,24,2,5,True,0.38860392007915145
2025-01-07 19:56:46,Fail to pick,232,282,0,0,0,0,0,0,0,0,False,0
2025-01-07 19:56:46,persegiMerah,238,282,148,140,114,64,113,59,1,5,False,0.14649493110656803
2025-01-07 19:56:46,Fail to pick,238,282,0,0,0,0,0,0,0,0,False,0
2025-01-07 19:56:47,persegiMerah,234,280,142,140,57,19,60,18,3,1,True,0.39270963905571177
2025-01-07 19:56:47,Fail to pick,234,280,0,0,0,0,0,0,0,0,False,0
2025-01-07 19:56:47,persegiMerah,233,289,144,140,174,60,177,55,3,5,True,0.2377752898659963
2025-01-07 19:56:47,Fail to pick,233,289,0,0,0,0,0,0,0,0,False,0
2025-01-07 19:56:47,persegiMerah,232,285,141,141,48,76,49,77,1,1,True,0.2667322772704278
2025-01-07 19:56:47,Fail to pick,232,285,0,0,0,0,0,0,0,0,False,0
2025-01-07 19:56:47,persegiMerah,248,274,151,137,138,95,137,95,1,0,True,0.3984581572859135
2025-01-07 19:56:47,persegiMerah,238,282,147,137,155,82,155,81,0,1,True,0.4882358744495501
2025-01-07 19:56:47,persegiMerah,236,283,146,138,22,13,22,11,0,2,True,0.47193952162218467
2025-01-07 19:56:47,Fail to pick,236,283,0,0,0,0,0,0,0,0,False,0
2025-01-07 19:56:47,persegiMerah,230,286,146,143,88,33,87,29,1,4,True,0.18225098668893447
2025-01-07 19:56:47,Fail to pick,230,286,0,0,0,0,0,0,0,0,False,0
2025-01-07 19:56:47,persegiMerah,232,285,143,140,11,57,13,58,2,1,True,0.29526847748329044
2025-01-07 19:56:47,Fail to pick,232,285,0,0,0,0,0,0,0,0,False,0
2025-01-07 19:56:48,persegiMerah,236,282,146,146,138,61,137,61,1,0,True,0.15957121050364417
2025-01-07 19:56:48,Fail to pick,236,282,0,0,0,0,0,0,0,0,False,0
2025-01-07 19:56:48,persegiMerah,241,277,148,140,132,91,128,90,4,1,True,0.423503510722696
2025-01-07 19:56:48,Fail to pick,241,277,0,0,0,0,0,0,0,0,False,0
2025-01-07 19:56:48,persegiMerah,233,281,142,142,33,85,37,84,4,1,True,0.22985549211900877
2025-01-07 19:56:48,Fail to pick,233,281,0,0,0,0,0,0,0,0,False,0
2025-01-07 19:56:48,persegiMerah,239,278,146,149,158,76,161,80,3,4,True,0.28643258768015684
2025-01-07 19:56:48,Fail to pick,239,278,0,0,0,0,0,0,0,0,False,0
2025-01-07 19:56:48,persegiMerah,246,277,151,142,23,23,19,21,4,2,True,0.10900537776038513
2025-01-07 19:56:48,Fail to pick,246,277,0,0,0,0,0,0,0,0,False,0
2025-01-07 19:56:48,persegiMerah,235,277,141,141,115,43,110,43,5,0,True,0.10266370764896848
2025-01-07 19:56:48,persegiMerah,234,287,144,141,169,51,167,53,2,2,True,0.10697291974333895
2025-01-07 19:56:49,persegiMerah,237,284,145,139,59,13,59,17,0,4,True,0.30885617176575264
2025-01-07 19:56:49,Fail to pick,237,284,0,0,0,0,0,0,0,0,False,0
2025-01-07 19:56:49,persegiMerah,245,272,151,145,185,64,183,59,2,5,True,0.23842382874374324
2025-01-07 19:56:49,persegiMerah,240,274,148,143,160,98,160,96,0,2,True,0.23400232694750478
2025-01-07 19:56:49,Fail to pick,240,274,0,0,0,0,0,0,0,0,False,0
2025-01-07 19:56:49,persegiMerah,242,272,152,143,20,46,19,44,1,2,True,0.1367532450214971
2025-01-07 19:56:49,Fail to pick,242,272,0,0,0,0,0,0,0,0,False,0
2025-01-07 19:56:49,persegiMerah,240,272,146,143,67,69,68,67,1,2,True,0.20127717101420567
2025-01-07 19:56:49,Fail to pick,240,272,0,0,0,0,0,0,0,0,False,0
2025-01-07 19:56:49,persegiMerah,237,281,147,144,31,57,31,61,0,4,True,0.4814414411276349
2025-01-07 19:56:49,Fail to pick,237,281,0,0,0,0,0,0,0,0,False,0
2025-01-07 19:56:49,persegiMerah,236,275,150,142,153,47,152,42,1,5,False,0.349405675898683
2025-01-07 19:56:49,Fail to pick,236,275,0,0,0,0,0,0,0,0,False,0
2025-01-07 19:56:49,persegiMerah,233,277,142,145,176,53,175,52,1,1,True,0.3380199423577137
2025-01-07 19:56:49,Fail to pick,233,277,0,0,0,0,0,0,0,0,False,0
2025-01-07 19:56:50,persegiMerah,237,280,149,141,107,36,108,39,1,3,True,0.1174346330731396
2025-01-07 19:56:50,Fail to pick,237,280,0,0,0,0,0,0,0,0,False,0
2025-01-07 19:56:50,persegiMerah,228,281,143,140,43,64,43,62,0,2,True,0.4332413101742477
2025-01-07 19:56:50,Fail to pick,228,281,0,0,0,0,0,0,0,0,False,0
2025-01-07 19:56:50,persegiMerah,233,283,146,140,192,42,188,44,4,2,False,0.22666542072964568
2025-01-07 19:56:50,Fail to pick,233,283,0,0,0,0,0,0,0,0,False,0
2025-01-07 19:56:50,persegiMerah,239,281,147,138,81,25,80,23,1,2,True,0.20234684873214911
2025-01-07 19:56:50,Fail to pick,239,281,0,0,0,0,0,0,0,0,False,0
2025-01-07 19:56:50,persegiMerah,234,281,144,144,131,41,135,44,4,3,False,0.37460075672784476
2025-01-07 19:56:50,Fail to pick,234,281,0,0,0,0,0,0,0,0,False,0
2025-01-07 19:56:50,persegiMerah,238,283,145,140,7,5,9,7,2,2,True,0.47617073552200573
2025-01-07 19:56:50,Fail to pick,238,283,0,0,0,0,0,0,0,0,False,0
2025-01-07 19:56:50,persegiMerah,236,285,149,140,80,30,77,25,3,5,True,0.48040673918561816
2025-01-07 19:56:50,Fail to pick,236,285,0,0,0,0,0,0,0,0,False,0
2025-01-07 19:56:51,persegiMerah,236,284,148,140,71,14,67,18,4,4,True,0.224469435132341
2025-01-07 19:56:51,Fail to pick,236,284,0,0,0,0,0,0,0,0,False,0
2025-01-07 19:56:51,persegiMerah,239,285,146,142,140,90,136,90,4,0,True,0.46397804017060074
2025-01-07 19:56:51,Fail to pick,239,285,0,0,0,0,0,0,0,0,False,0
2025-01-07 19:56:51,persegiMerah,234,280,143,143,74,32,73,35,1,3,True,0.10077878095732484
2025-01-07 19:56:51,Fail to pick,234,280,0,0,0,0,0,0,0,0,False,0
2025-01-07 19:56:51,persegiMerah,238,283,142,139,8,32,11,27,3,5,True,0.12133990649568478
2025-01-07 19:56:51,Fail to pick,238,283,0,0,0,0,0,0,0,0,False,0
2025-01-07 19:56:51,persegiMerah,229,289,145,141,115,82,114,83,1,1,True,0.2542233111974584
2025-01-07 19:56:51,Fail to pick,229,289,0,0,0,0,0,0,0,0,False,0
2025-01-07 19:56:51,persegiMerah,238,286,146,140,52,77,54,73,2,4,True,0.36308270652965513
2025-01-07 19:56:51,Fail to pick,238,286,0,0,0,0,0,0,0,0,False,0
2025-01-07 19:56:51,persegiMerah,231,284,143,139,184,21,183,16,1,5,False,0.1389608887682217
2025-01-07 19:56:51,Fail to pick,231,284,0,0,0,0,0,0,0,0,False,0
2025-01-07 19:56:51,persegiMerah,231,287,145,140,145,4,143,8,2,4,True,0.3893766356256746
2025-01-07 19:56:51,Fail to pick,231,287,0,0,0,0,0,0,0,0,False,0
2025-01-07 19:56:52,persegiMerah,236,281,144,140,147,76,149,76,2,0,True,0.3443977229224977
2025-01-07 19:56:52,Fail to pick,236,281,0,0,0,0,0,0,0,0,False,0
2025-01-07 19:56:52,persegiMerah,233,285,143,141,10,69,5,65,5,4,True,0.43373903649704804
2025-01-07 19:56:52,Fail to pick,233,285,0,0,0,0,0,0,0,0,False,0
2025-01-07 19:56:52,persegiMerah,233,278,144,142,64,23,59,22,5,1,True,0.16134655070202839
2025-01-07 19:56:52,Fail to pick,233,278,0,0,0,0,0,0,0,0,False,0
2025-01-07 19:56:52,persegiMerah,235,281,145,145,138,40,133,37,5,3,True,0.24795569759111655
2025-01-07 19:56:52,Fail to pick,235,281,0,0,0,0,0,0,0,0,False,0
2025-01-07 19:56:52,persegiMerah,229,285,143,143,65,60,66,56,1,4,True,0.23768887605973374
2025-01-07 19:56:52,Fail to pick,229,285,0,0,0,0,0,0,0,0,False,0
2025-01-07 19:56:52,persegiMerah,231,284,144,143,134,72,130,71,4,1,True,0.3420649382771196
2025-01-07 19:56:52,Fail to pick,231,284,0,0,0,0,0,0,0,0,False,0
2025-01-07 19:56:52,persegiMerah,233,279,141,140,46,8,42,6,4,2,True,0.4100025914586093
2025-01-07 19:56:52,Fail to pick,233,279,0,0,0,0,0,0,0,0,False,0
2025-01-07 19:56:53,persegiMerah,237,279,144,141,107,7,109,10,2,3,True,0.3600149515965839
2025-01-07 19:56:53,Fail to pick,237,279,0,0,0,0,0,0,0,0,False,0
2025-01-07 19:56:53,persegiMerah,242,283,151,143,70,62,73,64,3,2,True,0.12854643533601082
2025-01-07 19:56:53,Fail to pick,242,283,0,0,0,0,0,0,0,0,False,0
2025-01-07 19:56:53,persegiMerah,232,285,144,137,13,88,14,91,1,3,True,0.2161096043031567
2025-01-07 19:56:53,persegiMerah,232,277,143,143,184,94,184,98,0,4,True,0.21579551752265563
2025-01-07 19:56:53,Fail to pick,232,277,0,0,0,0,0,0,0,0,False,0
2025-01-07 19:56:53,persegiMerah,239,276,149,141,168,36,165,36,3,0,True,0.28905749441466766
2025-01-07 19:56:53,Fail to pick,239,276,0,0,0,0,0,0,0,0,False,0
2025-01-07 19:56:53,persegiMerah,234,280,147,151,119,19,118,19,1,0,True,0.405402790280177
2025-01-07 19:56:53,Fail to pick,234,280,0,0,0,0,0,0,0,0,False,0
2025-01-07 19:56:53,persegiMerah,244,272,155,138,101,11,105,7,4,4,True,0.26139028916671203
2025-01-07 19:56:53,persegiMerah,248,269,151,140,50,71,49,74,1,3,True,0.3927979710959495
2025-01-07 19:56:53,Fail to pick,248,269,0,0,0,0,0,0,0,0,False,0
2025-01-07 19:56:54,persegiMerah,248,271,151,137,0,60,-2,63,2,3,True,0.2237560419632295
2025-01-07 19:56:54,Fail to pick,248,271,0,0,0,0,0,0,0,0,False,0
2025-01-07 19:56:54,persegiMerah,245,273,152,141,64,32,60,32,4,0,True,0.10137459221785675
2025-01-07 19:56:54,Fail to pick,245,273,0,0,0,0,0,0,0,0,False,0
2025-01-07 19:56:54,persegiMerah,249,270,154,139,193,33,188,31,5,2,True,0.17159136704139044
2025-01-07 19:56:54,Fail to pick,249,270,0,0,0,0,0,0,0,0,False,0
2025-01-07 19:56:54,persegiMerah,245,268,156,142,158,32,155,28,3,4,True,0.33585793370292094
2025-01-07 19:56:54,Fail to pick,245,268,0,0,0,0,0,0,0,0,False,0
2025-01-07 19:56:54,persegiMerah,243,275,155,141,38,87,39,90,1,3,True,0.21094376965974948
2025-01-07 19:56:54,Fail to pick,243,275,0,0,0,0,0,0,0,0,False,0
2025-01-07 19:56:54,persegiMerah,247,271,150,136,16,95,17,95,1,0,True,0.4699404865074117
2025-01-07 19:56:54,Fail to pick,247,271,0,0,0,0,0,0,0,0,False,0
2025-01-07 19:56:54,persegiMerah,253,270,144,135,125,83,123,86,2,3,False,0.1956767734737388
2025-01-07 19:56:54,Fail to pick,253,270,0,0,0,0,0,0,0,0,False,0
2025-01-07 19:56:55,persegiMerah,249,275,145,134,138,58,135,59,3,1,True,0.150818380021413
2025-01-07 19:56:55,Fail to pick,249,275,0,0,0,0,0,0,0,0,False,0
2025-01-07 19:56:55,persegiMerah,253,267,148,136,195,58,197,54,2,4,True,0.10959758809543461
2025-01-07 19:56:55,Fail to pick,253,267,0,0,0,0,0,0,0,0,False,0
2025-01-07 19:56:55,persegiMerah,249,273,147,133,103,25,101,21,2,4,True,0.3837624183689117
2025-01-07 19:56:55,Fail to pick,249,273,0,0,0,0,0,0,0,0,False,0
2025-01-07 19:56:55,persegiMerah,252,275,145,132,29,67,24,62,5,5,True,0.15520808477462614
2025-01-07 19:56:55,Fail to pick,252,275,0,0,0,0,0,0,0,0,False,0
2025-01-07 19:56:55,persegiMerah,252,278,143,134,118,39,122,37,4,2,True,0.4983740163215864
2025-01-07 19:56:55,Fail to pick,252,278,0,0,0,0,0,0,0,0,False,0
2025-01-07 19:56:55,persegiMerah,258,277,144,131,153,17,154,13,1,4,True,0.24578567611287575
2025-01-07 19:56:55,Fail to pick,258,277,0,0,0,0,0,0,0,0,False,0
2025-01-07 19:56:55,persegiMerah,252,277,143,130,176,57,172,52,4,5,True,0.24985081615343938
2025-01-07 19:56:55,Fail to pick,252,277,0,0,0,0,0,0,0,0,False,0
2025-01-07 19:56:55,persegiMerah,253,277,146,129,196,16,198,11,2,5,True,0.15165860307276935
2025-01-07 19:56:55,Fail to pick,253,277,0,0,0,0,0,0,0,0,False,0
2025-01-07 19:56:56,persegiMerah,258,276,144,131,198,32,198,35,0,3,True,0.4409419986713605
2025-01-07 19:56:56,Fail to pick,258,276,0,0,0,0,0,0,0,0,False,0
2025-01-07 19:56:56,persegiMerah,251,276,144,132,88,25,90,27,2,2,False,0.26790404291390657
2025-01-07 19:56:56,Fail to pick,251,276,0,0,0,0,0,0,0,0,False,0
2025-01-07 19:56:56,persegiMerah,247,275,150,134,119,42,120,40,1,2,True,0.2091341110802187
2025-01-07 19:56:56,Fail to pick,247,275,0,0,0,0,0,0,0,0,False,0
2025-01-07 19:56:56,persegiMerah,250,277,146,133,1,20,-3,15,4,5,True,0.4424675705560466
2025-01-07 19:56:56,Fail to pick,250,277,0,0,0,0,0,0,0,0,False,0
2025-01-07 19:56:56,persegiMerah,249,275,148,136,14,91,9,93,5,2,True,0.22845984921377102
2025-01-07 19:56:56,Fail to pick,249,275,0,0,0,0,0,0,0,0,False,0
2025-01-07 19:56:56,persegiMerah,235,292,136,135,36,85,34,84,2,1,True,0.12287343303860312
2025-01-07 19:56:57,persegiMerah,234,288,137,139,24,61,25,57,1,4,True,0.4462739923383573
2025-01-07 19:56:57,Fail to pick,234,288,0,0,0,0,0,0,0,0,False,0
2025-01-07 19:56:57,persegiMerah,226,292,138,135,24,27,24,23,0,4,True,0.1754949176199538
2025-01-07 19:56:57,Fail to pick,226,292,0,0,0,0,0,0,0,0,False,0
2025-01-07 19:56:57,persegiMerah,231,286,138,140,134,62,133,60,1,2,True,0.18917432781708815
2025-01-07 19:56:57,Fail to pick,231,286,0,0,0,0,0,0,0,0,False,0
2025-01-07 19:56:57,persegiMerah,250,279,140,136,114,25,110,22,4,3,True,0.10375701309422625
2025-01-07 19:56:57,persegiMerah,248,273,144,135,58,16,60,14,2,2,True,0.2150634024635422
2025-01-07 19:56:57,Fail to pick,248,273,0,0,0,0,0,0,0,0,False,0
2025-01-07 19:56:57,persegiMerah,243,289,147,141,14,65,9,69,5,4,True,0.30815840411173134
2025-01-07 19:56:58,persegiMerah,253,282,146,138,108,99,107,101,1,2,True,0.13702075416689719
2025-01-07 19:56:58,persegiMerah,258,291,152,146,121,22,117,18,4,4,True,0.3988854055149035
2025-01-07 19:56:58,Fail to pick,258,291,0,0,0,0,0,0,0,0,False,0
2025-01-07 19:56:58,persegiMerah,237,291,144,142,146,82,141,84,5,2,True,0.1232141567706877
2025-01-07 19:56:58,persegiMerah,221,271,152,140,199,95,195,96,4,1,True,0.16897007912617318
2025-01-07 19:56:58,persegiMerah,243,263,154,139,135,59,131,58,4,1,True,0.36296283893604453
2025-01-07 19:56:58,persegiMerah,236,273,152,140,159,50,162,48,3,2,True,0.36964256482723146
2025-01-07 19:56:58,persegiMerah,240,268,150,139,187,41,188,42,1,1,True,0.49303612976265454
2025-01-07 19:56:58,Fail to pick,240,268,0,0,0,0,0,0,0,0,False,0
2025-01-07 19:56:58,persegiMerah,239,269,151,139,78,25,73,27,5,2,True,0.4852589794567923
2025-01-07 19:56:59,Fail to pick,239,269,0,0,0,0,0,0,0,0,False,0
2025-01-07 19:56:59,persegiMerah,234,280,146,139,51,57,49,60,2,3,False,0.4765786996805098
2025-01-07 19:56:59,persegiMerah,242,275,152,140,187,76,183,74,4,2,True,0.367058939449898
2025-01-07 19:56:59,Fail to pick,242,275,0,0,0,0,0,0,0,0,False,0
2025-01-07 19:56:59,persegiMerah,242,276,148,138,160,15,156,17,4,2,False,0.17717445183870395
2025-01-07 19:56:59,Fail to pick,242,276,0,0,0,0,0,0,0,0,False,0
2025-01-07 19:56:59,persegiMerah,227,278,144,143,33,63,37,60,4,3,True,0.144910304714896
2025-01-07 19:56:59,persegiMerah,239,273,152,143,8,76,11,80,3,4,True,0.3993330294256465
2025-01-07 19:56:59,persegiMerah,243,267,153,145,0,74,-5,78,5,4,True,0.3525899649342358
2025-01-07 19:56:59,Fail to pick,243,267,0,0,0,0,0,0,0,0,False,0
2025-01-07 19:56:59,persegiMerah,236,267,152,138,139,64,143,67,4,3,True,0.36581232123274177
2025-01-07 19:56:59,Fail to pick,236,267,0,0,0,0,0,0,0,0,False,0
2025-01-07 19:56:59,persegiMerah,233,263,146,141,90,28,93,32,3,4,True,0.4677506554555302
2025-01-07 19:56:59,Fail to pick,233,263,0,0,0,0,0,0,0,0,False,0
2025-01-07 19:57:00,persegiMerah,224,267,150,140,121,18,117,15,4,3,True,0.4514577873550184
2025-01-07 19:57:00,Fail to pick,224,267,0,0,0,0,0,0,0,0,False,0
2025-01-07 19:57:00,persegiMerah,225,265,149,141,165,11,168,6,3,5,True,0.14383604068722877
2025-01-07 19:57:00,Fail to pick,225,265,0,0,0,0,0,0,0,0,False,0
2025-01-07 19:57:00,persegiMerah,228,264,149,143,193,96,192,98,1,2,False,0.4718920586742078
2025-01-07 19:57:00,Fail to pick,228,264,0,0,0,0,0,0,0,0,False,0
2025-01-07 19:57:00,persegiMerah,228,257,149,146,5,59,0,60,5,1,False,0.21932100119377346
2025-01-07 19:57:00,Fail to pick,228,257,0,0,0,0,0,0,0,0,False,0
2025-01-07 19:57:00,persegiMerah,236,264,155,139,171,60,172,57,1,3,True,0.32651835280332936
2025-01-07 19:57:00,Fail to pick,236,264,0,0,0,0,0,0,0,0,False,0
2025-01-07 19:57:00,persegiMerah,236,265,154,137,8,43,6,43,2,0,True,0.2743466587160982
2025-01-07 19:57:00,Fail to pick,236,265,0,0,0,0,0,0,0,0,False,0
2025-01-07 19:57:00,persegiMerah,242,268,152,139,74,98,70,93,4,5,True,0.23914251356801064
2025-01-07 19:57:00,Fail to pick,242,268,0,0,0,0,0,0,0,0,False,0
2025-01-07 19:57:00,persegiMerah,243,265,150,141,86,33,87,30,1,3,True,0.21975667161610427
2025-01-07 19:57:00,Fail to pick,243,265,0,0,0,0,0,0,0,0,False,0
2025-01-07 19:57:01,persegiMerah,243,272,151,140,171,24,170,21,1,3,True,0.364572945231484
2025-01-07 19:57:01,Fail to pick,243,272,0,0,0,0,0,0,0,0,False,0
2025-01-07 19:57:01,persegiMerah,231,283,140,143,189,11,186,10,3,1,False,0.4575014763519414
2025-01-07 19:57:01,persegiMerah,237,281,149,143,71,69,75,73,4,4,True,0.27007236430840864
2025-01-07 19:57:01,Fail to pick,237,281,0,0,0,0,0,0,0,0,False,0
2025-01-07 19:57:01,persegiMerah,251,276,147,143,36,4,36,2,0,2,True,0.4682345481725323
2025-01-07 19:57:01,persegiMerah,246,266,154,137,53,35,56,30,3,5,True,0.36904025669548923
2025-01-07 19:57:01,persegiMerah,244,272,153,138,130,22,134,20,4,2,True,0.3398421309778861
2025-01-07 19:57:01,Fail to pick,244,272,0,0,0,0,0,0,0,0,False,0
2025-01-07 19:57:01,persegiMerah,242,269,155,139,192,79,194,81,2,2,True,0.21248076084501075
2025-01-07 19:57:01,Fail to pick,242,269,0,0,0,0,0,0,0,0,False,0
2025-01-07 19:57:01,persegiMerah,236,268,155,138,76,40,76,37,0,3,True,0.2605945549221932
2025-01-07 19:57:01,Fail to pick,236,268,0,0,0,0,0,0,0,0,False,0
2025-01-07 19:57:02,persegiMerah,237,265,156,135,100,74,101,75,1,1,True,0.27794961835501547
2025-01-07 19:57:02,Fail to pick,237,265,0,0,0,0,0,0,0,0,False,0
2025-01-07 19:57:02,persegiMerah,234,263,154,139,90,6,94,9,4,3,True,0.20107868682718927
2025-01-07 19:57:02,Fail to pick,234,263,0,0,0,0,0,0,0,0,False,0
2025-01-07 19:57:02,persegiMerah,233,266,153,137,181,13,178,12,3,1,True,0.44063351053727895
2025-01-07 19:57:02,Fail to pick,233,266,0,0,0,0,0,0,0,0,False,0
2025-01-07 19:57:02,persegiMerah,235,269,151,137,59,20,62,17,3,3,True,0.28958046178412206
2025-01-07 19:57:02,Fail to pick,235,269,0,0,0,0,0,0,0,0,False,0
2025-01-07 19:57:02,persegiMerah,231,266,147,137,75,28,74,24,1,4,True,0.3954568086815843
2025-01-07 19:57:02,Fail to pick,231,266,0,0,0,0,0,0,0,0,False,0
2025-01-07 19:57:02,persegiMerah,237,266,157,145,53,87,48,82,5,5,True,0.2605339714087618
2025-01-07 19:57:02,Fail to pick,237,266,0,0,0,0,0,0,0,0,False,0
2025-01-07 19:57:02,persegiMerah,241,272,155,135,2,72,4,69,2,3,True,0.19399421169105702
2025-01-07 19:57:02,Fail to pick,241,272,0,0,0,0,0,0,0,0,False,0
2025-01-07 19:57:02,persegiMerah,241,276,150,134,15,67,12,65,3,2,True,0.14360670869775105
2025-01-07 19:57:02,Fail to pick,241,276,0,0,0,0,0,0,0,0,False,0
2025-01-07 19:57:03,persegiMerah,243,273,154,135,100,68,103,71,3,3,True,0.3643011640943302
2025-01-07 19:57:03,Fail to pick,243,273,0,0,0,0,0,0,0,0,False,0
2025-01-07 19:57:03,persegiMerah,245,272,158,136,17,7,19,7,2,0,False,0.2215636675360495
2025-01-07 19:57:03,Fail to pick,245,272,0,0,0,0,0,0,0,0,False,0
2025-01-07 19:57:03,persegiMerah,252,274,147,134,64,21,67,25,3,4,True,0.2745159379299883
2025-01-07 19:57:03,Fail to pick,252,274,0,0,0,0,0,0,0,0,False,0
2025-01-07 19:57:03,persegiMerah,245,274,154,137,47,25,44,28,3,3,True,0.2581559733791517
2025-01-07 19:57:03,Fail to pick,245,274,0,0,0,0,0,0,0,0,False,0
2025-01-07 19:57:03,persegiMerah,243,277,153,132,79,94,74,92,5,2,False,0.3887270234979189
2025-01-07 19:57:03,Fail to pick,243,277,0,0,0,0,0,0,0,0,False,0
2025-01-07 19:57:03,persegiMerah,243,275,153,134,66,21,69,21,3,0,True,0.4175197349462678
2025-01-07 19:57:03,Fail to pick,243,275,0,0,0,0,0,0,0,0,False,0
2025-01-07 19:57:03,persegiMerah,251,270,151,137,137,0,134,3,3,3,True,0.4248619132314012
2025-01-07 19:57:03,Fail to pick,251,270,0,0,0,0,0,0,0,0,False,0
2025-01-07 19:57:03,persegiMerah,245,276,155,133,102,52,105,53,3,1,True,0.3104475776083676
2025-01-07 19:57:03,Fail to pick,245,276,0,0,0,0,0,0,0,0,False,0
2025-01-07 19:57:04,persegiMerah,246,270,153,137,163,94,166,92,3,2,True,0.28917144537482603
2025-01-07 19:57:04,Fail to pick,246,270,0,0,0,0,0,0,0,0,False,0
2025-01-07 19:57:04,persegiMerah,246,270,153,137,107,15,110,15,3,0,True,0.27972098593640365
2025-01-07 19:57:04,Fail to pick,246,270,0,0,0,0,0,0,0,0,False,0
2025-01-07 19:57:04,persegiMerah,261,289,157,142,66,78,70,76,4,2,True,0.4952994159954509
2025-01-07 19:57:04,persegiMerah,219,256,155,135,107,41,102,37,5,4,True,0.4486023788239366
2025-01-07 19:57:04,persegiMerah,214,263,149,136,1,40,3,35,2,5,True,0.4283873141457848
2025-01-07 19:57:04,Fail to pick,214,263,0,0,0,0,0,0,0,0,False,0
2025-01-07 19:57:04,persegiMerah,210,257,157,133,118,99,120,98,2,1,True,0.19963251433923446
2025-01-07 19:57:04,Fail to pick,210,257,0,0,0,0,0,0,0,0,False,0
2025-01-07 19:57:05,persegiMerah,210,257,157,133,109,8,105,11,4,3,True,0.21020427884239307
2025-01-07 19:57:05,Fail to pick,210,257,0,0,0,0,0,0,0,0,False,0
2025-01-07 19:57:05,persegiMerah,212,258,153,135,44,24,39,22,5,2,True,0.3407868451638152
2025-01-07 19:57:05,Fail to pick,212,258,0,0,0,0,0,0,0,0,False,0
2025-01-07 19:57:05,persegiMerah,212,258,153,135,141,69,139,71,2,2,True,0.3365273883149793
2025-01-07 19:57:05,Fail to pick,212,258,0,0,0,0,0,0,0,0,False,0
2025-01-07 19:57:05,persegiMerah,214,259,152,137,58,40,54,38,4,2,True,0.4069585738125088
2025-01-07 19:57:05,Fail to pick,214,259,0,0,0,0,0,0,0,0,False,0
2025-01-07 19:57:06,persegiMerah,211,260,154,135,199,53,202,56,3,3,True,0.4951831709234241
2025-01-07 19:57:06,Fail to pick,211,260,0,0,0,0,0,0,0,0,False,0
2025-01-07 19:57:06,persegiMerah,207,254,151,134,184,32,184,34,0,2,True,0.2773969602464187
2025-01-07 19:57:06,Fail to pick,207,254,0,0,0,0,0,0,0,0,False,0
2025-01-07 19:57:06,persegiMerah,207,254,156,134,7,84,9,80,2,4,True,0.4631751320440066
2025-01-07 19:57:06,Fail to pick,207,254,0,0,0,0,0,0,0,0,False,0
2025-01-07 19:57:06,persegiMerah,214,257,153,134,127,90,126,91,1,1,True,0.3437236244337225
2025-01-07 19:57:06,Fail to pick,214,257,0,0,0,0,0,0,0,0,False,0
2025-01-07 19:57:06,persegiMerah,216,273,143,135,119,20,121,16,2,4,True,0.2172324569350088
2025-01-07 19:57:07,persegiMerah,229,266,148,134,120,7,124,5,4,2,False,0.20559169337085537
2025-01-07 19:57:07,persegiMerah,232,266,145,133,1,19,1,15,0,4,True,0.2140508813166061
2025-01-07 19:57:07,Fail to pick,232,266,0,0,0,0,0,0,0,0,False,0
2025-01-07 19:57:07,persegiMerah,221,266,146,134,81,3,77,0,4,3,True,0.16897116277565738
2025-01-07 19:57:07,persegiMerah,213,258,146,132,184,77,182,72,2,5,True,0.30301808391105345
2025-01-07 19:57:07,Fail to pick,213,258,0,0,0,0,0,0,0,0,False,0
2025-01-07 19:57:07,persegiMerah,215,259,148,134,185,86,183,82,2,4,True,0.3358328872523688
2025-01-07 19:57:07,Fail to pick,215,259,0,0,0,0,0,0,0,0,False,0
2025-01-07 19:57:07,persegiMerah,243,294,150,139,77,66,74,64,3,2,True,0.267965271836985
2025-01-07 19:57:08,persegiMerah,241,267,148,135,13,63,12,61,1,2,True,0.38985593457912415
2025-01-07 19:57:08,persegiMerah,247,272,153,140,49,5,46,4,3,1,True,0.10825843368602835
2025-01-07 19:57:08,Fail to pick,247,272,0,0,0,0,0,0,0,0,False,0
2025-01-07 19:57:08,persegiMerah,254,284,150,139,145,93,142,91,3,2,True,0.1961772945958396
2025-01-07 19:57:08,persegiMerah,268,287,150,142,66,98,61,97,5,1,True,0.26292796188586487
2025-01-07 19:57:08,persegiMerah,253,298,145,144,26,76,30,74,4,2,True,0.12949954400696148
2025-01-07 19:57:08,persegiMerah,265,299,149,144,120,67,122,70,2,3,True,0.4046622394468332
2025-01-07 19:57:08,persegiMerah,254,309,151,143,57,61,53,57,4,4,True,0.1622602358818066
2025-01-07 19:57:09,persegiMerah,264,302,146,144,170,32,170,29,0,3,True,0.3183502372545217
2025-01-07 19:57:09,persegiMerah,259,306,145,137,168,74,163,75,5,1,True,0.33830243614356237
2025-01-07 19:57:09,Fail to pick,259,306,0,0,0,0,0,0,0,0,False,0
2025-01-07 19:57:09,persegiMerah,260,299,145,139,118,8,117,12,1,4,False,0.2728454421382106
2025-01-07 19:57:09,Fail to pick,260,299,0,0,0,0,0,0,0,0,False,0
2025-01-07 19:57:09,persegiMerah,260,301,144,140,83,67,86,68,3,1,False,0.18162886767485753
2025-01-07 19:57:09,Fail to pick,260,301,0,0,0,0,0,0,0,0,False,0
2025-01-07 19:57:09,persegiMerah,248,302,150,137,122,6,120,1,2,5,False,0.13778611908406557
2025-01-07 19:57:09,persegiMerah,251,303,143,136,174,3,172,7,2,4,True,0.4857863960624744
2025-01-07 19:57:09,Fail to pick,251,303,0,0,0,0,0,0,0,0,False,0
2025-01-07 19:57:09,persegiMerah,251,303,141,138,116,98,112,102,4,4,True,0.29988526171161645
2025-01-07 19:57:09,Fail to pick,251,303,0,0,0,0,0,0,0,0,False,0
2025-01-07 19:57:09,persegiMerah,256,306,143,137,19,33,21,31,2,2,True,0.42141144510696993
2025-01-07 19:57:09,Fail to pick,256,306,0,0,0,0,0,0,0,0,False,0
2025-01-07 19:57:10,persegiMerah,255,309,141,138,95,6,90,1,5,5,False,0.1990737170014274
2025-01-07 19:57:10,Fail to pick,255,309,0,0,0,0,0,0,0,0,False,0
2025-01-07 19:57:10,persegiMerah,263,301,147,139,70,97,66,99,4,2,True,0.45434971469913743
2025-01-07 19:57:10,Fail to pick,263,301,0,0,0,0,0,0,0,0,False,0
2025-01-07 19:57:10,persegiMerah,259,303,142,139,153,26,153,26,0,0,True,0.12620203905678815
2025-01-07 19:57:10,Fail to pick,259,303,0,0,0,0,0,0,0,0,False,0
2025-01-07 19:57:10,persegiMerah,265,299,152,139,36,10,38,9,2,1,True,0.44385757887472155
2025-01-07 19:57:10,Fail to pick,265,299,0,0,0,0,0,0,0,0,False,0
2025-01-07 19:57:10,persegiMerah,270,298,153,138,11,81,6,76,5,5,True,0.13908890333169033
2025-01-07 19:57:10,Fail to pick,270,298,0,0,0,0,0,0,0,0,False,0
2025-01-07 19:57:10,persegiMerah,274,297,146,137,97,71,93,66,4,5,True,0.2760361115445725
2025-01-07 19:57:10,Fail to pick,274,297,0,0,0,0,0,0,0,0,False,0
2025-01-07 19:57:10,persegiMerah,260,302,144,141,121,43,125,43,4,0,True,0.10574291054939905
2025-01-07 19:57:10,persegiMerah,248,306,137,135,66,44,67,42,1,2,True,0.4700891769898575
2025-01-07 19:57:11,persegiMerah,255,304,139,135,101,33,103,30,2,3,True,0.3218009777323737
2025-01-07 19:57:11,Fail to pick,255,304,0,0,0,0,0,0,0,0,False,0
2025-01-07 19:57:11,persegiMerah,269,295,147,133,4,31,8,29,4,2,True,0.3643296095715578
2025-01-07 19:57:11,persegiMerah,267,286,145,137,79,21,80,25,1,4,True,0.43076939262220193
2025-01-07 19:57:11,Fail to pick,267,286,0,0,0,0,0,0,0,0,False,0
2025-01-07 19:57:11,persegiMerah,253,271,141,132,197,19,201,15,4,4,True,0.25842376187260896
2025-01-07 19:57:11,persegiMerah,255,275,144,131,39,45,34,45,5,0,True,0.39433117856641775
2025-01-07 19:57:11,Fail to pick,255,275,0,0,0,0,0,0,0,0,False,0
2025-01-07 19:57:11,persegiMerah,258,273,145,132,24,31,22,30,2,1,True,0.3523989395253967
2025-01-07 19:57:11,Fail to pick,258,273,0,0,0,0,0,0,0,0,False,0
2025-01-07 19:57:11,persegiMerah,253,274,143,134,109,90,104,92,5,2,True,0.13041751310592026
2025-01-07 19:57:11,Fail to pick,253,274,0,0,0,0,0,0,0,0,False,0
2025-01-07 19:57:11,persegiMerah,252,274,142,134,79,32,78,28,1,4,True,0.4306151406493888
2025-01-07 19:57:11,Fail to pick,252,274,0,0,0,0,0,0,0,0,False,0
2025-01-07 19:57:12,persegiMerah,249,278,143,130,131,90,132,88,1,2,False,0.12527506845148753
2025-01-07 19:57:12,Fail to pick,249,278,0,0,0,0,0,0,0,0,False,0
2025-01-07 19:57:12,persegiMerah,255,276,143,131,32,52,31,50,1,2,True,0.3154154122031022
2025-01-07 19:57:12,Fail to pick,255,276,0,0,0,0,0,0,0,0,False,0
2025-01-07 19:57:12,persegiMerah,255,273,143,129,163,32,161,34,2,2,True,0.40013913366507403
2025-01-07 19:57:12,Fail to pick,255,273,0,0,0,0,0,0,0,0,False,0
2025-01-07 19:57:12,persegiMerah,248,275,147,133,172,22,170,25,2,3,False,0.2220156324202323
2025-01-07 19:57:12,Fail to pick,248,275,0,0,0,0,0,0,0,0,False,0
2025-01-07 19:57:12,persegiMerah,243,274,153,135,156,91,160,93,4,2,True,0.2359550183816102
2025-01-07 19:57:12,Fail to pick,243,274,0,0,0,0,0,0,0,0,False,0
2025-01-07 19:57:12,persegiMerah,249,276,144,132,117,65,119,68,2,3,True,0.40361695085337657
2025-01-07 19:57:12,Fail to pick,249,276,0,0,0,0,0,0,0,0,False,0
2025-01-07 19:57:12,persegiMerah,254,276,144,132,80,35,75,33,5,2,True,0.35156067706282423
2025-01-07 19:57:12,Fail to pick,254,276,0,0,0,0,0,0,0,0,False,0
2025-01-07 19:57:13,persegiMerah,250,275,147,132,49,14,51,16,2,2,True,0.37489967266520896
2025-01-07 19:57:13,Fail to pick,250,275,0,0,0,0,0,0,0,0,False,0
2025-01-07 19:57:13,persegiMerah,247,269,145,132,165,73,168,69,3,4,False,0.4634695871139968
2025-01-07 19:57:13,Fail to pick,247,269,0,0,0,0,0,0,0,0,False,0
2025-01-07 19:57:13,persegiMerah,241,266,147,135,145,95,143,91,2,4,True,0.3107020051545928
2025-01-07 19:57:13,Fail to pick,241,266,0,0,0,0,0,0,0,0,False,0
2025-01-07 19:57:13,persegiMerah,238,268,146,133,164,65,163,63,1,2,True,0.12525590608178483
2025-01-07 19:57:13,Fail to pick,238,268,0,0,0,0,0,0,0,0,False,0
2025-01-07 19:57:13,persegiMerah,236,271,149,133,46,73,42,68,4,5,True,0.1360972348638216
2025-01-07 19:57:13,Fail to pick,236,271,0,0,0,0,0,0,0,0,False,0
2025-01-07 19:57:13,persegiMerah,238,266,149,133,48,49,51,52,3,3,True,0.4554032791045707
2025-01-07 19:57:13,Fail to pick,238,266,0,0,0,0,0,0,0,0,False,0
2025-01-07 19:57:13,persegiMerah,241,264,144,133,15,32,10,30,5,2,True,0.22635828453934295
2025-01-07 19:57:13,Fail to pick,241,264,0,0,0,0,0,0,0,0,False,0
2025-01-07 19:57:13,persegiMerah,238,264,147,133,133,30,130,29,3,1,True,0.10591467658582716
2025-01-07 19:57:13,Fail to pick,238,264,0,0,0,0,0,0,0,0,False,0
2025-01-07 19:57:14,persegiMerah,238,266,144,133,61,34,58,30,3,4,True,0.4113781299390056
2025-01-07 19:57:14,Fail to pick,238,266,0,0,0,0,0,0,0,0,False,0
2025-01-07 19:57:14,persegiMerah,243,264,152,134,152,33,154,31,2,2,True,0.38398003044116413
2025-01-07 19:57:14,Fail to pick,243,264,0,0,0,0,0,0,0,0,False,0
2025-01-07 19:57:14,persegiMerah,236,268,146,133,52,59,48,56,4,3,True,0.40084583466618984
2025-01-07 19:57:14,Fail to pick,236,268,0,0,0,0,0,0,0,0,False,0
2025-01-07 19:57:14,persegiMerah,240,264,146,136,147,78,142,80,5,2,True,0.30280505352124487
2025-01-07 19:57:14,Fail to pick,240,264,0,0,0,0,0,0,0,0,False,0
2025-01-07 19:57:14,persegiMerah,228,275,147,132,102,69,100,72,2,3,True,0.4058247794779305
2025-01-07 19:57:14,persegiMerah,240,266,149,133,13,86,13,90,0,4,True,0.21091551144549192
2025-01-07 19:57:14,persegiMerah,238,266,144,133,131,6,134,4,3,2,True,0.3411153442138132
2025-01-07 19:57:14,Fail to pick,238,266,0,0,0,0,0,0,0,0,False,0
2025-01-07 19:57:15,persegiMerah,243,267,150,134,189,13,191,16,2,3,True,0.43820653601763215
2025-01-07 19:57:15,Fail to pick,243,267,0,0,0,0,0,0,0,0,False,0
2025-01-07 19:57:15,persegiMerah,240,266,149,135,134,68,129,67,5,1,True,0.12791670866445737
2025-01-07 19:57:15,Fail to pick,240,266,0,0,0,0,0,0,0,0,False,0
2025-01-07 19:57:15,persegiMerah,240,268,146,134,19,3,21,0,2,3,True,0.35204461722530245
2025-01-07 19:57:15,Fail to pick,240,268,0,0,0,0,0,0,0,0,False,0
2025-01-07 19:57:15,persegiMerah,245,268,151,133,26,54,22,56,4,2,True,0.1788214403306233
2025-01-07 19:57:15,Fail to pick,245,268,0,0,0,0,0,0,0,0,False,0
2025-01-07 19:57:15,persegiMerah,245,268,149,132,39,70,36,73,3,3,True,0.16896626983887342
2025-01-07 19:57:15,Fail to pick,245,268,0,0,0,0,0,0,0,0,False,0
2025-01-07 19:57:15,persegiMerah,246,269,154,134,24,77,25,79,1,2,False,0.4935000518790392
2025-01-07 19:57:15,Fail to pick,246,269,0,0,0,0,0,0,0,0,False,0
2025-01-07 19:57:15,persegiMerah,242,273,150,137,58,19,61,23,3,4,True,0.24651884117012784
2025-01-07 19:57:15,Fail to pick,242,273,0,0,0,0,0,0,0,0,False,0
2025-01-07 19:57:15,persegiMerah,253,269,146,132,195,61,194,57,1,4,False,0.3116442423733033
2025-01-07 19:57:16,persegiMerah,251,276,146,133,144,93,146,89,2,4,True,0.1416036336637746
2025-01-07 19:57:16,Fail to pick,251,276,0,0,0,0,0,0,0,0,False,0
2025-01-07 19:57:16,persegiMerah,247,269,151,137,48,70,52,68,4,2,True,0.3480850953269117
2025-01-07 19:57:16,Fail to pick,247,269,0,0,0,0,0,0,0,0,False,0
2025-01-07 19:57:16,persegiMerah,251,274,149,137,96,66,98,62,2,4,True,0.4536074107022724
2025-01-07 19:57:16,Fail to pick,251,274,0,0,0,0,0,0,0,0,False,0
2025-01-07 19:57:16,persegiMerah,251,273,148,137,47,17,49,19,2,2,True,0.23190664781795098
2025-01-07 19:57:16,Fail to pick,251,273,0,0,0,0,0,0,0,0,False,0
2025-01-07 19:57:16,persegiMerah,246,266,150,135,83,35,79,37,4,2,True,0.486256830758241
2025-01-07 19:57:16,Fail to pick,246,266,0,0,0,0,0,0,0,0,False,0
2025-01-07 19:57:16,persegiMerah,244,266,148,135,23,66,24,63,1,3,True,0.3162820655239179
2025-01-07 19:57:16,Fail to pick,244,266,0,0,0,0,0,0,0,0,False,0
2025-01-07 19:57:16,persegiMerah,243,275,149,135,157,7,152,7,5,0,True,0.25780999252826914
2025-01-07 19:57:16,Fail to pick,243,275,0,0,0,0,0,0,0,0,False,0
2025-01-07 19:57:16,persegiMerah,250,270,146,135,165,77,167,75,2,2,True,0.33129150766706306
2025-01-07 19:57:16,Fail to pick,250,270,0,0,0,0,0,0,0,0,False,0
2025-01-07 19:57:17,persegiMerah,253,270,146,134,64,51,63,50,1,1,True,0.4015309406704911
2025-01-07 19:57:17,Fail to pick,253,270,0,0,0,0,0,0,0,0,False,0
2025-01-07 19:57:17,persegiMerah,248,273,152,134,28,40,30,39,2,1,True,0.12808729476429148
2025-01-07 19:57:17,Fail to pick,248,273,0,0,0,0,0,0,0,0,False,0
2025-01-07 19:57:17,persegiMerah,252,272,149,135,10,49,7,48,3,1,True,0.47397224330965126
2025-01-07 19:57:17,Fail to pick,252,272,0,0,0,0,0,0,0,0,False,0
2025-01-07 19:57:17,persegiMerah,250,275,144,134,34,58,37,54,3,4,True,0.4044337061719898
2025-01-07 19:57:17,Fail to pick,250,275,0,0,0,0,0,0,0,0,False,0
2025-01-07 19:57:17,persegiMerah,244,273,149,133,164,4,162,4,2,0,True,0.3538631772159331
2025-01-07 19:57:17,Fail to pick,244,273,0,0,0,0,0,0,0,0,False,0
2025-01-07 19:57:17,persegiMerah,249,272,150,135,13,5,11,4,2,1,True,0.46003720790164004
2025-01-07 19:57:17,Fail to pick,249,272,0,0,0,0,0,0,0,0,False,0
2025-01-07 19:57:17,persegiMerah,244,269,150,136,121,8,124,4,3,4,True,0.13191998784865122
2025-01-07 19:57:17,Fail to pick,244,269,0,0,0,0,0,0,0,0,False,0
2025-01-07 19:57:17,persegiMerah,254,274,144,135,154,42,155,46,1,4,True,0.3610474016418651
2025-01-07 19:57:18,persegiMerah,247,269,153,136,195,25,197,27,2,2,True,0.2583091400684938
2025-01-07 19:57:18,Fail to pick,247,269,0,0,0,0,0,0,0,0,False,0
2025-01-07 19:57:18,persegiMerah,253,268,148,132,199,61,195,65,4,4,False,0.37444341286159577
2025-01-07 19:57:18,Fail to pick,253,268,0,0,0,0,0,0,0,0,False,0
2025-01-07 19:57:18,persegiMerah,247,272,154,136,26,69,27,66,1,3,True,0.1000374297042105
2025-01-07 19:57:18,Fail to pick,247,272,0,0,0,0,0,0,0,0,False,0
2025-01-07 19:57:18,persegiMerah,244,274,148,135,121,14,119,13,2,1,True,0.33318538607286535
2025-01-07 19:57:18,Fail to pick,244,274,0,0,0,0,0,0,0,0,False,0
2025-01-07 19:57:18,persegiMerah,244,268,150,134,152,71,151,74,1,3,True,0.4464343045986451
2025-01-07 19:57:18,Fail to pick,244,268,0,0,0,0,0,0,0,0,False,0
2025-01-07 19:57:18,persegiMerah,248,272,149,136,43,2,38,-3,5,5,True,0.16835224381548058
2025-01-07 19:57:18,Fail to pick,248,272,0,0,0,0,0,0,0,0,False,0
2025-01-07 19:57:18,persegiMerah,247,274,153,135,47,26,48,25,1,1,True,0.12878179826223965
2025-01-07 19:57:18,Fail to pick,247,274,0,0,0,0,0,0,0,0,False,0
2025-01-07 19:57:19,persegiMerah,252,271,147,133,185,60,184,58,1,2,True,0.18469400304609063
2025-01-07 19:57:19,Fail to pick,252,271,0,0,0,0,0,0,0,0,False,0
2025-01-07 19:57:19,persegiMerah,243,267,149,135,177,66,174,62,3,4,True,0.42046071886471703
2025-01-07 19:57:19,Fail to pick,243,267,0,0,0,0,0,0,0,0,False,0
2025-01-07 19:57:19,persegiMerah,243,268,149,133,101,48,99,52,2,4,True,0.1365091469111775
2025-01-07 19:57:19,Fail to pick,243,268,0,0,0,0,0,0,0,0,False,0
2025-01-07 19:57:19,persegiMerah,246,271,152,135,170,68,166,68,4,0,True,0.4516333826533835
2025-01-07 19:57:19,Fail to pick,246,271,0,0,0,0,0,0,0,0,False,0
2025-01-07 19:57:19,persegiMerah,251,270,148,137,192,84,188,87,4,3,True,0.4771973172949887
2025-01-07 19:57:19,Fail to pick,251,270,0,0,0,0,0,0,0,0,False,0
2025-01-07 19:57:19,persegiMerah,245,273,152,135,93,8,88,4,5,4,True,0.28195129444083267
2025-01-07 19:57:19,Fail to pick,245,273,0,0,0,0,0,0,0,0,False,0
2025-01-07 19:57:19,persegiMerah,246,271,155,135,76,19,72,20,4,1,True,0.19902537691765662
2025-01-07 19:57:19,Fail to pick,246,271,0,0,0,0,0,0,0,0,False,0
2025-01-07 19:57:19,persegiMerah,242,271,152,138,121,40,117,40,4,0,True,0.30571536989499826
2025-01-07 19:57:19,Fail to pick,242,271,0,0,0,0,0,0,0,0,False,0
2025-01-07 19:57:20,persegiMerah,246,271,150,135,32,92,29,92,3,0,True,0.20291680294290948
2025-01-07 19:57:20,Fail to pick,246,271,0,0,0,0,0,0,0,0,False,0
2025-01-07 19:57:20,persegiMerah,253,274,148,132,1,51,-1,54,2,3,True,0.20042074779400887
2025-01-07 19:57:20,Fail to pick,253,274,0,0,0,0,0,0,0,0,False,0
2025-01-07 19:57:20,persegiMerah,250,273,149,134,35,14,30,16,5,2,True,0.42278159647282865
2025-01-07 19:57:20,Fail to pick,250,273,0,0,0,0,0,0,0,0,False,0
2025-01-07 19:58:18,persegiMerah,264,290,154,143,146,10,143,13,3,3,False,0.16019909201324906
2025-01-07 19:58:18,Merah,264,290,tensor(154.5246),tensor(143.6282),119,24,119,19,0,5,True,0.0004980564117431641
2025-01-07 19:58:19,persegiMerah,277,304,153,147,89,23,85,20,4,3,False,0.3202332650648022
2025-01-07 19:58:19,persegiMerah,266,295,147,140,120,85,122,85,2,0,True,0.40069426750602677
2025-01-07 19:58:19,persegiMerah,270,285,149,139,2,43,-3,42,5,1,True,0.3785017654189332
2025-01-07 19:58:19,persegiMerah,258,284,149,145,140,84,137,88,3,4,True,0.37649869027738536
2025-01-07 19:58:19,persegiMerah,263,284,152,140,76,75,75,76,1,1,True,0.40813813439608426
2025-01-07 19:58:19,Fail to pick,263,284,0,0,0,0,0,0,0,0,False,0
2025-01-07 19:58:19,persegiMerah,262,284,152,140,139,85,138,80,1,5,False,0.3698530465946628
2025-01-07 19:58:19,Fail to pick,262,284,0,0,0,0,0,0,0,0,False,0
2025-01-07 19:58:20,persegiMerah,255,283,143,140,156,4,160,6,4,2,True,0.4988980296826512
2025-01-07 19:58:20,Fail to pick,255,283,0,0,0,0,0,0,0,0,False,0
2025-01-07 19:58:20,persegiMerah,259,263,150,137,101,30,99,33,2,3,True,0.1793881401075683
2025-01-07 19:58:20,persegiMerah,251,261,147,140,117,51,114,53,3,2,True,0.3583240031553916
2025-01-07 19:58:20,Fail to pick,251,261,0,0,0,0,0,0,0,0,False,0
2025-01-07 19:58:20,persegiMerah,255,256,148,139,86,18,81,14,5,4,True,0.3183338444407689
2025-01-07 19:58:20,Fail to pick,255,256,0,0,0,0,0,0,0,0,False,0
2025-01-07 19:58:20,persegiMerah,254,256,151,142,22,57,17,53,5,4,True,0.46879410631076923
2025-01-07 19:58:20,Fail to pick,254,256,0,0,0,0,0,0,0,0,False,0
2025-01-07 19:58:20,persegiMerah,244,259,152,139,183,71,179,72,4,1,True,0.26083013654361165
2025-01-07 19:58:20,persegiMerah,246,257,152,139,24,17,23,17,1,0,True,0.272956760476393
2025-01-07 19:58:20,Fail to pick,246,257,0,0,0,0,0,0,0,0,False,0
2025-01-07 19:58:20,persegiMerah,253,256,148,138,18,18,20,13,2,5,True,0.10445005972956772
2025-01-07 19:58:20,Fail to pick,253,256,0,0,0,0,0,0,0,0,False,0
2025-01-07 19:58:21,persegiMerah,242,257,151,138,11,49,8,46,3,3,True,0.43124138631397824
2025-01-07 19:58:21,persegiMerah,242,251,150,138,89,63,93,58,4,5,True,0.2226101933512816
2025-01-07 19:58:21,Fail to pick,242,251,0,0,0,0,0,0,0,0,False,0
2025-01-07 19:58:21,persegiMerah,242,256,149,137,154,28,153,25,1,3,True,0.2028817983499364
2025-01-07 19:58:21,Fail to pick,242,256,0,0,0,0,0,0,0,0,False,0
2025-01-07 19:58:21,persegiMerah,243,251,153,135,99,81,100,78,1,3,True,0.47170237384294256
2025-01-07 19:58:21,Fail to pick,243,251,0,0,0,0,0,0,0,0,False,0
2025-01-07 19:58:21,persegiMerah,248,254,151,137,96,16,91,16,5,0,True,0.38801718992462964
2025-01-07 19:58:21,Fail to pick,248,254,0,0,0,0,0,0,0,0,False,0
2025-01-07 19:58:21,persegiMerah,239,253,146,136,161,14,165,16,4,2,True,0.3997146157661855
2025-01-07 19:58:21,Fail to pick,239,253,0,0,0,0,0,0,0,0,False,0
2025-01-07 19:58:21,persegiMerah,243,260,152,139,87,37,83,40,4,3,True,0.46834658305597765
2025-01-07 19:58:21,Fail to pick,243,260,0,0,0,0,0,0,0,0,False,0
2025-01-07 19:58:22,persegiMerah,255,263,149,140,89,96,88,92,1,4,True,0.1460266787869663
2025-01-07 19:58:22,persegiMerah,256,264,147,136,193,71,193,67,0,4,True,0.20750764739665173
2025-01-07 19:58:22,Fail to pick,256,264,0,0,0,0,0,0,0,0,False,0
2025-01-07 19:58:22,persegiMerah,260,262,148,136,188,81,191,84,3,3,True,0.3192149776864296
2025-01-07 19:58:22,Fail to pick,260,262,0,0,0,0,0,0,0,0,False,0
2025-01-07 19:58:22,persegiMerah,258,265,147,134,48,40,47,43,1,3,True,0.32454861176618854
2025-01-07 19:58:22,Fail to pick,258,265,0,0,0,0,0,0,0,0,False,0
2025-01-07 19:58:22,persegiMerah,259,263,146,136,68,68,70,65,2,3,True,0.2892489830595474
2025-01-07 19:58:22,Fail to pick,259,263,0,0,0,0,0,0,0,0,False,0
2025-01-07 19:58:22,persegiMerah,260,267,148,133,66,2,70,6,4,4,True,0.3633571084244487
2025-01-07 19:58:22,Fail to pick,260,267,0,0,0,0,0,0,0,0,False,0
2025-01-07 19:58:22,persegiMerah,263,264,153,136,18,45,17,41,1,4,True,0.47354780516449557
2025-01-07 19:58:22,Fail to pick,263,264,0,0,0,0,0,0,0,0,False,0
2025-01-07 19:58:23,persegiMerah,256,263,151,137,156,26,151,25,5,1,True,0.2542474656147072
2025-01-07 19:58:23,Fail to pick,256,263,0,0,0,0,0,0,0,0,False,0
2025-01-07 19:58:23,persegiMerah,260,264,153,134,127,13,125,15,2,2,True,0.4652900700384217
2025-01-07 19:58:23,Fail to pick,260,264,0,0,0,0,0,0,0,0,False,0
2025-01-07 19:58:23,persegiMerah,249,250,152,147,86,41,82,38,4,3,False,0.25193836197116976
2025-01-07 19:58:23,persegiMerah,259,258,149,137,168,27,168,23,0,4,False,0.374381666590456
2025-01-07 19:58:23,persegiMerah,265,259,147,135,26,25,27,20,1,5,False,0.16341208950606503
2025-01-07 19:58:23,Fail to pick,265,259,0,0,0,0,0,0,0,0,False,0
2025-01-07 19:58:23,persegiMerah,255,264,153,138,134,42,137,45,3,3,True,0.37755481414579195
2025-01-07 19:58:23,persegiMerah,260,257,160,138,192,92,188,87,4,5,True,0.41510906241403955
2025-01-07 19:58:23,Fail to pick,260,257,0,0,0,0,0,0,0,0,False,0
2025-01-07 19:58:23,persegiMerah,242,262,151,141,98,29,100,26,2,3,True,0.28478298219894305
2025-01-07 19:58:24,persegiMerah,243,246,159,136,192,57,189,55,3,2,True,0.18335683100472988
2025-01-07 19:58:24,persegiMerah,236,241,156,134,117,13,116,11,1,2,True,0.3987957910034
2025-01-07 19:58:24,Fail to pick,236,241,0,0,0,0,0,0,0,0,False,0
2025-01-07 19:58:26,persegiMerah,245,321,151,146,50,82,48,79,2,3,True,0.4172456590905488
2025-01-07 19:58:26,Merah,245,321,tensor(151.6026),tensor(146.1209),110,22,107,24,3,2,True,0.0005056858062744141
2025-01-07 19:58:26,persegiMerah,247,333,147,135,7,29,6,30,1,1,False,0.450003955385043
2025-01-07 19:58:26,persegiMerah,247,333,147,135,12,7,12,8,0,1,True,0.42076892896051843
2025-01-07 19:58:26,Fail to pick,247,333,0,0,0,0,0,0,0,0,False,0
2025-01-07 19:58:41,persegiMerah,229,308,143,131,72,77,72,80,0,3,True,0.37561645596543536
2025-01-07 19:58:42,persegiMerah,219,308,137,125,50,70,51,67,1,3,True,0.43230264146735264
2025-01-07 19:58:48,persegiMerah,231,338,146,141,73,31,77,28,4,3,False,0.36287934958324464
2025-01-07 19:58:49,persegiMerah,202,316,144,141,14,15,18,18,4,3,True,0.4121904155830719
2025-01-07 19:58:49,persegiMerah,202,318,135,137,191,88,186,86,5,2,True,0.24082200562840517
2025-01-07 19:58:49,Fail to pick,202,318,0,0,0,0,0,0,0,0,False,0
2025-01-07 19:58:50,persegiMerah,201,318,142,138,10,54,12,55,2,1,True,0.20458508970187705
2025-01-07 19:58:50,Fail to pick,201,318,0,0,0,0,0,0,0,0,False,0
2025-01-07 19:58:50,persegiMerah,202,316,145,141,35,24,35,28,0,4,True,0.42824081744340303
2025-01-07 19:58:50,Fail to pick,202,316,0,0,0,0,0,0,0,0,False,0
2025-01-07 19:58:50,persegiMerah,201,315,144,141,137,98,136,98,1,0,True,0.4013394339485902
2025-01-07 19:58:50,Fail to pick,201,315,0,0,0,0,0,0,0,0,False,0
2025-01-07 19:58:50,persegiMerah,204,311,141,145,181,23,183,26,2,3,True,0.47427884831235767
2025-01-07 19:58:50,Fail to pick,204,311,0,0,0,0,0,0,0,0,False,0
2025-01-07 19:58:51,persegiMerah,199,318,141,136,73,72,69,72,4,0,True,0.42432701879428714
2025-01-07 19:58:51,Fail to pick,199,318,0,0,0,0,0,0,0,0,False,0
2025-01-07 19:58:51,persegiMerah,208,317,148,139,178,38,176,37,2,1,True,0.279407374366331
2025-01-07 19:58:51,Fail to pick,208,317,0,0,0,0,0,0,0,0,False,0
2025-01-07 19:58:51,persegiMerah,199,319,142,140,174,3,175,-1,1,4,False,0.12177144317226013
2025-01-07 19:58:51,Fail to pick,199,319,0,0,0,0,0,0,0,0,False,0
2025-01-07 19:58:51,persegiMerah,201,316,143,140,177,67,175,65,2,2,True,0.2030833496581218
2025-01-07 19:58:51,Fail to pick,201,316,0,0,0,0,0,0,0,0,False,0
2025-01-07 19:58:51,persegiMerah,205,316,141,140,115,44,111,41,4,3,True,0.195047411479157
2025-01-07 19:58:51,Fail to pick,205,316,0,0,0,0,0,0,0,0,False,0
2025-01-07 19:58:51,persegiMerah,201,317,144,139,194,58,192,57,2,1,True,0.2294397671020652
2025-01-07 19:58:51,Fail to pick,201,317,0,0,0,0,0,0,0,0,False,0
2025-01-07 19:58:51,persegiMerah,207,317,139,140,125,12,124,13,1,1,False,0.18595926369740892
2025-01-07 19:58:51,Fail to pick,207,317,0,0,0,0,0,0,0,0,False,0
2025-01-07 19:58:51,persegiMerah,199,315,146,147,33,46,32,47,1,1,False,0.2645125909300029
2025-01-07 19:58:51,Fail to pick,199,315,0,0,0,0,0,0,0,0,False,0
2025-01-07 19:58:52,persegiMerah,205,312,144,142,1,60,4,62,3,2,True,0.12930239622166512
2025-01-07 19:58:52,Fail to pick,205,312,0,0,0,0,0,0,0,0,False,0
2025-01-07 19:58:52,persegiMerah,206,314,142,143,32,77,28,75,4,2,True,0.4534386731872583
2025-01-07 19:58:52,Fail to pick,206,314,0,0,0,0,0,0,0,0,False,0
2025-01-07 19:58:52,persegiMerah,202,314,142,141,89,95,86,95,3,0,True,0.2911291790070195
2025-01-07 19:58:52,Fail to pick,202,314,0,0,0,0,0,0,0,0,False,0
2025-01-07 19:58:52,persegiMerah,205,314,141,140,145,4,142,4,3,0,True,0.45488090102845036
2025-01-07 19:58:52,Fail to pick,205,314,0,0,0,0,0,0,0,0,False,0
2025-01-07 19:58:52,persegiMerah,201,311,143,148,143,67,142,63,1,4,True,0.48329144047651773
2025-01-07 19:58:52,Fail to pick,201,311,0,0,0,0,0,0,0,0,False,0
2025-01-07 19:58:52,persegiMerah,207,313,140,144,147,39,145,34,2,5,True,0.24130441398419766
2025-01-07 19:58:52,Fail to pick,207,313,0,0,0,0,0,0,0,0,False,0
2025-01-07 19:58:53,persegiMerah,208,314,138,142,109,43,107,44,2,1,False,0.4542980052153637
2025-01-07 19:58:53,Fail to pick,208,314,0,0,0,0,0,0,0,0,False,0
2025-01-07 19:58:53,persegiMerah,203,313,139,141,38,62,40,57,2,5,True,0.35738017131188093
2025-01-07 19:58:53,Fail to pick,203,313,0,0,0,0,0,0,0,0,False,0
2025-01-07 19:58:53,persegiMerah,201,314,141,141,199,46,195,45,4,1,True,0.15383234796921155
2025-01-07 19:58:53,Fail to pick,201,314,0,0,0,0,0,0,0,0,False,0
2025-01-07 19:58:53,persegiMerah,207,313,139,142,16,75,12,71,4,4,True,0.13971586704889905
2025-01-07 19:58:53,Fail to pick,207,313,0,0,0,0,0,0,0,0,False,0
2025-01-07 19:58:53,persegiMerah,198,319,144,142,9,5,11,6,2,1,True,0.2181133432776711
2025-01-07 19:58:53,Fail to pick,198,319,0,0,0,0,0,0,0,0,False,0
2025-01-07 19:58:53,persegiMerah,200,316,143,141,21,40,18,38,3,2,True,0.3095802499852387
2025-01-07 19:58:53,Fail to pick,200,316,0,0,0,0,0,0,0,0,False,0
2025-01-07 19:58:53,persegiMerah,202,316,141,142,54,36,57,33,3,3,True,0.2085471370514588
2025-01-07 19:58:53,Fail to pick,202,316,0,0,0,0,0,0,0,0,False,0
2025-01-07 19:58:53,persegiMerah,203,318,141,138,119,69,122,65,3,4,True,0.1195117013454953
2025-01-07 19:58:53,Fail to pick,203,318,0,0,0,0,0,0,0,0,False,0
2025-01-07 19:58:54,persegiMerah,204,316,144,141,38,84,33,87,5,3,True,0.3706302436660821
2025-01-07 19:58:54,Fail to pick,204,316,0,0,0,0,0,0,0,0,False,0
2025-01-07 19:58:54,persegiMerah,200,313,143,142,111,33,115,34,4,1,True,0.44130893207177335
2025-01-07 19:58:54,Fail to pick,200,313,0,0,0,0,0,0,0,0,False,0
2025-01-07 19:58:54,persegiMerah,200,317,148,138,148,54,147,51,1,3,True,0.37767837005687865
2025-01-07 19:58:54,Fail to pick,200,317,0,0,0,0,0,0,0,0,False,0
2025-01-07 19:58:54,persegiMerah,200,318,141,137,127,96,128,100,1,4,True,0.24700327661080934
2025-01-07 19:58:54,Fail to pick,200,318,0,0,0,0,0,0,0,0,False,0
2025-01-07 19:58:54,persegiMerah,214,318,138,135,170,51,168,51,2,0,True,0.4234268612313009
2025-01-07 19:58:54,persegiMerah,212,318,142,137,122,8,118,12,4,4,True,0.38684093597236147
2025-01-07 19:58:54,Fail to pick,212,318,0,0,0,0,0,0,0,0,False,0
2025-01-07 19:58:54,persegiMerah,215,321,142,136,66,86,63,87,3,1,True,0.10627457694672025
2025-01-07 19:58:54,Fail to pick,215,321,0,0,0,0,0,0,0,0,False,0
2025-01-07 19:58:54,persegiMerah,212,320,144,137,175,19,174,17,1,2,True,0.3434930818293802
2025-01-07 19:58:54,Fail to pick,212,320,0,0,0,0,0,0,0,0,False,0
2025-01-07 19:58:55,persegiMerah,205,322,139,138,86,6,86,8,0,2,True,0.4248725109716769
2025-01-07 19:58:55,Fail to pick,205,322,0,0,0,0,0,0,0,0,False,0
2025-01-07 19:58:55,persegiMerah,210,317,144,139,77,35,74,39,3,4,True,0.463285730721511
2025-01-07 19:58:55,Fail to pick,210,317,0,0,0,0,0,0,0,0,False,0
2025-01-07 19:58:55,persegiMerah,210,318,144,138,178,2,174,5,4,3,False,0.17533208317168214
2025-01-07 19:58:55,Fail to pick,210,318,0,0,0,0,0,0,0,0,False,0
2025-01-07 19:58:55,persegiMerah,213,324,146,139,44,93,44,88,0,5,True,0.3757851468684994
2025-01-07 19:58:55,Fail to pick,213,324,0,0,0,0,0,0,0,0,False,0
2025-01-07 19:58:55,persegiMerah,216,307,142,148,193,80,197,83,4,3,True,0.19002179939000988
2025-01-07 19:58:55,persegiMerah,219,318,135,137,176,54,179,57,3,3,True,0.159449616941043
2025-01-07 19:58:55,persegiMerah,219,325,142,139,93,48,89,43,4,5,True,0.3243945376536282
2025-01-07 19:58:55,Fail to pick,219,325,0,0,0,0,0,0,0,0,False,0
2025-01-07 19:58:55,persegiMerah,220,325,140,141,113,34,109,37,4,3,True,0.28500456824340015
2025-01-07 19:58:55,Fail to pick,220,325,0,0,0,0,0,0,0,0,False,0
2025-01-07 19:58:56,persegiMerah,217,324,140,141,149,5,151,1,2,4,True,0.41204561426803143
2025-01-07 19:58:56,Fail to pick,217,324,0,0,0,0,0,0,0,0,False,0
2025-01-07 19:58:56,persegiMerah,204,323,136,139,90,85,92,82,2,3,True,0.3543136982358204
2025-01-07 19:58:56,persegiMerah,203,322,138,138,55,76,55,74,0,2,True,0.14362834751014475
2025-01-07 19:58:56,Fail to pick,203,322,0,0,0,0,0,0,0,0,False,0
2025-01-07 19:58:56,persegiMerah,211,327,145,142,133,59,134,63,1,4,True,0.18369397477524566
2025-01-07 19:58:56,Fail to pick,211,327,0,0,0,0,0,0,0,0,False,0
2025-01-07 19:58:56,persegiMerah,213,328,149,145,103,48,98,51,5,3,False,0.2544509526492261
2025-01-07 19:58:56,Fail to pick,213,328,0,0,0,0,0,0,0,0,False,0
2025-01-07 19:58:56,persegiMerah,196,323,150,141,21,60,24,55,3,5,True,0.2688545709504455
2025-01-07 19:58:56,persegiMerah,198,320,146,146,126,18,124,14,2,4,True,0.34345722994525774
2025-01-07 19:58:56,Fail to pick,198,320,0,0,0,0,0,0,0,0,False,0
2025-01-07 19:58:56,persegiMerah,187,318,148,140,84,68,83,71,1,3,True,0.22050945948192716
2025-01-07 19:58:57,persegiMerah,181,311,142,137,146,69,146,72,0,3,True,0.2167495554338871
2025-01-07 19:58:57,Fail to pick,181,311,0,0,0,0,0,0,0,0,False,0
2025-01-07 19:58:57,persegiMerah,211,312,139,142,22,53,25,56,3,3,True,0.43213846533929645
2025-01-07 19:58:57,persegiMerah,214,312,139,139,82,17,83,17,1,0,True,0.4159686514844927
2025-01-07 19:58:57,Fail to pick,214,312,0,0,0,0,0,0,0,0,False,0
2025-01-07 19:58:57,persegiMerah,227,304,138,137,173,55,177,59,4,4,True,0.3619146320192491
2025-01-07 19:58:58,persegiMerah,236,297,140,135,19,55,18,52,1,3,True,0.41893714591917375
2025-01-07 19:58:58,Fail to pick,236,297,0,0,0,0,0,0,0,0,False,0
2025-01-07 19:58:58,persegiMerah,235,302,140,137,178,1,179,-3,1,4,True,0.11699345849799402
2025-01-07 19:58:58,Fail to pick,235,302,0,0,0,0,0,0,0,0,False,0
2025-01-07 19:58:58,persegiMerah,239,301,143,137,155,5,153,4,2,1,True,0.30290152427631123
2025-01-07 19:58:58,Fail to pick,239,301,0,0,0,0,0,0,0,0,False,0
2025-01-07 19:58:58,persegiMerah,237,306,146,134,78,9,77,13,1,4,True,0.13508889070194974
2025-01-07 19:58:58,Fail to pick,237,306,0,0,0,0,0,0,0,0,False,0
2025-01-07 19:58:58,persegiMerah,242,305,146,134,130,67,132,68,2,1,True,0.27557570788404484
2025-01-07 19:58:58,Fail to pick,242,305,0,0,0,0,0,0,0,0,False,0
2025-01-07 19:58:58,persegiMerah,240,309,141,136,197,35,200,37,3,2,True,0.13873051495062516
2025-01-07 19:58:58,Fail to pick,240,309,0,0,0,0,0,0,0,0,False,0
2025-01-07 19:58:58,persegiMerah,243,303,143,134,167,34,162,34,5,0,True,0.41643677916821065
2025-01-07 19:58:58,Fail to pick,243,303,0,0,0,0,0,0,0,0,False,0
2025-01-07 19:58:59,persegiMerah,243,305,140,137,13,0,16,-3,3,3,True,0.3209757972984981
2025-01-07 19:58:59,Fail to pick,243,305,0,0,0,0,0,0,0,0,False,0
2025-01-07 19:58:59,persegiMerah,243,306,143,136,25,42,21,41,4,1,True,0.3420931726534362
2025-01-07 19:58:59,Fail to pick,243,306,0,0,0,0,0,0,0,0,False,0
2025-01-07 19:58:59,persegiMerah,238,312,141,140,80,88,76,90,4,2,True,0.2720014564323886
2025-01-07 19:58:59,Fail to pick,238,312,0,0,0,0,0,0,0,0,False,0
2025-01-07 19:58:59,persegiMerah,236,312,139,136,44,6,46,2,2,4,True,0.3807486242475303
2025-01-07 19:58:59,Fail to pick,236,312,0,0,0,0,0,0,0,0,False,0
2025-01-07 19:58:59,persegiMerah,236,308,138,134,134,27,136,31,2,4,True,0.1942587003376749
2025-01-07 19:58:59,Fail to pick,236,308,0,0,0,0,0,0,0,0,False,0
2025-01-07 19:58:59,persegiMerah,240,303,144,139,119,70,121,65,2,5,True,0.25017945939240827
2025-01-07 19:58:59,Fail to pick,240,303,0,0,0,0,0,0,0,0,False,0
2025-01-07 19:58:59,persegiMerah,236,302,142,138,14,52,15,50,1,2,True,0.44320056427051835
2025-01-07 19:58:59,Fail to pick,236,302,0,0,0,0,0,0,0,0,False,0
2025-01-07 19:58:59,persegiMerah,241,309,144,135,137,82,133,80,4,2,True,0.28870960962763964
2025-01-07 19:58:59,Fail to pick,241,309,0,0,0,0,0,0,0,0,False,0
2025-01-07 19:59:00,persegiMerah,243,301,144,138,20,4,16,2,4,2,True,0.314022638713213
2025-01-07 19:59:00,Fail to pick,243,301,0,0,0,0,0,0,0,0,False,0
2025-01-07 19:59:00,persegiMerah,239,307,140,136,5,59,5,54,0,5,True,0.379386262748726
2025-01-07 19:59:00,Fail to pick,239,307,0,0,0,0,0,0,0,0,False,0
2025-01-07 19:59:00,persegiMerah,243,305,144,135,125,65,120,60,5,5,True,0.24247710361768268
2025-01-07 19:59:00,Fail to pick,243,305,0,0,0,0,0,0,0,0,False,0
2025-01-07 19:59:00,persegiMerah,237,310,139,137,172,71,171,72,1,1,True,0.1647115793176909
2025-01-07 19:59:00,Fail to pick,237,310,0,0,0,0,0,0,0,0,False,0
2025-01-07 19:59:00,persegiMerah,242,304,146,138,7,5,9,3,2,2,True,0.20684952554008357
2025-01-07 19:59:00,Fail to pick,242,304,0,0,0,0,0,0,0,0,False,0
2025-01-07 19:59:00,persegiMerah,241,306,145,135,181,36,184,32,3,4,True,0.23737158406643358
2025-01-07 19:59:00,Fail to pick,241,306,0,0,0,0,0,0,0,0,False,0
2025-01-07 19:59:00,persegiMerah,242,303,146,137,107,35,111,32,4,3,True,0.31249836225098204
2025-01-07 19:59:00,Fail to pick,242,303,0,0,0,0,0,0,0,0,False,0
2025-01-07 19:59:01,persegiMerah,241,304,143,137,185,75,188,70,3,5,True,0.2081085399015865
2025-01-07 19:59:01,Fail to pick,241,304,0,0,0,0,0,0,0,0,False,0
2025-01-07 19:59:01,persegiMerah,247,307,143,135,30,49,25,44,5,5,True,0.17097464823039776
2025-01-07 19:59:01,Fail to pick,247,307,0,0,0,0,0,0,0,0,False,0
2025-01-07 19:59:01,persegiMerah,245,303,146,136,143,40,140,39,3,1,True,0.21435818885505525
2025-01-07 19:59:01,Fail to pick,245,303,0,0,0,0,0,0,0,0,False,0
2025-01-07 19:59:01,persegiMerah,243,302,143,141,50,5,50,5,0,0,False,0.2357048501608071
2025-01-07 19:59:01,Fail to pick,243,302,0,0,0,0,0,0,0,0,False,0
2025-01-07 19:59:01,persegiMerah,241,313,145,143,9,17,13,13,4,4,True,0.42572181463985004
2025-01-07 19:59:01,persegiMerah,244,311,141,139,158,83,157,85,1,2,True,0.4440779629757078
2025-01-07 19:59:01,Fail to pick,244,311,0,0,0,0,0,0,0,0,False,0
2025-01-07 19:59:01,persegiMerah,252,317,147,139,174,57,175,58,1,1,True,0.39209031646135006
2025-01-07 19:59:01,Fail to pick,252,317,0,0,0,0,0,0,0,0,False,0
2025-01-07 19:59:02,persegiMerah,260,330,144,142,100,67,104,71,4,4,True,0.447893108821496
2025-01-07 20:11:33,persegiMerah,901,351,154,124,7,80,7,79,0,1,True,0.2856153335292677
2025-01-07 20:11:33,Merah,901,351,tensor(154.0258),tensor(124.6527),102,83,101,80,1,3,True,0.0
2025-01-07 20:11:49,persegiMerah,224,310,145,130,38,62,38,64,0,2,True,0.26344326244983735
2025-01-07 20:11:49,Merah,224,310,tensor(145.4208),tensor(130.3088),113,20,112,24,1,4,True,0.0
2025-01-07 20:11:49,persegiMerah,223,305,144,133,94,45,95,40,1,5,True,0.2538744147204772
2025-01-07 20:11:49,Fail to pick,223,305,0,0,0,0,0,0,0,0,False,0
2025-01-07 20:11:50,persegiMerah,222,304,144,133,107,84,103,86,4,2,True,0.30529400095882325
2025-01-07 20:11:50,Fail to pick,222,304,0,0,0,0,0,0,0,0,False,0
2025-01-07 20:11:50,persegiMerah,223,303,139,131,194,32,189,30,5,2,True,0.4499620004243854
2025-01-07 20:11:50,Fail to pick,223,303,0,0,0,0,0,0,0,0,False,0
2025-01-07 20:11:50,persegiMerah,226,304,145,132,109,79,106,77,3,2,True,0.2136776807176991
2025-01-07 20:11:50,Fail to pick,226,304,0,0,0,0,0,0,0,0,False,0
2025-01-07 20:11:50,persegiMerah,226,308,144,128,136,25,140,23,4,2,True,0.45621552874823357
2025-01-07 20:11:50,Fail to pick,226,308,0,0,0,0,0,0,0,0,False,0
2025-01-07 20:11:50,persegiMerah,226,307,144,128,29,52,27,47,2,5,True,0.13787367131590011
2025-01-07 20:11:50,Fail to pick,226,307,0,0,0,0,0,0,0,0,False,0
2025-01-07 20:11:50,persegiMerah,227,302,143,134,39,86,38,89,1,3,True,0.12249915376722638
2025-01-07 20:11:50,Fail to pick,227,302,0,0,0,0,0,0,0,0,False,0
2025-01-07 20:11:50,persegiMerah,222,310,142,130,124,14,128,13,4,1,True,0.40404041231460475
2025-01-07 20:11:50,Fail to pick,222,310,0,0,0,0,0,0,0,0,False,0
2025-01-07 20:11:50,persegiMerah,226,306,143,129,55,34,57,38,2,4,False,0.49980019880548643
2025-01-07 20:11:50,Fail to pick,226,306,0,0,0,0,0,0,0,0,False,0
2025-01-07 20:11:50,persegiMerah,224,305,145,132,132,41,127,42,5,1,True,0.13408409162077503
2025-01-07 20:11:50,Fail to pick,224,305,0,0,0,0,0,0,0,0,False,0
2025-01-07 20:11:50,persegiMerah,221,307,143,130,179,3,181,7,2,4,True,0.43003442935120884
2025-01-07 20:11:50,Fail to pick,221,307,0,0,0,0,0,0,0,0,False,0
2025-01-07 20:11:51,persegiMerah,218,313,142,133,170,10,171,11,1,1,True,0.11452560895645686
2025-01-07 20:11:51,Fail to pick,218,313,0,0,0,0,0,0,0,0,False,0
2025-01-07 20:11:51,persegiMerah,226,304,144,132,99,65,100,65,1,0,True,0.3221449955831349
2025-01-07 20:11:51,Fail to pick,226,304,0,0,0,0,0,0,0,0,False,0
2025-01-07 20:11:51,persegiMerah,222,302,141,132,196,99,199,96,3,3,True,0.1771037056285826
2025-01-07 20:11:51,Fail to pick,222,302,0,0,0,0,0,0,0,0,False,0
2025-01-07 20:11:51,persegiMerah,215,305,146,136,135,99,137,101,2,2,True,0.21890639501728357
2025-01-07 20:11:51,Fail to pick,215,305,0,0,0,0,0,0,0,0,False,0
2025-01-07 20:11:51,persegiMerah,223,302,140,135,89,95,93,90,4,5,True,0.26055075316267373
2025-01-07 20:11:51,Fail to pick,223,302,0,0,0,0,0,0,0,0,False,0
2025-01-07 20:11:51,persegiMerah,228,297,140,130,42,83,43,79,1,4,True,0.21625152547307602
2025-01-07 20:11:51,Fail to pick,228,297,0,0,0,0,0,0,0,0,False,0
2025-01-07 20:11:51,persegiMerah,223,308,143,132,16,44,18,46,2,2,True,0.3204048620733325
2025-01-07 20:11:56,persegiMerah,327,321,125,141,37,66,41,61,4,5,True,0.3310216930997161
2025-01-07 20:11:57,persegiMerah,324,327,121,142,37,85,32,82,5,3,True,0.23996836068287114
2025-01-07 20:11:57,Fail to pick,324,327,0,0,0,0,0,0,0,0,False,0
2025-01-07 20:11:59,persegiMerah,172,119,111,123,181,2,176,4,5,2,True,0.2570460608250036
2025-01-07 20:11:59,Merah,172,119,tensor(111.0458),tensor(123.1759),166,15,167,10,1,5,True,0.0
2025-01-07 20:11:59,persegiMerah,178,113,137,124,117,17,119,12,2,5,True,0.1548950524286784
2025-01-07 20:11:59,Fail to pick,178,113,0,0,0,0,0,0,0,0,False,0
2025-01-07 20:11:59,persegiMerah,188,115,115,127,42,8,40,8,2,0,True,0.482779562756544
2025-01-07 20:11:59,persegiMerah,183,114,119,119,122,47,120,49,2,2,True,0.39553937342659196
2025-01-07 20:11:59,Fail to pick,183,114,0,0,0,0,0,0,0,0,False,0
2025-01-07 20:12:00,persegiMerah,187,116,122,121,191,53,188,57,3,4,True,0.38411328067981676
2025-01-07 20:12:00,Fail to pick,187,116,0,0,0,0,0,0,0,0,False,0
2025-01-07 20:12:00,persegiMerah,203,113,118,116,97,84,101,86,4,2,True,0.38994957992796164
2025-01-07 20:12:00,persegiMerah,204,113,122,120,18,53,17,48,1,5,True,0.4484763580658232
2025-01-07 20:12:00,Fail to pick,204,113,0,0,0,0,0,0,0,0,False,0
2025-01-07 20:12:00,persegiMerah,199,115,125,121,90,65,87,69,3,4,True,0.21130104904531666
2025-01-07 20:12:00,Fail to pick,199,115,0,0,0,0,0,0,0,0,False,0
2025-01-07 20:12:00,persegiMerah,208,106,124,122,176,6,172,7,4,1,True,0.3115177391274192
2025-01-07 20:12:00,Fail to pick,208,106,0,0,0,0,0,0,0,0,False,0
2025-01-07 20:12:00,persegiMerah,205,108,124,123,167,12,167,12,0,0,True,0.13083165530297935
2025-01-07 20:12:00,Fail to pick,205,108,0,0,0,0,0,0,0,0,False,0
2025-01-07 20:12:00,persegiMerah,205,111,129,125,134,96,129,96,5,0,False,0.15608945421816078
2025-01-07 20:12:00,Fail to pick,205,111,0,0,0,0,0,0,0,0,False,0
2025-01-07 20:12:00,persegiMerah,212,111,130,119,96,96,100,95,4,1,True,0.10853206187815134
2025-01-07 20:12:00,Fail to pick,212,111,0,0,0,0,0,0,0,0,False,0
2025-01-07 20:12:00,persegiMerah,207,109,123,122,89,10,93,5,4,5,True,0.24008462506518347
2025-01-07 20:12:00,Fail to pick,207,109,0,0,0,0,0,0,0,0,False,0
2025-01-07 20:12:01,persegiMerah,208,111,130,124,176,29,174,32,2,3,True,0.4116935174601911
2025-01-07 20:12:01,Fail to pick,208,111,0,0,0,0,0,0,0,0,False,0
2025-01-07 20:12:01,persegiMerah,210,106,129,130,88,87,85,87,3,0,True,0.10585203022019521
2025-01-07 20:12:01,Fail to pick,210,106,0,0,0,0,0,0,0,0,False,0
2025-01-07 20:12:01,persegiMerah,209,108,127,121,172,9,176,10,4,1,True,0.15254966769008918
2025-01-07 20:12:01,Fail to pick,209,108,0,0,0,0,0,0,0,0,False,0
2025-01-07 20:12:01,persegiMerah,208,105,124,121,96,62,92,60,4,2,True,0.3597675191402361
2025-01-07 20:12:01,Fail to pick,208,105,0,0,0,0,0,0,0,0,False,0
2025-01-07 20:12:01,persegiMerah,206,110,131,128,21,52,16,56,5,4,True,0.46511716860674124
2025-01-07 20:12:01,Fail to pick,206,110,0,0,0,0,0,0,0,0,False,0
2025-01-07 20:12:01,persegiMerah,200,113,124,123,83,32,84,34,1,2,True,0.26920685435972797
2025-01-07 20:12:01,Fail to pick,200,113,0,0,0,0,0,0,0,0,False,0
2025-01-07 20:12:01,persegiMerah,197,113,127,119,2,95,-2,98,4,3,True,0.3927926044193245
2025-01-07 20:12:01,Fail to pick,197,113,0,0,0,0,0,0,0,0,False,0
2025-01-07 20:12:01,persegiMerah,203,111,130,123,195,62,193,66,2,4,True,0.259655568537721
2025-01-07 20:12:01,Fail to pick,203,111,0,0,0,0,0,0,0,0,False,0
2025-01-07 20:12:01,persegiMerah,200,113,131,120,197,13,197,11,0,2,True,0.3762518749274022
2025-01-07 20:12:01,Fail to pick,200,113,0,0,0,0,0,0,0,0,False,0
2025-01-07 20:12:02,persegiMerah,195,115,122,119,10,34,8,34,2,0,True,0.4371926910591907
2025-01-07 20:12:02,Fail to pick,195,115,0,0,0,0,0,0,0,0,False,0
2025-01-07 20:12:02,persegiMerah,195,115,126,123,110,93,106,89,4,4,False,0.2716664860093028
2025-01-07 20:12:02,Fail to pick,195,115,0,0,0,0,0,0,0,0,False,0
2025-01-07 20:12:02,persegiMerah,189,117,120,119,82,57,79,56,3,1,True,0.3841092065763242
2025-01-07 20:12:02,Fail to pick,189,117,0,0,0,0,0,0,0,0,False,0
2025-01-07 20:12:12,persegiMerah,176,110,124,116,162,52,166,55,4,3,False,0.21510945955181798
2025-01-07 20:12:12,persegiMerah,181,107,130,116,91,23,88,21,3,2,True,0.45163422115613616
2025-01-07 20:12:12,Fail to pick,181,107,0,0,0,0,0,0,0,0,False,0
2025-01-07 20:12:12,persegiMerah,194,104,131,118,116,11,115,8,1,3,True,0.43231973401514223
2025-01-07 20:12:12,persegiMerah,187,107,125,117,37,8,34,6,3,2,True,0.1999280742443207
2025-01-07 20:12:12,Fail to pick,187,107,0,0,0,0,0,0,0,0,False,0
2025-01-07 20:12:12,persegiMerah,186,108,121,118,142,1,137,-2,5,3,True,0.33422394715343473
2025-01-07 20:12:12,Fail to pick,186,108,0,0,0,0,0,0,0,0,False,0
2025-01-07 20:12:12,persegiMerah,183,107,129,116,34,5,29,7,5,2,True,0.23353575168207216
2025-01-07 20:12:12,Fail to pick,183,107,0,0,0,0,0,0,0,0,False,0
2025-01-07 20:12:12,persegiMerah,188,103,128,115,124,62,122,58,2,4,True,0.39852671109986626
2025-01-07 20:12:12,Fail to pick,188,103,0,0,0,0,0,0,0,0,False,0
2025-01-07 20:12:12,persegiMerah,193,105,135,116,128,42,124,40,4,2,True,0.41438310130272205
2025-01-07 20:12:12,Fail to pick,193,105,0,0,0,0,0,0,0,0,False,0
2025-01-07 20:12:12,persegiMerah,186,110,128,116,29,39,28,35,1,4,True,0.16723186521300892
2025-01-07 20:12:12,Fail to pick,186,110,0,0,0,0,0,0,0,0,False,0
2025-01-07 20:12:13,persegiMerah,189,101,134,111,40,71,37,71,3,0,True,0.3039554431829218
2025-01-07 20:12:13,Fail to pick,189,101,0,0,0,0,0,0,0,0,False,0
2025-01-07 20:12:13,persegiMerah,182,102,130,111,13,33,15,35,2,2,True,0.4413824305299844
2025-01-07 20:12:13,Fail to pick,182,102,0,0,0,0,0,0,0,0,False,0
2025-01-07 20:12:13,persegiMerah,178,105,132,118,54,32,49,35,5,3,True,0.1477204235641401
2025-01-07 20:12:13,Fail to pick,178,105,0,0,0,0,0,0,0,0,False,0
2025-01-07 20:12:13,persegiMerah,183,106,131,117,193,55,189,58,4,3,True,0.2676177046403255
2025-01-07 20:12:13,Fail to pick,183,106,0,0,0,0,0,0,0,0,False,0
2025-01-07 20:12:13,persegiMerah,174,106,125,116,157,5,156,5,1,0,True,0.18912987353195648
2025-01-07 20:12:13,Fail to pick,174,106,0,0,0,0,0,0,0,0,False,0
2025-01-07 20:12:13,persegiMerah,186,103,131,116,112,80,111,83,1,3,True,0.19335328584269762
2025-01-07 20:12:13,persegiMerah,185,107,127,115,95,54,98,58,3,4,False,0.44413996201151595
2025-01-07 20:12:13,Fail to pick,185,107,0,0,0,0,0,0,0,0,False,0
2025-01-07 20:12:13,persegiMerah,179,107,125,117,134,4,133,2,1,2,False,0.30337334146503325
2025-01-07 20:12:13,Fail to pick,179,107,0,0,0,0,0,0,0,0,False,0
2025-01-07 20:12:13,persegiMerah,188,100,131,118,123,38,126,38,3,0,True,0.249588351618075
2025-01-07 20:12:13,Fail to pick,188,100,0,0,0,0,0,0,0,0,False,0
2025-01-07 20:12:14,persegiMerah,179,106,130,115,151,88,153,91,2,3,True,0.11865340216831083
2025-01-07 20:12:14,Fail to pick,179,106,0,0,0,0,0,0,0,0,False,0
2025-01-07 20:12:14,persegiMerah,180,108,124,114,66,37,70,38,4,1,True,0.47504452677893194
2025-01-07 20:12:14,Fail to pick,180,108,0,0,0,0,0,0,0,0,False,0
2025-01-07 20:12:14,persegiMerah,178,111,126,117,29,17,33,15,4,2,True,0.3431781422740948
2025-01-07 20:12:14,Fail to pick,178,111,0,0,0,0,0,0,0,0,False,0
2025-01-07 20:12:14,persegiMerah,183,108,124,112,155,21,150,22,5,1,True,0.2080287253279557
2025-01-07 20:12:14,Fail to pick,183,108,0,0,0,0,0,0,0,0,False,0
2025-01-07 20:12:14,persegiMerah,188,105,130,115,103,63,106,58,3,5,True,0.3593390156908848
2025-01-07 20:12:14,Fail to pick,188,105,0,0,0,0,0,0,0,0,False,0
2025-01-07 20:12:38,persegiBiru,234,532,120,103,27,38,27,42,0,4,True,0.14024998255577337
2025-01-07 20:12:38,Biru,234,532,tensor(120.0395),tensor(103.3874),52,21,56,20,4,1,True,0.0
2025-01-07 20:12:38,persegiBiru,237,532,118,101,156,79,153,74,3,5,True,0.24808050739067777
2025-01-07 20:12:38,Fail to pick,237,532,0,0,0,0,0,0,0,0,False,0
2025-01-07 20:12:39,persegiBiru,266,508,120,103,183,0,187,-2,4,2,True,0.25038653245811004
2025-01-07 20:12:39,persegiBiru,251,517,127,106,78,18,80,17,2,1,True,0.13635310248151986
2025-01-07 20:12:39,persegiBiru,253,515,143,106,179,0,174,-3,5,3,True,0.28174493022553976
2025-01-07 20:12:39,Fail to pick,253,515,0,0,0,0,0,0,0,0,False,0
2025-01-07 20:12:39,persegiBiru,245,525,120,112,175,15,173,16,2,1,True,0.18580100511011902
2025-01-07 20:12:55,persegiBiru,349,488,143,124,146,26,143,24,3,2,True,0.13112396940605545
2025-01-07 20:12:55,Biru,349,488,tensor(143.1655),tensor(124.1380),64,32,64,35,0,3,True,0.0
2025-01-07 20:12:56,persegiBiru,343,483,142,130,194,80,190,84,4,4,True,0.4107816236927698
2025-01-07 20:12:56,Fail to pick,343,483,0,0,0,0,0,0,0,0,False,0
2025-01-07 20:12:56,persegiBiru,340,485,139,130,98,23,100,25,2,2,True,0.3443658856277516
2025-01-07 20:12:56,Fail to pick,340,485,0,0,0,0,0,0,0,0,False,0
2025-01-07 20:12:56,persegiBiru,338,486,140,127,25,22,29,17,4,5,True,0.25905294921426414
2025-01-07 20:12:56,Fail to pick,338,486,0,0,0,0,0,0,0,0,False,0
2025-01-07 20:12:56,persegiBiru,327,499,137,124,51,17,55,18,4,1,False,0.4744556297960869
2025-01-07 20:12:56,persegiBiru,335,489,143,126,71,24,73,19,2,5,True,0.33496664829250494
2025-01-07 20:12:56,persegiBiru,341,493,141,127,28,88,31,90,3,2,True,0.15367393638409066
2025-01-07 20:12:56,Fail to pick,341,493,0,0,0,0,0,0,0,0,False,0
2025-01-07 20:12:56,persegiBiru,334,501,139,126,125,14,120,18,5,4,True,0.19301360002258117
2025-01-07 20:12:56,Fail to pick,334,501,0,0,0,0,0,0,0,0,False,0
2025-01-07 20:12:56,persegiBiru,347,488,138,123,71,99,73,99,2,0,True,0.32472591601641754
2025-01-07 20:12:56,persegiBiru,345,494,137,122,196,26,196,21,0,5,True,0.23654043755180473
2025-01-07 20:12:57,Fail to pick,345,494,0,0,0,0,0,0,0,0,False,0
2025-01-07 20:12:57,persegiBiru,322,490,135,127,128,58,132,56,4,2,True,0.13267784692041018
2025-01-07 20:12:57,persegiBiru,331,494,143,126,190,72,189,75,1,3,True,0.22476046407905176
2025-01-07 20:12:57,Fail to pick,331,494,0,0,0,0,0,0,0,0,False,0
2025-01-07 20:12:57,persegiBiru,330,494,138,129,154,45,157,49,3,4,True,0.10295440284435098
2025-01-07 20:12:57,Fail to pick,330,494,0,0,0,0,0,0,0,0,False,0
2025-01-07 20:12:57,persegiBiru,323,496,138,127,69,92,72,96,3,4,True,0.21272709209011165
2025-01-07 20:12:57,Fail to pick,323,496,0,0,0,0,0,0,0,0,False,0
2025-01-07 20:12:57,persegiBiru,336,493,140,128,26,33,26,36,0,3,True,0.26920990603800116
2025-01-07 20:14:55,persegiMerah,145,390,139,116,180,83,178,80,2,3,True,0.15868881532761592
2025-01-07 20:14:55,Merah,145,390,tensor(139.1030),tensor(116.7203),91,13,86,9,5,4,True,0.0005173683166503906
2025-01-07 20:14:55,persegiMerah,173,396,133,113,95,15,94,16,1,1,True,0.37903723120860333
2025-01-07 20:14:55,persegiMerah,172,397,132,110,53,74,57,74,4,0,True,0.10806360858180658
2025-01-07 20:14:55,Fail to pick,172,397,0,0,0,0,0,0,0,0,False,0
2025-01-07 20:14:56,persegiMerah,170,397,133,111,173,50,175,54,2,4,True,0.3531491024837814
2025-01-07 20:14:56,Fail to pick,170,397,0,0,0,0,0,0,0,0,False,0
2025-01-07 20:14:56,persegiMerah,176,397,135,112,154,2,150,-3,4,5,True,0.1686041176135146
2025-01-07 20:14:56,Fail to pick,176,397,0,0,0,0,0,0,0,0,False,0
2025-01-07 20:14:56,persegiMerah,174,394,133,114,135,82,139,86,4,4,True,0.3355599414475512
2025-01-07 20:14:56,Fail to pick,174,394,0,0,0,0,0,0,0,0,False,0
2025-01-07 20:14:56,persegiMerah,172,397,133,112,55,34,58,30,3,4,True,0.10216602278315877
2025-01-07 20:14:56,Fail to pick,172,397,0,0,0,0,0,0,0,0,False,0
2025-01-07 20:14:56,persegiMerah,176,393,134,112,28,10,30,8,2,2,True,0.12299984239014035
2025-01-07 20:14:56,Fail to pick,176,393,0,0,0,0,0,0,0,0,False,0
2025-01-07 20:14:56,persegiMerah,170,395,130,114,65,79,68,79,3,0,True,0.36011824233653456
2025-01-07 20:14:56,Fail to pick,170,395,0,0,0,0,0,0,0,0,False,0
2025-01-07 20:14:56,persegiMerah,176,397,133,110,149,89,148,88,1,1,True,0.22123470842823045
2025-01-07 20:14:56,Fail to pick,176,397,0,0,0,0,0,0,0,0,False,0
2025-01-07 20:14:56,persegiMerah,170,397,130,111,148,82,149,78,1,4,True,0.36515363838010284
2025-01-07 20:14:56,Fail to pick,170,397,0,0,0,0,0,0,0,0,False,0
2025-01-07 20:14:56,persegiMerah,173,396,133,111,32,35,28,31,4,4,True,0.3390511753628337
2025-01-07 20:14:56,Fail to pick,173,396,0,0,0,0,0,0,0,0,False,0
2025-01-07 20:14:57,persegiMerah,173,401,134,113,93,24,95,19,2,5,False,0.4873778660558562
2025-01-07 20:14:57,Fail to pick,173,401,0,0,0,0,0,0,0,0,False,0
2025-01-07 20:14:57,persegiMerah,170,396,129,112,12,15,15,11,3,4,False,0.4119775801322003
2025-01-07 20:14:57,Fail to pick,170,396,0,0,0,0,0,0,0,0,False,0
2025-01-07 20:14:57,persegiMerah,171,398,132,110,108,24,111,20,3,4,True,0.1697919299209263
2025-01-07 20:14:57,Fail to pick,171,398,0,0,0,0,0,0,0,0,False,0
2025-01-07 20:14:57,persegiMerah,170,403,132,113,147,28,151,26,4,2,True,0.4172755699925238
2025-01-07 20:14:57,Fail to pick,170,403,0,0,0,0,0,0,0,0,False,0
2025-01-07 20:14:57,persegiMerah,165,401,137,113,183,63,178,59,5,4,True,0.3451653881518767
2025-01-07 20:14:57,Fail to pick,165,401,0,0,0,0,0,0,0,0,False,0
2025-01-07 20:15:02,persegiMerah,241,443,161,134,123,56,119,60,4,4,True,0.2330707022115909
2025-01-07 20:15:02,Merah,241,443,tensor(161.1770),tensor(134.2369),76,22,80,24,4,2,True,0.000499725341796875
2025-01-07 20:15:02,persegiMerah,225,460,152,127,131,19,126,21,5,2,True,0.39807093022220896
2025-01-07 20:15:02,persegiMerah,228,461,162,126,84,13,79,17,5,4,True,0.48107456743116594
2025-01-07 20:15:02,Fail to pick,228,461,0,0,0,0,0,0,0,0,False,0
2025-01-07 20:15:03,persegiMerah,223,457,158,130,77,60,77,61,0,1,True,0.3107264262076195
2025-01-07 20:15:03,Fail to pick,223,457,0,0,0,0,0,0,0,0,False,0
2025-01-07 20:15:03,persegiMerah,227,459,155,124,115,8,118,8,3,0,True,0.3197933402563027
2025-01-07 20:15:03,Fail to pick,227,459,0,0,0,0,0,0,0,0,False,0
2025-01-07 20:15:03,persegiMerah,227,463,153,127,187,40,185,35,2,5,True,0.1471586461484541
2025-01-07 20:15:03,Fail to pick,227,463,0,0,0,0,0,0,0,0,False,0
2025-01-07 20:15:03,persegiMerah,222,458,156,131,82,11,79,10,3,1,True,0.20809511704072664
2025-01-07 20:15:03,Fail to pick,222,458,0,0,0,0,0,0,0,0,False,0
2025-01-07 20:15:03,persegiMerah,228,458,157,130,76,13,72,12,4,1,True,0.13514643593398956
2025-01-07 20:15:03,Fail to pick,228,458,0,0,0,0,0,0,0,0,False,0
2025-01-07 20:15:03,persegiMerah,223,458,152,127,144,60,146,59,2,1,True,0.11578674308175008
2025-01-07 20:15:03,Fail to pick,223,458,0,0,0,0,0,0,0,0,False,0
2025-01-07 20:15:03,persegiMerah,225,462,161,131,143,27,140,27,3,0,True,0.4659000811487325
2025-01-07 20:15:03,Fail to pick,225,462,0,0,0,0,0,0,0,0,False,0
2025-01-07 20:15:03,persegiMerah,225,459,154,127,145,51,148,55,3,4,True,0.41151483131044764
2025-01-07 20:15:03,Fail to pick,225,459,0,0,0,0,0,0,0,0,False,0
2025-01-07 20:15:03,persegiMerah,229,460,151,124,88,79,86,83,2,4,True,0.47708914641641276
2025-01-07 20:15:03,Fail to pick,229,460,0,0,0,0,0,0,0,0,False,0
2025-01-07 20:15:04,persegiMerah,230,458,153,126,41,23,44,27,3,4,True,0.4105846221129378
2025-01-07 20:15:04,Fail to pick,230,458,0,0,0,0,0,0,0,0,False,0
2025-01-07 20:15:04,persegiMerah,266,151,120,127,12,18,15,20,3,2,True,0.45404423944099803
2025-01-07 20:15:04,Merah,266,151,tensor(120.3397),tensor(127.7775),158,24,162,22,4,2,True,0.0004992485046386719
2025-01-07 20:15:04,persegiMerah,263,157,119,125,191,20,186,15,5,5,True,0.24508217447541147
2025-01-07 20:15:04,Fail to pick,263,157,0,0,0,0,0,0,0,0,False,0
2025-01-07 20:15:05,persegiMerah,273,156,127,127,84,39,83,39,1,0,True,0.29221553281437296
2025-01-07 20:15:05,persegiMerah,273,157,125,128,13,73,14,72,1,1,True,0.2569029651788154
2025-01-07 20:15:05,Fail to pick,273,157,0,0,0,0,0,0,0,0,False,0
2025-01-07 20:15:05,persegiMerah,268,158,122,128,142,98,142,101,0,3,True,0.4961885162587981
2025-01-07 20:15:05,Fail to pick,268,158,0,0,0,0,0,0,0,0,False,0
2025-01-07 20:15:05,persegiMerah,272,154,125,127,141,31,138,32,3,1,True,0.3587248494887262
2025-01-07 20:15:05,Fail to pick,272,154,0,0,0,0,0,0,0,0,False,0
2025-01-07 20:15:05,persegiMerah,271,151,122,128,87,11,90,8,3,3,True,0.15635443173720703
2025-01-07 20:15:05,Fail to pick,271,151,0,0,0,0,0,0,0,0,False,0
2025-01-07 20:15:05,persegiMerah,280,153,130,126,139,46,140,45,1,1,True,0.22262261879678996
2025-01-07 20:15:05,Fail to pick,280,153,0,0,0,0,0,0,0,0,False,0
2025-01-07 20:15:05,persegiMerah,276,154,127,125,138,83,133,78,5,5,True,0.45974980204063487
2025-01-07 20:15:05,Fail to pick,276,154,0,0,0,0,0,0,0,0,False,0
2025-01-07 20:15:05,persegiMerah,278,154,128,126,139,80,134,76,5,4,True,0.12910431936029348
2025-01-07 20:15:05,Fail to pick,278,154,0,0,0,0,0,0,0,0,False,0
2025-01-07 20:15:05,persegiMerah,275,151,128,124,24,24,27,25,3,1,True,0.16103248611272059
2025-01-07 20:15:05,Fail to pick,275,151,0,0,0,0,0,0,0,0,False,0
2025-01-07 20:15:06,persegiMerah,275,154,128,127,158,92,159,93,1,1,True,0.10523525132346899
2025-01-07 20:15:06,Fail to pick,275,154,0,0,0,0,0,0,0,0,False,0
2025-01-07 20:15:06,persegiMerah,275,159,128,122,199,54,198,50,1,4,True,0.4690276314077161
2025-01-07 20:15:06,Fail to pick,275,159,0,0,0,0,0,0,0,0,False,0
2025-01-07 20:15:06,persegiMerah,278,158,130,123,179,28,180,23,1,5,True,0.47361179718299184
2025-01-07 20:15:06,Fail to pick,278,158,0,0,0,0,0,0,0,0,False,0
2025-01-07 20:15:06,persegiMerah,271,150,125,121,46,55,49,57,3,2,True,0.32324563118074706
2025-01-07 20:15:06,Fail to pick,271,150,0,0,0,0,0,0,0,0,False,0
2025-01-07 20:15:06,persegiMerah,272,156,129,125,89,28,93,30,4,2,True,0.21903408909188432
2025-01-07 20:15:06,Fail to pick,272,156,0,0,0,0,0,0,0,0,False,0
2025-01-07 20:15:06,persegiMerah,269,153,128,126,171,58,169,53,2,5,False,0.10485035984968297
2025-01-07 20:15:06,Fail to pick,269,153,0,0,0,0,0,0,0,0,False,0
2025-01-07 20:15:06,persegiMerah,275,155,127,126,6,26,6,26,0,0,False,0.2904611990979059
2025-01-07 20:15:06,Fail to pick,275,155,0,0,0,0,0,0,0,0,False,0
2025-01-07 20:15:06,persegiMerah,279,150,127,121,16,32,20,34,4,2,True,0.31066661105769
2025-01-07 20:15:06,Fail to pick,279,150,0,0,0,0,0,0,0,0,False,0
2025-01-07 20:15:07,persegiMerah,275,153,133,127,181,15,179,11,2,4,True,0.2809498164278542
2025-01-07 20:15:07,Fail to pick,275,153,0,0,0,0,0,0,0,0,False,0
2025-01-07 20:15:07,persegiMerah,282,155,136,125,88,62,84,60,4,2,True,0.48518241514592686
2025-01-07 20:15:07,Fail to pick,282,155,0,0,0,0,0,0,0,0,False,0
2025-01-07 20:15:07,persegiMerah,283,153,136,126,161,8,158,11,3,3,True,0.10052701336870605
2025-01-07 20:15:07,Fail to pick,283,153,0,0,0,0,0,0,0,0,False,0
2025-01-07 20:15:07,persegiMerah,280,152,133,130,72,23,70,20,2,3,True,0.27251657777820604
2025-01-07 20:15:07,Fail to pick,280,152,0,0,0,0,0,0,0,0,False,0
2025-01-07 20:15:07,persegiMerah,279,153,132,125,169,56,169,53,0,3,True,0.30167487238135027
2025-01-07 20:15:07,Fail to pick,279,153,0,0,0,0,0,0,0,0,False,0
2025-01-07 20:15:07,persegiMerah,279,154,135,124,150,38,154,39,4,1,True,0.4227509691108423
2025-01-07 20:15:07,Fail to pick,279,154,0,0,0,0,0,0,0,0,False,0
2025-01-07 20:15:07,persegiMerah,281,151,131,126,19,95,14,99,5,4,True,0.23664376859688324
2025-01-07 20:15:07,Fail to pick,281,151,0,0,0,0,0,0,0,0,False,0
2025-01-07 20:15:07,persegiMerah,282,152,132,128,15,13,16,12,1,1,True,0.4122588737224203
2025-01-07 20:15:07,Fail to pick,282,152,0,0,0,0,0,0,0,0,False,0
2025-01-07 20:15:07,persegiMerah,280,151,132,128,84,86,84,86,0,0,True,0.12407323059039457
2025-01-07 20:15:07,Fail to pick,280,151,0,0,0,0,0,0,0,0,False,0
2025-01-07 20:15:08,persegiMerah,284,152,136,124,99,64,99,64,0,0,True,0.3039576193527648
2025-01-07 20:15:08,Fail to pick,284,152,0,0,0,0,0,0,0,0,False,0
2025-01-07 20:15:08,persegiMerah,283,149,134,123,53,57,53,52,0,5,False,0.17782659763930286
2025-01-07 20:15:08,Fail to pick,283,149,0,0,0,0,0,0,0,0,False,0
2025-01-07 20:15:08,persegiMerah,277,152,134,124,52,51,50,48,2,3,True,0.13612791521402556
2025-01-07 20:15:08,Fail to pick,277,152,0,0,0,0,0,0,0,0,False,0
2025-01-07 20:15:13,persegiMerah,274,137,137,124,144,71,140,75,4,4,True,0.3834848897617573
2025-01-07 20:15:13,persegiMerah,273,141,137,121,96,11,91,6,5,5,False,0.47381825056962845
2025-01-07 20:15:13,Fail to pick,273,141,0,0,0,0,0,0,0,0,False,0
2025-01-07 20:15:13,persegiMerah,272,139,135,118,52,61,54,58,2,3,True,0.1736414726758715
2025-01-07 20:15:13,Fail to pick,272,139,0,0,0,0,0,0,0,0,False,0
2025-01-07 20:15:13,persegiMerah,272,143,136,120,83,31,87,26,4,5,True,0.4237460985758169
2025-01-07 20:15:13,Fail to pick,272,143,0,0,0,0,0,0,0,0,False,0
2025-01-07 20:15:13,persegiMerah,275,140,136,119,102,70,102,68,0,2,True,0.2898634432488226
2025-01-07 20:15:13,Fail to pick,275,140,0,0,0,0,0,0,0,0,False,0
2025-01-07 20:15:13,persegiMerah,268,145,137,119,133,67,129,69,4,2,True,0.27359714376733685
2025-01-07 20:15:13,Fail to pick,268,145,0,0,0,0,0,0,0,0,False,0
2025-01-07 20:15:13,persegiMerah,273,142,136,121,167,49,167,51,0,2,True,0.3265012299048954
2025-01-07 20:15:13,Fail to pick,273,142,0,0,0,0,0,0,0,0,False,0
2025-01-07 20:15:13,persegiMerah,298,155,137,127,94,26,95,28,1,2,True,0.30989452751393176
2025-01-07 20:15:13,persegiMerah,288,158,133,125,1,86,-3,90,4,4,True,0.13888191318599802
2025-01-07 20:15:13,persegiMerah,282,155,135,127,117,88,120,89,3,1,True,0.14500864105779698
2025-01-07 20:15:13,Fail to pick,282,155,0,0,0,0,0,0,0,0,False,0
2025-01-07 20:15:14,persegiMerah,287,149,131,120,11,57,15,61,4,4,True,0.1514774728135485
2025-01-07 20:15:14,Fail to pick,287,149,0,0,0,0,0,0,0,0,False,0
2025-01-07 20:15:14,persegiMerah,276,151,138,121,3,9,5,6,2,3,True,0.23943913992236665
2025-01-07 20:15:14,persegiMerah,276,153,135,125,174,94,172,92,2,2,True,0.29709088926578603
2025-01-07 20:15:14,Fail to pick,276,153,0,0,0,0,0,0,0,0,False,0
2025-01-07 20:15:14,persegiMerah,272,165,131,123,189,46,185,48,4,2,True,0.2968035039305708
2025-01-07 20:15:14,persegiMerah,273,178,133,127,32,79,32,75,0,4,True,0.4255375502621854
2025-01-07 20:15:14,persegiMerah,282,185,137,133,77,23,73,22,4,1,True,0.35411440973011366
2025-01-07 20:15:14,Fail to pick,282,185,0,0,0,0,0,0,0,0,False,0
2025-01-07 20:15:15,persegiMerah,265,169,137,129,47,44,49,39,2,5,True,0.2546882980167948
2025-01-07 20:15:15,persegiMerah,265,143,131,116,115,8,114,3,1,5,True,0.21422042710645584
2025-01-07 20:15:15,persegiMerah,263,141,132,117,102,29,106,25,4,4,True,0.2632636946788805
2025-01-07 20:15:15,Fail to pick,263,141,0,0,0,0,0,0,0,0,False,0
2025-01-07 20:15:15,persegiMerah,268,146,135,121,197,3,196,0,1,3,False,0.46556154891114243
2025-01-07 20:15:15,Fail to pick,268,146,0,0,0,0,0,0,0,0,False,0
2025-01-07 20:15:15,persegiMerah,270,141,142,116,47,20,46,16,1,4,True,0.20914947937486597
2025-01-07 20:15:15,Fail to pick,270,141,0,0,0,0,0,0,0,0,False,0
2025-01-07 20:15:15,persegiMerah,271,144,135,115,190,44,189,42,1,2,True,0.48472969997777593
2025-01-07 20:15:15,Fail to pick,271,144,0,0,0,0,0,0,0,0,False,0
2025-01-07 20:15:16,persegiMerah,273,144,137,116,137,21,141,18,4,3,True,0.3383575756617195
2025-01-07 20:15:16,Fail to pick,273,144,0,0,0,0,0,0,0,0,False,0
2025-01-07 20:15:16,persegiMerah,273,141,136,120,72,74,75,76,3,2,True,0.39832925568291777
2025-01-07 20:15:16,Fail to pick,273,141,0,0,0,0,0,0,0,0,False,0
2025-01-07 20:15:16,persegiMerah,266,144,136,120,99,30,102,33,3,3,True,0.46048646434552754
2025-01-07 20:15:16,Fail to pick,266,144,0,0,0,0,0,0,0,0,False,0
2025-01-07 20:15:17,persegiMerah,273,142,139,121,192,57,191,58,1,1,True,0.4442474957355479
2025-01-07 20:15:17,Fail to pick,273,142,0,0,0,0,0,0,0,0,False,0
2025-01-07 20:15:17,persegiMerah,270,140,135,119,48,17,46,15,2,2,True,0.34053851931060486
2025-01-07 20:15:17,Merah,270,140,tensor(135.1566),tensor(119.6613),161,25,156,20,5,5,True,0.0
2025-01-07 20:15:17,Fail to pick,270,140,0,0,0,0,0,0,0,0,False,0
2025-01-07 20:15:17,persegiMerah,263,139,133,117,78,29,82,26,4,3,True,0.3341763223329296
2025-01-07 20:15:17,Fail to pick,263,139,0,0,0,0,0,0,0,0,False,0
2025-01-07 20:15:17,persegiMerah,264,144,133,117,50,47,46,49,4,2,False,0.20246595206642956
2025-01-07 20:15:17,Fail to pick,264,144,0,0,0,0,0,0,0,0,False,0
2025-01-07 20:15:23,persegiMerah,233,180,156,131,50,47,48,44,2,3,True,0.2498504813656744
2025-01-07 20:15:24,persegiMerah,268,200,156,135,80,39,82,35,2,4,True,0.24189515209249135
2025-01-07 20:15:24,persegiMerah,265,201,159,136,163,10,162,13,1,3,True,0.1275553684134892
2025-01-07 20:15:24,Fail to pick,265,201,0,0,0,0,0,0,0,0,False,0
2025-01-07 20:15:24,persegiMerah,263,200,162,133,149,0,148,1,1,1,True,0.3342976153168116
2025-01-07 20:15:24,Fail to pick,263,200,0,0,0,0,0,0,0,0,False,0
2025-01-07 20:15:24,persegiMerah,270,205,166,138,96,5,98,9,2,4,True,0.38646430186854386
2025-01-07 20:15:24,Fail to pick,270,205,0,0,0,0,0,0,0,0,False,0
2025-01-07 20:15:24,persegiMerah,256,174,156,127,35,74,35,72,0,2,True,0.2566532853158009
2025-01-07 20:15:24,persegiMerah,253,173,156,129,75,59,70,56,5,3,True,0.20522394508913397
2025-01-07 20:15:24,Fail to pick,253,173,0,0,0,0,0,0,0,0,False,0
2025-01-07 20:15:24,persegiMerah,252,175,158,124,16,98,16,95,0,3,True,0.22165585063328758
2025-01-07 20:15:24,Fail to pick,252,175,0,0,0,0,0,0,0,0,False,0
2025-01-07 20:15:24,persegiMerah,256,175,154,127,12,1,16,0,4,1,True,0.4953325097527548
2025-01-07 20:15:24,Fail to pick,256,175,0,0,0,0,0,0,0,0,False,0
2025-01-07 20:15:24,persegiMerah,290,195,170,134,58,29,55,28,3,1,True,0.47429831162492697
2025-01-07 20:15:25,persegiMerah,284,188,165,133,158,95,156,98,2,3,True,0.15620547151018718
2025-01-07 20:15:25,Fail to pick,284,188,0,0,0,0,0,0,0,0,False,0
2025-01-07 20:15:25,persegiMerah,276,186,157,137,145,88,146,90,1,2,True,0.21749049680366084
2025-01-07 20:15:25,Fail to pick,276,186,0,0,0,0,0,0,0,0,False,0
2025-01-07 20:15:25,persegiMerah,286,188,162,137,67,35,64,39,3,4,True,0.129167753907788
2025-01-07 20:15:25,persegiMerah,272,191,160,137,194,59,193,61,1,2,False,0.4947415410888054
2025-01-07 20:15:27,persegiMerah,371,263,120,107,17,53,21,56,4,3,True,0.13022481456455548
2025-01-07 20:15:27,Merah,371,263,tensor(120.7480),tensor(107.7980),126,34,128,34,2,0,True,0.0004987716674804688
2025-01-07 20:15:27,persegiMerah,369,264,119,110,70,10,67,5,3,5,True,0.40548617799380804
2025-01-07 20:15:27,Fail to pick,369,264,0,0,0,0,0,0,0,0,False,0
2025-01-07 20:15:29,persegiBiru,340,246,131,109,55,96,50,92,5,4,True,0.19746179858710453
2025-01-07 20:15:30,persegiBiru,337,246,127,109,139,4,142,6,3,2,True,0.3187062143555582
2025-01-07 20:15:30,Fail to pick,337,246,0,0,0,0,0,0,0,0,False,0
2025-01-07 20:15:30,persegiBiru,334,243,132,107,9,64,5,65,4,1,True,0.266055976167547
2025-01-07 20:15:30,Fail to pick,334,243,0,0,0,0,0,0,0,0,False,0
2025-01-07 20:15:30,persegiBiru,334,242,129,108,25,37,23,32,2,5,True,0.20274917676859375
2025-01-07 20:15:30,Fail to pick,334,242,0,0,0,0,0,0,0,0,False,0
2025-01-07 20:15:34,persegiMerah,388,238,130,108,164,98,163,100,1,2,True,0.43277709625954974
2025-01-07 20:15:34,persegiMerah,384,240,129,112,122,31,120,35,2,4,True,0.2952621306322273
2025-01-07 20:15:34,Fail to pick,384,240,0,0,0,0,0,0,0,0,False,0
2025-01-07 20:15:35,persegiMerah,385,238,134,109,3,83,-2,85,5,2,True,0.43057150144485
2025-01-07 20:15:35,Fail to pick,385,238,0,0,0,0,0,0,0,0,False,0
2025-01-07 20:15:35,persegiMerah,381,237,133,110,35,30,30,33,5,3,True,0.2811161473897337
2025-01-07 20:15:35,Fail to pick,381,237,0,0,0,0,0,0,0,0,False,0
2025-01-07 20:15:35,persegiMerah,388,240,132,113,172,30,168,32,4,2,True,0.29340268734431724
2025-01-07 20:15:35,Fail to pick,388,240,0,0,0,0,0,0,0,0,False,0
2025-01-07 20:15:35,persegiMerah,383,240,130,113,118,32,117,28,1,4,True,0.28629381401494025
2025-01-07 20:15:35,Fail to pick,383,240,0,0,0,0,0,0,0,0,False,0
2025-01-07 20:15:35,persegiMerah,384,241,128,114,98,12,102,10,4,2,True,0.3454750082970406
2025-01-07 20:15:35,Fail to pick,384,241,0,0,0,0,0,0,0,0,False,0
2025-01-07 20:15:35,persegiBiru,391,242,130,110,169,77,172,73,3,4,True,0.13651989068694245
2025-01-07 20:15:35,Fail to pick,391,242,0,0,0,0,0,0,0,0,False,0
2025-01-07 20:15:35,persegiBiru,383,245,129,113,77,9,72,12,5,3,True,0.3512051670937104
2025-01-07 20:15:35,Fail to pick,383,245,0,0,0,0,0,0,0,0,False,0
2025-01-07 20:15:37,persegiMerah,348,129,140,122,108,44,106,41,2,3,True,0.22769849831048786
2025-01-07 20:15:37,Merah,348,129,tensor(140.7805),tensor(122.2883),164,32,163,35,1,3,True,0.0004987716674804688
2025-01-07 20:15:37,persegiMerah,344,126,138,120,2,3,-3,5,5,2,True,0.19949071202383878
2025-01-07 20:15:37,Fail to pick,344,126,0,0,0,0,0,0,0,0,False,0
2025-01-07 20:15:37,persegiMerah,342,130,134,119,63,88,65,91,2,3,True,0.48832288425002734
2025-01-07 20:15:37,Fail to pick,342,130,0,0,0,0,0,0,0,0,False,0
2025-01-07 20:15:37,persegiMerah,344,126,132,122,102,16,100,16,2,0,True,0.4731697571642499
2025-01-07 20:15:37,Fail to pick,344,126,0,0,0,0,0,0,0,0,False,0
2025-01-07 20:15:37,persegiMerah,332,126,133,121,26,41,30,39,4,2,True,0.42567856999539433
2025-01-07 20:15:37,persegiMerah,341,126,138,118,191,36,192,33,1,3,True,0.1704430165693241
2025-01-07 20:15:37,Fail to pick,341,126,0,0,0,0,0,0,0,0,False,0
2025-01-07 20:15:37,persegiMerah,340,124,140,118,92,26,95,28,3,2,True,0.3592060904268989
2025-01-07 20:15:37,Fail to pick,340,124,0,0,0,0,0,0,0,0,False,0
2025-01-07 20:15:38,persegiMerah,334,125,134,120,151,70,151,70,0,0,True,0.36441611786604755
2025-01-07 20:15:38,Fail to pick,334,125,0,0,0,0,0,0,0,0,False,0
2025-01-07 20:15:38,persegiMerah,335,124,134,118,35,42,36,40,1,2,True,0.4026672583004053
2025-01-07 20:15:38,Fail to pick,335,124,0,0,0,0,0,0,0,0,False,0
2025-01-07 20:15:38,persegiMerah,343,124,133,122,27,23,22,18,5,5,True,0.11488636569376749
2025-01-07 20:15:38,Fail to pick,343,124,0,0,0,0,0,0,0,0,False,0
2025-01-07 20:15:38,persegiMerah,335,126,138,119,189,14,189,17,0,3,True,0.16977189045932786
2025-01-07 20:15:38,Fail to pick,335,126,0,0,0,0,0,0,0,0,False,0
2025-01-07 20:15:38,persegiMerah,337,127,138,123,33,59,32,55,1,4,True,0.17617544562318557
2025-01-07 20:15:38,Fail to pick,337,127,0,0,0,0,0,0,0,0,False,0
2025-01-07 20:15:38,persegiMerah,359,138,136,125,58,46,57,49,1,3,True,0.17333235991934273
2025-01-07 20:15:38,persegiMerah,353,137,131,121,10,9,8,11,2,2,True,0.35970592266766555
2025-01-07 20:15:38,Fail to pick,353,137,0,0,0,0,0,0,0,0,False,0
2025-01-07 20:15:38,persegiMerah,354,135,135,122,160,41,155,36,5,5,True,0.13501842400562347
2025-01-07 20:15:38,Fail to pick,354,135,0,0,0,0,0,0,0,0,False,0
2025-01-07 20:15:38,persegiMerah,355,138,136,122,179,82,174,83,5,1,True,0.4639372059840856
2025-01-07 20:15:38,Fail to pick,355,138,0,0,0,0,0,0,0,0,False,0
2025-01-07 20:15:39,persegiMerah,361,134,139,122,52,54,51,52,1,2,True,0.23905350856154045
2025-01-07 20:15:39,Fail to pick,361,134,0,0,0,0,0,0,0,0,False,0
2025-01-07 20:15:39,persegiMerah,353,135,127,118,1,27,3,22,2,5,True,0.39471817277103527
2025-01-07 20:15:39,Fail to pick,353,135,0,0,0,0,0,0,0,0,False,0
2025-01-07 20:15:47,persegiMerah,331,53,123,106,133,23,134,22,1,1,False,0.28612955428393505
2025-01-07 20:15:47,Merah,331,53,tensor(123.6443),tensor(106.7419),185,30,189,31,4,1,True,0.000499725341796875
2025-01-07 20:15:48,persegiMerah,346,54,126,109,61,35,59,36,2,1,True,0.4175579281792061
2025-01-07 20:15:48,persegiMerah,345,50,120,101,144,12,141,8,3,4,True,0.4817771214128629
2025-01-07 20:15:48,Fail to pick,345,50,0,0,0,0,0,0,0,0,False,0
2025-01-07 20:15:50,persegiMerah,335,42,135,85,55,14,56,12,1,2,True,0.3982561300770685
2025-01-07 20:15:50,persegiMerah,341,40,136,81,66,68,66,68,0,0,False,0.48317343932071743
2025-01-07 20:15:50,Fail to pick,341,40,0,0,0,0,0,0,0,0,False,0
2025-01-07 20:15:50,persegiMerah,336,42,139,85,28,5,31,7,3,2,True,0.18422195752904932
2025-01-07 20:15:50,Fail to pick,336,42,0,0,0,0,0,0,0,0,False,0
2025-01-07 20:15:50,persegiMerah,328,40,139,80,31,93,35,95,4,2,True,0.11145754397902806
2025-01-07 20:15:50,Fail to pick,328,40,0,0,0,0,0,0,0,0,False,0
2025-01-07 20:15:50,persegiMerah,332,37,139,74,125,58,121,58,4,0,True,0.4094825673836957
2025-01-07 20:15:50,Fail to pick,332,37,0,0,0,0,0,0,0,0,False,0
2025-01-07 20:15:51,persegiMerah,335,40,143,81,165,89,163,93,2,4,True,0.42875628862275506
2025-01-07 20:15:51,Fail to pick,335,40,0,0,0,0,0,0,0,0,False,0
2025-01-07 20:16:11,persegiMerah,274,504,142,113,82,41,78,45,4,4,True,0.2722999042991863
2025-01-07 20:16:11,Merah,274,504,tensor(142.1921),tensor(113.7464),60,25,60,29,0,4,True,0.0
2025-01-07 20:16:11,persegiMerah,261,509,134,115,31,36,31,35,0,1,True,0.4668517506590947
2025-01-07 20:16:11,persegiMerah,254,515,136,115,172,47,170,51,2,4,True,0.3325137531688511
2025-01-07 20:16:11,Fail to pick,254,515,0,0,0,0,0,0,0,0,False,0
2025-01-07 20:16:12,persegiMerah,269,505,147,113,107,41,108,41,1,0,True,0.4430435580863914
2025-01-07 20:16:12,persegiMerah,273,505,148,113,125,6,123,1,2,5,True,0.4574169655509318
2025-01-07 20:16:12,Fail to pick,273,505,0,0,0,0,0,0,0,0,False,0
2025-01-07 20:16:12,persegiMerah,259,508,139,115,29,48,28,52,1,4,False,0.3050382847377287
2025-01-07 20:16:18,persegiMerah,428,556,142,121,39,46,34,43,5,3,True,0.15449769521506207
2025-01-07 20:16:18,Merah,428,556,tensor(142.2254),tensor(121.3887),45,39,49,35,4,4,True,0.0
2025-01-07 20:16:18,persegiMerah,430,551,144,121,83,24,86,19,3,5,False,0.20801603937959046
2025-01-07 20:16:18,Fail to pick,430,551,0,0,0,0,0,0,0,0,False,0
2025-01-07 20:16:18,persegiMerah,441,557,140,122,90,35,93,38,3,3,True,0.4476463945936432
2025-01-07 20:16:18,persegiMerah,431,562,142,123,145,76,147,79,2,3,True,0.2049041976864243
2025-01-07 20:16:18,persegiMerah,438,552,144,120,83,69,84,67,1,2,True,0.3876710632924819
2025-01-07 20:16:18,persegiMerah,430,551,143,122,131,31,134,32,3,1,False,0.1256259882996884
2025-01-07 20:16:18,Fail to pick,430,551,0,0,0,0,0,0,0,0,False,0
2025-01-07 20:16:19,persegiMerah,429,552,141,121,19,56,19,54,0,2,True,0.326817560361073
2025-01-07 20:16:19,Fail to pick,429,552,0,0,0,0,0,0,0,0,False,0
2025-01-07 20:16:20,persegiMerah,264,264,148,132,148,98,143,102,5,4,True,0.2838043604119449
2025-01-07 20:16:20,Merah,264,264,tensor(148.2100),tensor(132.1107),126,24,130,24,4,0,True,0.0
2025-01-07 20:16:20,persegiMerah,253,256,148,132,99,2,98,6,1,4,False,0.20901893976048613
2025-01-07 20:16:20,persegiMerah,261,256,151,132,133,60,132,57,1,3,True,0.14547392525433464
2025-01-07 20:16:20,Fail to pick,261,256,0,0,0,0,0,0,0,0,False,0
2025-01-07 20:16:20,persegiMerah,263,261,151,133,144,54,146,57,2,3,True,0.10616493600729351
2025-01-07 20:16:20,Fail to pick,263,261,0,0,0,0,0,0,0,0,False,0
2025-01-07 20:16:20,persegiMerah,262,262,156,134,64,40,65,37,1,3,True,0.1087373922716095
2025-01-07 20:16:20,Fail to pick,262,262,0,0,0,0,0,0,0,0,False,0
2025-01-07 20:16:20,persegiMerah,258,264,151,133,80,99,80,99,0,0,True,0.3466611184675885
2025-01-07 20:16:20,Fail to pick,258,264,0,0,0,0,0,0,0,0,False,0
2025-01-07 20:16:20,persegiMerah,254,259,152,135,27,63,26,67,1,4,True,0.42885792740148077
2025-01-07 20:16:20,Fail to pick,254,259,0,0,0,0,0,0,0,0,False,0
2025-01-07 20:16:20,persegiMerah,254,263,152,136,190,90,189,89,1,1,True,0.19836022123921465
2025-01-07 20:16:20,Fail to pick,254,263,0,0,0,0,0,0,0,0,False,0
2025-01-07 20:16:20,persegiMerah,253,260,148,133,44,92,47,95,3,3,True,0.2575296757473607
2025-01-07 20:16:20,Fail to pick,253,260,0,0,0,0,0,0,0,0,False,0
2025-01-07 20:16:21,persegiMerah,252,267,154,134,7,75,2,72,5,3,True,0.3068628147311955
2025-01-07 20:16:21,Fail to pick,252,267,0,0,0,0,0,0,0,0,False,0
2025-01-07 20:16:21,persegiMerah,261,260,154,133,3,72,-2,75,5,3,True,0.281174224015317
2025-01-07 20:16:21,Fail to pick,261,260,0,0,0,0,0,0,0,0,False,0
2025-01-07 20:16:21,persegiMerah,233,273,155,134,157,72,156,71,1,1,False,0.43583913376050176
2025-01-07 20:16:22,persegiMerah,241,257,125,125,143,67,141,63,2,4,True,0.22315354523355238
2025-01-07 20:16:22,persegiMerah,241,252,128,124,111,2,112,-1,1,3,True,0.10791390082887338
2025-01-07 20:16:22,Fail to pick,241,252,0,0,0,0,0,0,0,0,False,0
2025-01-07 20:16:22,persegiMerah,245,253,134,123,148,87,147,90,1,3,True,0.4074867906061206
2025-01-07 20:16:22,Fail to pick,245,253,0,0,0,0,0,0,0,0,False,0
2025-01-07 20:16:22,persegiMerah,248,254,131,125,106,54,105,56,1,2,False,0.46195735592999665
2025-01-07 20:16:22,Fail to pick,248,254,0,0,0,0,0,0,0,0,False,0
2025-01-07 20:16:22,persegiMerah,247,248,134,127,132,53,131,55,1,2,True,0.30781554543523004
2025-01-07 20:16:22,Fail to pick,247,248,0,0,0,0,0,0,0,0,False,0
2025-01-07 20:16:22,persegiMerah,247,256,134,127,112,15,112,14,0,1,True,0.17617375124433685
2025-01-07 20:16:22,Fail to pick,247,256,0,0,0,0,0,0,0,0,False,0
2025-01-07 20:16:22,persegiMerah,248,253,134,126,160,4,157,8,3,4,True,0.2843255303488368
2025-01-07 20:16:22,Fail to pick,248,253,0,0,0,0,0,0,0,0,False,0
2025-01-07 20:16:22,persegiMerah,244,257,132,130,120,94,117,96,3,2,False,0.12798074611976384
2025-01-07 20:16:22,Fail to pick,244,257,0,0,0,0,0,0,0,0,False,0
2025-01-07 20:16:23,persegiMerah,245,253,133,129,163,93,166,92,3,1,True,0.18356972054327422
2025-01-07 20:16:23,Fail to pick,245,253,0,0,0,0,0,0,0,0,False,0
2025-01-07 20:16:23,persegiMerah,246,249,136,128,8,82,7,79,1,3,True,0.34351442949001065
2025-01-07 20:16:23,Fail to pick,246,249,0,0,0,0,0,0,0,0,False,0
2025-01-07 20:16:23,persegiMerah,245,249,132,127,175,47,170,43,5,4,True,0.2647502409692576
2025-01-07 20:16:23,Fail to pick,245,249,0,0,0,0,0,0,0,0,False,0
2025-01-07 20:16:23,persegiMerah,242,257,128,125,127,51,129,51,2,0,True,0.12798461009888482
2025-01-07 20:16:23,Fail to pick,242,257,0,0,0,0,0,0,0,0,False,0
2025-01-07 20:16:28,persegiMerah,246,259,128,117,140,5,135,0,5,5,True,0.4140692941277615
2025-01-07 20:16:28,Fail to pick,246,259,0,0,0,0,0,0,0,0,False,0
2025-01-07 20:16:28,persegiMerah,249,255,125,119,50,86,49,87,1,1,True,0.3056285315366849
2025-01-07 20:16:28,Fail to pick,249,255,0,0,0,0,0,0,0,0,False,0
2025-01-07 20:16:28,persegiMerah,249,258,127,117,71,25,72,24,1,1,True,0.3102683544986036
2025-01-07 20:16:28,Fail to pick,249,258,0,0,0,0,0,0,0,0,False,0
2025-01-07 20:16:28,persegiMerah,250,258,130,116,93,7,94,3,1,4,True,0.2656666084309657
2025-01-07 20:16:28,Fail to pick,250,258,0,0,0,0,0,0,0,0,False,0
2025-01-07 20:16:28,persegiMerah,246,259,130,119,154,17,154,20,0,3,True,0.1129029054174108
2025-01-07 20:16:28,Fail to pick,246,259,0,0,0,0,0,0,0,0,False,0
2025-01-07 20:16:28,persegiMerah,249,257,133,115,12,66,15,68,3,2,True,0.17107223375938696
2025-01-07 20:16:28,Fail to pick,249,257,0,0,0,0,0,0,0,0,False,0
2025-01-07 20:16:29,persegiMerah,248,258,128,117,124,63,125,62,1,1,True,0.17670302644943503
2025-01-07 20:16:29,Fail to pick,248,258,0,0,0,0,0,0,0,0,False,0
2025-01-07 20:16:29,persegiMerah,246,255,123,117,6,51,2,52,4,1,True,0.41394973832431614
2025-01-07 20:16:29,Fail to pick,246,255,0,0,0,0,0,0,0,0,False,0
2025-01-07 20:16:29,persegiMerah,252,256,125,117,30,84,26,85,4,1,True,0.19644379091928965
2025-01-07 20:16:29,Fail to pick,252,256,0,0,0,0,0,0,0,0,False,0
2025-01-07 20:16:29,persegiMerah,247,255,130,119,92,41,91,38,1,3,True,0.4461266479934819
2025-01-07 20:16:29,Fail to pick,247,255,0,0,0,0,0,0,0,0,False,0
2025-01-07 20:16:29,persegiMerah,246,258,129,117,16,15,16,19,0,4,True,0.3227894974702654
2025-01-07 20:16:29,Fail to pick,246,258,0,0,0,0,0,0,0,0,False,0
2025-01-07 20:16:29,persegiMerah,249,253,128,121,155,91,152,88,3,3,True,0.1447549470199866
2025-01-07 20:16:29,Fail to pick,249,253,0,0,0,0,0,0,0,0,False,0
2025-01-07 20:16:29,persegiMerah,246,258,129,119,150,27,151,29,1,2,True,0.38696146727742375
2025-01-07 20:16:29,Fail to pick,246,258,0,0,0,0,0,0,0,0,False,0
2025-01-07 20:16:29,persegiMerah,243,259,125,119,47,84,45,87,2,3,True,0.2048831546843473
2025-01-07 20:16:29,Fail to pick,243,259,0,0,0,0,0,0,0,0,False,0
2025-01-07 20:16:30,persegiMerah,247,253,131,120,65,95,69,91,4,4,True,0.4640299954985807
2025-01-07 20:16:30,Fail to pick,247,253,0,0,0,0,0,0,0,0,False,0
2025-01-07 20:16:30,persegiMerah,243,256,128,121,194,74,192,73,2,1,True,0.30356027330234303
2025-01-07 20:16:30,Fail to pick,243,256,0,0,0,0,0,0,0,0,False,0
2025-01-07 20:16:30,persegiMerah,244,253,128,122,73,90,77,94,4,4,True,0.3151011594022336
2025-01-07 20:16:30,Fail to pick,244,253,0,0,0,0,0,0,0,0,False,0
2025-01-07 20:16:30,persegiMerah,243,254,128,124,66,59,65,55,1,4,False,0.11484622179615225
2025-01-07 20:16:30,Fail to pick,243,254,0,0,0,0,0,0,0,0,False,0
2025-01-07 20:16:30,persegiMerah,245,257,129,118,170,61,168,64,2,3,False,0.3774044329209497
2025-01-07 20:16:30,Fail to pick,245,257,0,0,0,0,0,0,0,0,False,0
2025-01-07 20:16:30,persegiMerah,246,254,132,123,15,6,13,7,2,1,True,0.40600122833752916
2025-01-07 20:16:30,Fail to pick,246,254,0,0,0,0,0,0,0,0,False,0
2025-01-07 20:16:30,persegiMerah,246,258,127,120,167,22,165,22,2,0,True,0.22500119859639833
2025-01-07 20:16:30,Fail to pick,246,258,0,0,0,0,0,0,0,0,False,0
2025-01-07 20:16:30,persegiMerah,245,254,127,119,151,19,152,18,1,1,True,0.3103521420877353
2025-01-07 20:16:30,Fail to pick,245,254,0,0,0,0,0,0,0,0,False,0
2025-01-07 20:16:31,persegiMerah,247,254,129,118,113,34,112,38,1,4,True,0.31530994850868505
2025-01-07 20:16:31,Fail to pick,247,254,0,0,0,0,0,0,0,0,False,0
2025-01-07 20:16:31,persegiMerah,249,255,127,121,83,68,82,70,1,2,True,0.4051751294712729
2025-01-07 20:16:31,Fail to pick,249,255,0,0,0,0,0,0,0,0,False,0
2025-01-07 20:16:31,persegiMerah,247,256,130,118,81,87,82,84,1,3,True,0.20229522016996443
2025-01-07 20:16:31,Fail to pick,247,256,0,0,0,0,0,0,0,0,False,0
2025-01-07 20:16:31,persegiMerah,247,254,134,120,136,28,137,25,1,3,True,0.4280704732236068
2025-01-07 20:16:31,Fail to pick,247,254,0,0,0,0,0,0,0,0,False,0
2025-01-07 20:16:31,persegiMerah,241,259,130,119,73,64,73,62,0,2,True,0.22892636943568132
2025-01-07 20:16:31,Fail to pick,241,259,0,0,0,0,0,0,0,0,False,0
2025-01-07 20:16:31,persegiMerah,242,257,128,118,81,70,78,66,3,4,True,0.2256258068409919
2025-01-07 20:16:31,Fail to pick,242,257,0,0,0,0,0,0,0,0,False,0
2025-01-07 20:16:31,persegiMerah,247,256,128,116,164,25,160,21,4,4,True,0.4300769919131342
2025-01-07 20:16:31,Fail to pick,247,256,0,0,0,0,0,0,0,0,False,0
2025-01-07 20:16:31,persegiMerah,249,258,131,119,179,12,183,14,4,2,True,0.18301350818111414
2025-01-07 20:16:31,Fail to pick,249,258,0,0,0,0,0,0,0,0,False,0
2025-01-07 20:16:31,persegiMerah,251,257,129,115,128,3,126,1,2,2,True,0.3730830936601771
2025-01-07 20:16:31,Fail to pick,251,257,0,0,0,0,0,0,0,0,False,0
2025-01-07 20:16:32,persegiMerah,252,259,133,117,30,60,27,57,3,3,True,0.3930098441183645
2025-01-07 20:16:32,Fail to pick,252,259,0,0,0,0,0,0,0,0,False,0
2025-01-07 20:16:32,persegiMerah,243,263,130,118,102,48,100,50,2,2,False,0.23884069854068934
2025-01-07 20:16:32,Fail to pick,243,263,0,0,0,0,0,0,0,0,False,0
2025-01-07 20:16:32,persegiMerah,244,257,126,114,137,86,140,90,3,4,True,0.49614172592714934
2025-01-07 20:16:32,Fail to pick,244,257,0,0,0,0,0,0,0,0,False,0
2025-01-07 20:16:32,persegiMerah,244,259,124,116,155,64,157,66,2,2,True,0.2499030954268974
2025-01-07 20:16:32,Fail to pick,244,259,0,0,0,0,0,0,0,0,False,0
2025-01-07 20:16:32,persegiMerah,249,257,128,117,183,33,181,33,2,0,True,0.4691781641365903
2025-01-07 20:16:32,Fail to pick,249,257,0,0,0,0,0,0,0,0,False,0
2025-01-07 20:16:32,persegiMerah,240,260,122,116,21,48,22,43,1,5,True,0.44555314123748513
2025-01-07 20:16:32,Fail to pick,240,260,0,0,0,0,0,0,0,0,False,0
2025-01-07 20:16:32,persegiMerah,243,259,126,117,177,84,177,88,0,4,True,0.3019763623011421
2025-01-07 20:16:32,Fail to pick,243,259,0,0,0,0,0,0,0,0,False,0
2025-01-07 20:16:32,persegiMerah,241,262,124,115,99,65,96,65,3,0,True,0.4217575773744642
2025-01-07 20:16:32,Fail to pick,241,262,0,0,0,0,0,0,0,0,False,0
2025-01-07 20:16:32,persegiMerah,244,260,128,115,75,70,77,71,2,1,False,0.23350508703267564
2025-01-07 20:16:32,Fail to pick,244,260,0,0,0,0,0,0,0,0,False,0
2025-01-07 20:16:32,persegiMerah,247,260,128,116,165,27,162,22,3,5,True,0.1654319761824008
2025-01-07 20:16:32,Fail to pick,247,260,0,0,0,0,0,0,0,0,False,0
2025-01-07 20:16:33,persegiMerah,243,259,124,116,192,54,194,58,2,4,False,0.3633370657323144
2025-01-07 20:16:33,Fail to pick,243,259,0,0,0,0,0,0,0,0,False,0
2025-01-07 20:16:33,persegiMerah,247,258,129,118,99,47,103,42,4,5,True,0.1387609868655395
2025-01-07 20:16:33,Fail to pick,247,258,0,0,0,0,0,0,0,0,False,0
2025-01-07 20:16:33,persegiMerah,245,257,129,119,123,64,125,68,2,4,True,0.1627005347655217
2025-01-07 20:16:33,Fail to pick,245,257,0,0,0,0,0,0,0,0,False,0
2025-01-07 20:16:33,persegiMerah,248,256,131,117,165,1,168,-3,3,4,True,0.4661025831606155
2025-01-07 20:16:33,Fail to pick,248,256,0,0,0,0,0,0,0,0,False,0
2025-01-07 20:16:33,persegiMerah,247,255,131,115,80,88,81,84,1,4,True,0.10803626227014701
2025-01-07 20:16:33,Fail to pick,247,255,0,0,0,0,0,0,0,0,False,0
2025-01-07 20:16:33,persegiMerah,248,257,133,119,94,57,89,61,5,4,True,0.10020157396425877
2025-01-07 20:16:33,Fail to pick,248,257,0,0,0,0,0,0,0,0,False,0
2025-01-07 20:16:33,persegiMerah,245,260,131,116,70,36,74,35,4,1,True,0.11832930029551268
2025-01-07 20:16:33,Fail to pick,245,260,0,0,0,0,0,0,0,0,False,0
2025-01-07 20:16:33,persegiMerah,246,259,130,119,38,48,39,45,1,3,False,0.38513852165313467
2025-01-07 20:16:33,Fail to pick,246,259,0,0,0,0,0,0,0,0,False,0
2025-01-07 20:16:33,persegiMerah,244,259,129,114,83,69,87,64,4,5,True,0.4386905738622713
2025-01-07 20:16:33,Fail to pick,244,259,0,0,0,0,0,0,0,0,False,0
2025-01-07 20:16:34,persegiMerah,243,259,130,117,13,57,13,61,0,4,True,0.11617024318007685
2025-01-07 20:16:34,Fail to pick,243,259,0,0,0,0,0,0,0,0,False,0
2025-01-07 20:16:34,persegiMerah,248,251,133,117,184,87,183,88,1,1,False,0.1588819426216309
2025-01-07 20:16:34,Fail to pick,248,251,0,0,0,0,0,0,0,0,False,0
2025-01-07 20:16:34,persegiMerah,246,259,129,117,38,18,40,16,2,2,True,0.34000106273472464
2025-01-07 20:16:34,Fail to pick,246,259,0,0,0,0,0,0,0,0,False,0
2025-01-07 20:16:34,persegiMerah,247,258,128,115,61,49,63,50,2,1,True,0.4296838106626877
2025-01-07 20:16:34,Fail to pick,247,258,0,0,0,0,0,0,0,0,False,0
2025-01-07 20:16:34,persegiMerah,246,257,131,114,198,58,201,55,3,3,True,0.13834000806654229
2025-01-07 20:16:34,Fail to pick,246,257,0,0,0,0,0,0,0,0,False,0
2025-01-07 20:16:34,persegiMerah,246,257,127,115,100,71,99,70,1,1,True,0.3980224809614342
2025-01-07 20:16:34,Fail to pick,246,257,0,0,0,0,0,0,0,0,False,0
2025-01-07 20:16:34,persegiMerah,247,258,130,119,25,71,25,73,0,2,False,0.27403513142581415
2025-01-07 20:16:34,Fail to pick,247,258,0,0,0,0,0,0,0,0,False,0
2025-01-07 20:16:52,persegiMerah,259,225,125,120,75,33,72,33,3,0,False,0.22801149255517192
2025-01-07 20:16:52,persegiMerah,253,226,122,120,45,81,40,80,5,1,False,0.46189723207211975
2025-01-07 20:16:52,Fail to pick,253,226,0,0,0,0,0,0,0,0,False,0
2025-01-07 20:16:52,persegiMerah,260,229,125,116,67,81,62,85,5,4,True,0.21902670768832933
2025-01-07 20:16:52,Fail to pick,260,229,0,0,0,0,0,0,0,0,False,0
2025-01-07 20:16:52,persegiMerah,258,228,124,115,175,25,176,23,1,2,True,0.19901984187158195
2025-01-07 20:16:52,Fail to pick,258,228,0,0,0,0,0,0,0,0,False,0
2025-01-07 20:16:52,persegiMerah,261,225,127,119,72,69,74,65,2,4,True,0.4412423960259403
2025-01-07 20:16:52,Fail to pick,261,225,0,0,0,0,0,0,0,0,False,0
2025-01-07 20:16:52,persegiMerah,256,230,123,118,46,68,43,71,3,3,True,0.4475356530058977
2025-01-07 20:16:52,Fail to pick,256,230,0,0,0,0,0,0,0,0,False,0
2025-01-07 20:16:52,persegiMerah,261,225,126,116,39,61,36,61,3,0,True,0.4918020001189538
2025-01-07 20:16:52,Fail to pick,261,225,0,0,0,0,0,0,0,0,False,0
2025-01-07 20:16:52,persegiMerah,254,228,125,115,14,2,18,0,4,2,True,0.19777156211719663
2025-01-07 20:16:52,Fail to pick,254,228,0,0,0,0,0,0,0,0,False,0
2025-01-07 20:16:53,persegiMerah,255,228,122,119,3,50,-2,45,5,5,True,0.2729584940742103
2025-01-07 20:16:53,Fail to pick,255,228,0,0,0,0,0,0,0,0,False,0
2025-01-07 20:16:53,persegiMerah,257,226,122,120,4,0,4,-4,0,4,True,0.39627994560069857
2025-01-07 20:16:53,Fail to pick,257,226,0,0,0,0,0,0,0,0,False,0
2025-01-07 20:16:53,persegiMerah,256,231,124,119,144,76,147,74,3,2,True,0.36752037323413855
2025-01-07 20:16:53,Fail to pick,256,231,0,0,0,0,0,0,0,0,False,0
2025-01-07 20:16:53,persegiMerah,260,227,130,118,145,33,146,33,1,0,True,0.4302055247327009
2025-01-07 20:16:53,Fail to pick,260,227,0,0,0,0,0,0,0,0,False,0
2025-01-07 20:16:53,persegiMerah,253,228,121,117,137,29,132,28,5,1,False,0.2251861680265953
2025-01-07 20:16:53,Fail to pick,253,228,0,0,0,0,0,0,0,0,False,0
2025-01-07 20:16:53,persegiMerah,262,223,125,115,152,37,147,38,5,1,True,0.4197121437534296
2025-01-07 20:16:53,Fail to pick,262,223,0,0,0,0,0,0,0,0,False,0
2025-01-07 20:16:53,persegiMerah,263,223,126,116,47,90,50,86,3,4,True,0.3690516732376393
2025-01-07 20:16:53,Fail to pick,263,223,0,0,0,0,0,0,0,0,False,0
2025-01-07 20:16:53,persegiMerah,259,223,128,117,17,52,17,52,0,0,True,0.21549568259097784
2025-01-07 20:16:53,Fail to pick,259,223,0,0,0,0,0,0,0,0,False,0
2025-01-07 20:16:54,persegiMerah,259,226,126,118,196,52,194,48,2,4,True,0.46768569935761894
2025-01-07 20:16:54,Fail to pick,259,226,0,0,0,0,0,0,0,0,False,0
2025-01-07 20:16:54,persegiMerah,255,228,122,117,5,17,2,15,3,2,True,0.4915484489047296
2025-01-07 20:16:54,Fail to pick,255,228,0,0,0,0,0,0,0,0,False,0
2025-01-07 20:16:54,persegiMerah,261,223,131,118,59,60,60,59,1,1,False,0.30809772173847816
2025-01-07 20:16:54,Fail to pick,261,223,0,0,0,0,0,0,0,0,False,0
2025-01-07 20:17:08,persegiMerah,404,430,122,115,15,47,14,51,1,4,True,0.46360154851508084
2025-01-07 20:17:08,Merah,404,430,tensor(122.8874),tensor(115.5003),80,37,77,38,3,1,True,0.0
2025-01-07 20:17:08,persegiKuning,393,437,121,108,151,70,153,69,2,1,True,0.2444745178829039
2025-01-07 20:17:09,persegiBiru,398,435,120,106,154,39,158,40,4,1,True,0.42238046369100324
2025-01-07 20:17:09,Fail to pick,398,435,0,0,0,0,0,0,0,0,False,0
2025-01-07 20:17:09,persegiKuning,396,435,119,104,18,86,19,81,1,5,True,0.29326494127242275
2025-01-07 20:17:09,Fail to pick,396,435,0,0,0,0,0,0,0,0,False,0
2025-01-07 20:17:20,persegiMerah,146,436,125,109,116,43,119,40,3,3,True,0.11303589734914957
2025-01-07 20:17:20,Merah,146,436,tensor(125.3494),tensor(109.5483),78,13,77,13,1,0,True,0.0
2025-01-07 20:17:20,persegiMerah,145,432,127,113,26,5,27,6,1,1,True,0.4242276297248664
2025-01-07 20:17:20,Fail to pick,145,432,0,0,0,0,0,0,0,0,False,0
2025-01-07 20:17:20,persegiMerah,147,433,129,112,102,91,99,92,3,1,True,0.3603920845296946
2025-01-07 20:17:20,Fail to pick,147,433,0,0,0,0,0,0,0,0,False,0
2025-01-07 20:17:20,persegiMerah,146,436,126,109,17,5,14,5,3,0,True,0.38111385924043517
2025-01-07 20:17:20,Fail to pick,146,436,0,0,0,0,0,0,0,0,False,0
2025-01-07 20:17:20,persegiMerah,145,434,124,111,47,91,49,86,2,5,True,0.4917555605122008
2025-01-07 20:17:20,Fail to pick,145,434,0,0,0,0,0,0,0,0,False,0
2025-01-07 20:17:20,persegiMerah,145,433,132,113,1,76,-2,73,3,3,True,0.2873898741049773
2025-01-07 20:17:20,Fail to pick,145,433,0,0,0,0,0,0,0,0,False,0
2025-01-07 20:17:20,persegiMerah,140,432,129,113,18,2,19,-3,1,5,True,0.43187190028767464
2025-01-07 20:17:20,Fail to pick,140,432,0,0,0,0,0,0,0,0,False,0
2025-01-07 20:17:21,persegiMerah,149,433,131,111,35,36,31,40,4,4,True,0.3941107989472381
2025-01-07 20:17:21,Fail to pick,149,433,0,0,0,0,0,0,0,0,False,0
2025-01-07 20:17:21,persegiMerah,150,433,132,111,97,3,96,2,1,1,False,0.2543906813976968
2025-01-07 20:17:21,Fail to pick,150,433,0,0,0,0,0,0,0,0,False,0
2025-01-07 20:17:21,persegiMerah,146,429,130,111,46,82,46,85,0,3,True,0.2088242936479448
2025-01-07 20:17:21,Fail to pick,146,429,0,0,0,0,0,0,0,0,False,0
2025-01-07 20:17:21,persegiMerah,149,432,131,113,36,18,40,22,4,4,True,0.2767801365723764
2025-01-07 20:17:21,Fail to pick,149,432,0,0,0,0,0,0,0,0,False,0
2025-01-07 20:17:21,persegiMerah,140,434,127,112,132,26,133,21,1,5,True,0.3548531763636219
2025-01-07 20:17:21,Fail to pick,140,434,0,0,0,0,0,0,0,0,False,0
2025-01-07 20:17:21,persegiMerah,150,431,131,111,25,99,25,100,0,1,True,0.23322908971861556
2025-01-07 20:17:21,persegiMerah,150,433,132,111,72,3,75,6,3,3,True,0.15288091330087172
2025-01-07 20:17:21,Fail to pick,150,433,0,0,0,0,0,0,0,0,False,0
2025-01-07 20:17:21,persegiMerah,145,433,128,112,166,79,165,79,1,0,True,0.3547916934884776
2025-01-07 20:17:21,Fail to pick,145,433,0,0,0,0,0,0,0,0,False,0
2025-01-07 20:17:21,persegiMerah,148,434,131,113,157,59,161,54,4,5,True,0.13953540971918904
2025-01-07 20:17:21,Fail to pick,148,434,0,0,0,0,0,0,0,0,False,0
2025-01-07 20:17:22,persegiMerah,137,438,128,108,69,16,72,19,3,3,True,0.2859899614349482
2025-01-07 20:19:24,persegiMerah,254,239,141,125,195,27,196,30,1,3,True,0.1766902228257622
2025-01-07 20:19:24,Merah,254,239,tensor(141.4942),tensor(125.3539),133,23,132,20,1,3,True,0.0
2025-01-07 20:19:24,persegiMerah,255,239,138,126,131,80,128,77,3,3,False,0.2042538055710634
2025-01-07 20:19:24,Fail to pick,255,239,0,0,0,0,0,0,0,0,False,0
2025-01-07 20:19:24,persegiMerah,252,242,140,127,48,5,49,4,1,1,True,0.24781190934442598
2025-01-07 20:19:24,Fail to pick,252,242,0,0,0,0,0,0,0,0,False,0
2025-01-07 20:19:24,persegiMerah,252,238,140,129,16,53,17,51,1,2,True,0.2550550597423947
2025-01-07 20:19:24,Fail to pick,252,238,0,0,0,0,0,0,0,0,False,0
2025-01-07 20:19:25,persegiMerah,248,236,145,128,140,97,138,93,2,4,True,0.2816018383798268
2025-01-07 20:19:25,Fail to pick,248,236,0,0,0,0,0,0,0,0,False,0
2025-01-07 20:19:25,persegiMerah,258,241,139,127,178,75,175,70,3,5,True,0.44518432195294466
2025-01-07 20:19:25,persegiMerah,257,241,137,127,124,68,120,66,4,2,False,0.2281325012987906
2025-01-07 20:19:25,Fail to pick,257,241,0,0,0,0,0,0,0,0,False,0
2025-01-07 20:19:25,persegiMerah,253,240,135,128,194,33,190,31,4,2,False,0.28453297991297477
2025-01-07 20:19:25,Fail to pick,253,240,0,0,0,0,0,0,0,0,False,0
2025-01-07 20:19:25,persegiMerah,259,237,140,128,192,3,191,0,1,3,True,0.41527931861648215
2025-01-07 20:19:25,Fail to pick,259,237,0,0,0,0,0,0,0,0,False,0
2025-01-07 20:19:25,persegiMerah,255,237,141,129,145,96,140,99,5,3,True,0.3050273179604449
2025-01-07 20:19:25,Fail to pick,255,237,0,0,0,0,0,0,0,0,False,0
2025-01-07 20:19:25,persegiMerah,261,237,137,129,43,37,42,41,1,4,True,0.2726422812904088
2025-01-07 20:19:25,Fail to pick,261,237,0,0,0,0,0,0,0,0,False,0
2025-01-07 20:19:25,persegiMerah,259,241,137,127,78,85,75,82,3,3,True,0.2476754248815093
2025-01-07 20:19:25,Fail to pick,259,241,0,0,0,0,0,0,0,0,False,0
2025-01-07 20:19:25,persegiMerah,261,241,137,127,139,23,142,23,3,0,True,0.23074516245758328
2025-01-07 20:19:25,Fail to pick,261,241,0,0,0,0,0,0,0,0,False,0
2025-01-07 20:19:26,persegiMerah,259,238,139,132,167,48,170,43,3,5,True,0.13144129105081284
2025-01-07 20:19:26,Fail to pick,259,238,0,0,0,0,0,0,0,0,False,0
2025-01-07 20:19:26,persegiMerah,259,236,142,127,103,72,103,68,0,4,True,0.3280156602229832
2025-01-07 20:19:26,Fail to pick,259,236,0,0,0,0,0,0,0,0,False,0
2025-01-07 20:19:26,persegiMerah,252,241,141,126,152,67,154,65,2,2,True,0.4004385600088932
2025-01-07 20:19:26,Fail to pick,252,241,0,0,0,0,0,0,0,0,False,0
2025-01-07 20:19:26,persegiMerah,259,237,138,126,55,74,54,76,1,2,True,0.4710735789104322
2025-01-07 20:19:26,Fail to pick,259,237,0,0,0,0,0,0,0,0,False,0
2025-01-07 20:19:26,persegiMerah,256,237,142,130,86,27,84,29,2,2,True,0.23665832170948847
2025-01-07 20:19:26,Fail to pick,256,237,0,0,0,0,0,0,0,0,False,0
2025-01-07 20:19:26,persegiMerah,261,238,138,128,196,29,197,31,1,2,True,0.38970984968782474
2025-01-07 20:19:26,Fail to pick,261,238,0,0,0,0,0,0,0,0,False,0
2025-01-07 20:19:26,persegiMerah,255,238,140,129,140,77,136,78,4,1,True,0.23268749330057015
2025-01-07 20:19:26,Fail to pick,255,238,0,0,0,0,0,0,0,0,False,0
2025-01-07 20:19:26,persegiMerah,255,237,141,129,119,93,119,90,0,3,True,0.4542321294582641
2025-01-07 20:19:26,Fail to pick,255,237,0,0,0,0,0,0,0,0,False,0
2025-01-07 20:19:26,persegiMerah,250,237,139,127,169,37,170,32,1,5,True,0.24691654856202294
2025-01-07 20:19:26,Fail to pick,250,237,0,0,0,0,0,0,0,0,False,0
2025-01-07 20:19:37,persegiMerah,388,427,133,115,13,0,16,-2,3,2,False,0.432486247730134
2025-01-07 20:19:37,Merah,388,427,tensor(133.9510),tensor(115.4743),81,35,82,32,1,3,True,0.0005002021789550781
2025-01-07 20:19:37,persegiMerah,392,428,134,113,140,46,144,46,4,0,True,0.42388617637396353
2025-01-07 20:19:37,Fail to pick,392,428,0,0,0,0,0,0,0,0,False,0
2025-01-07 20:19:37,persegiMerah,392,427,135,113,110,52,110,54,0,2,True,0.48647516176405425
2025-01-07 20:19:37,Fail to pick,392,427,0,0,0,0,0,0,0,0,False,0
2025-01-07 20:19:37,persegiMerah,386,430,137,116,98,67,93,66,5,1,True,0.26126112094913645
2025-01-07 20:19:37,Fail to pick,386,430,0,0,0,0,0,0,0,0,False,0
2025-01-07 20:19:38,persegiMerah,397,429,135,114,76,42,77,38,1,4,True,0.1388797964224469
2025-01-07 20:19:38,persegiMerah,389,434,139,115,132,23,128,24,4,1,False,0.4646853738656874
2025-01-07 20:19:38,Fail to pick,389,434,0,0,0,0,0,0,0,0,False,0
2025-01-07 20:19:38,persegiMerah,385,431,134,114,163,1,166,1,3,0,True,0.2008812500728425
2025-01-07 20:19:38,Fail to pick,385,431,0,0,0,0,0,0,0,0,False,0
2025-01-07 20:19:38,persegiMerah,395,428,134,113,199,74,196,72,3,2,True,0.30192431231773353
2025-01-07 20:19:38,persegiMerah,391,429,137,113,84,39,83,43,1,4,True,0.187279374517316
2025-01-07 20:19:38,Fail to pick,391,429,0,0,0,0,0,0,0,0,False,0
2025-01-07 20:19:39,persegiMerah,388,429,136,114,176,97,172,95,4,2,True,0.34753208470368474
2025-01-07 20:19:39,Fail to pick,388,429,0,0,0,0,0,0,0,0,False,0
2025-01-07 20:19:39,persegiMerah,389,428,137,114,100,83,102,81,2,2,True,0.3403686007663995
2025-01-07 20:19:39,Fail to pick,389,428,0,0,0,0,0,0,0,0,False,0
2025-01-07 20:19:39,persegiMerah,391,432,137,115,57,20,58,22,1,2,True,0.38294869989682245
2025-01-07 20:19:39,Fail to pick,391,432,0,0,0,0,0,0,0,0,False,0
2025-01-07 20:19:39,persegiMerah,393,428,137,111,34,7,29,9,5,2,True,0.16554576339972732
2025-01-07 20:19:39,Fail to pick,393,428,0,0,0,0,0,0,0,0,False,0
2025-01-07 20:19:44,persegiMerah,452,449,153,131,163,54,162,56,1,2,True,0.1980800942893521
2025-01-07 20:19:44,persegiMerah,453,447,159,129,56,50,60,47,4,3,True,0.27683856261164486
2025-01-07 20:19:44,Fail to pick,453,447,0,0,0,0,0,0,0,0,False,0
2025-01-07 20:19:44,persegiMerah,448,453,157,130,140,14,143,12,3,2,True,0.2634267339203492
2025-01-07 20:19:44,Fail to pick,448,453,0,0,0,0,0,0,0,0,False,0
2025-01-07 20:19:44,persegiMerah,448,453,160,132,93,48,91,50,2,2,True,0.4963171063472738
2025-01-07 20:19:44,Fail to pick,448,453,0,0,0,0,0,0,0,0,False,0
2025-01-07 20:19:44,persegiMerah,451,452,154,130,131,53,129,56,2,3,False,0.10481218484307378
2025-01-07 20:19:44,Fail to pick,451,452,0,0,0,0,0,0,0,0,False,0
2025-01-07 20:19:44,persegiMerah,450,446,156,126,54,96,54,99,0,3,True,0.42647719526856087
2025-01-07 20:19:44,Fail to pick,450,446,0,0,0,0,0,0,0,0,False,0
2025-01-07 20:19:49,persegiMerah,169,356,144,118,122,9,122,11,0,2,True,0.24625182671352264
2025-01-07 20:19:49,Merah,169,356,tensor(144.5573),tensor(118.1837),101,15,96,18,5,3,True,0.0
2025-01-07 20:19:49,persegiMerah,170,354,145,119,74,65,70,68,4,3,True,0.3979997587348587
2025-01-07 20:19:49,Fail to pick,170,354,0,0,0,0,0,0,0,0,False,0
2025-01-07 20:19:49,persegiMerah,165,356,141,120,101,56,96,59,5,3,True,0.49842979174201807
2025-01-07 20:19:49,Fail to pick,165,356,0,0,0,0,0,0,0,0,False,0
2025-01-07 20:19:49,persegiMerah,161,362,143,118,97,14,101,17,4,3,True,0.18707579001430086
2025-01-07 20:19:49,Fail to pick,161,362,0,0,0,0,0,0,0,0,False,0
2025-01-07 20:19:49,persegiMerah,162,363,142,119,81,79,85,79,4,0,True,0.48211307447384033
2025-01-07 20:19:49,Fail to pick,162,363,0,0,0,0,0,0,0,0,False,0
2025-01-07 20:19:49,persegiMerah,161,361,141,116,174,34,173,37,1,3,False,0.3886887377084588
2025-01-07 20:19:49,Fail to pick,161,361,0,0,0,0,0,0,0,0,False,0
2025-01-07 20:19:49,persegiMerah,164,364,140,118,139,64,134,59,5,5,True,0.15121407018118102
2025-01-07 20:19:49,Fail to pick,164,364,0,0,0,0,0,0,0,0,False,0
2025-01-07 20:19:49,persegiMerah,163,360,140,117,119,59,122,59,3,0,False,0.357538974895549
2025-01-07 20:19:49,Fail to pick,163,360,0,0,0,0,0,0,0,0,False,0
2025-01-07 20:19:49,persegiMerah,162,357,144,114,27,45,29,45,2,0,True,0.34618530159015004
2025-01-07 20:19:49,Fail to pick,162,357,0,0,0,0,0,0,0,0,False,0
2025-01-07 20:19:50,persegiMerah,162,361,142,117,120,92,123,87,3,5,True,0.10199944019928164
2025-01-07 20:19:50,Fail to pick,162,361,0,0,0,0,0,0,0,0,False,0
2025-01-07 20:19:50,persegiMerah,158,363,138,123,142,81,145,78,3,3,True,0.40746970597778875
2025-01-07 20:19:50,Fail to pick,158,363,0,0,0,0,0,0,0,0,False,0
2025-01-07 20:19:54,persegiMerah,159,363,139,112,35,45,37,43,2,2,True,0.43071163235872545
2025-01-07 20:19:54,Fail to pick,159,363,0,0,0,0,0,0,0,0,False,0
2025-01-07 20:19:55,persegiMerah,165,360,140,112,69,42,71,39,2,3,True,0.25048339788780216
2025-01-07 20:19:55,Fail to pick,165,360,0,0,0,0,0,0,0,0,False,0
2025-01-07 20:19:55,persegiMerah,140,402,127,108,1,63,-3,66,4,3,True,0.3077139056384669
2025-01-07 20:19:55,Merah,140,402,tensor(127.9524),tensor(108.8205),88,12,86,11,2,1,True,0.0
2025-01-07 20:20:24,persegiMerah,158,102,125,124,131,18,132,19,1,1,True,0.28093013408743106
2025-01-07 20:20:24,Merah,158,102,tensor(125.6742),tensor(124.1897),171,14,172,15,1,1,True,0.0004999637603759766
2025-01-07 20:20:24,persegiMerah,149,89,134,130,19,33,20,36,1,3,True,0.2860380356495074
2025-01-07 20:20:24,persegiMerah,192,114,150,129,33,88,37,87,4,1,True,0.23609017521299358
2025-01-07 20:20:24,persegiMerah,192,113,143,126,57,39,52,37,5,2,True,0.2332081259709478
2025-01-07 20:20:24,Fail to pick,192,113,0,0,0,0,0,0,0,0,False,0
2025-01-07 20:20:24,persegiMerah,188,111,145,131,29,3,26,1,3,2,False,0.4122220928532463
2025-01-07 20:20:24,Fail to pick,188,111,0,0,0,0,0,0,0,0,False,0
2025-01-07 20:20:24,persegiMerah,186,115,142,128,141,93,137,91,4,2,True,0.33072735429000766
2025-01-07 20:20:24,Fail to pick,186,115,0,0,0,0,0,0,0,0,False,0
2025-01-07 20:20:25,persegiMerah,185,113,139,131,15,94,11,90,4,4,False,0.2642190806479002
2025-01-07 20:20:25,Fail to pick,185,113,0,0,0,0,0,0,0,0,False,0
2025-01-07 20:20:25,persegiMerah,186,110,140,127,24,29,22,31,2,2,True,0.30568547339078145
2025-01-07 20:20:25,Fail to pick,186,110,0,0,0,0,0,0,0,0,False,0
2025-01-07 20:20:25,persegiMerah,190,111,150,132,105,17,106,14,1,3,True,0.35558357395804585
2025-01-07 20:20:25,Fail to pick,190,111,0,0,0,0,0,0,0,0,False,0
2025-01-07 20:20:25,persegiMerah,187,112,142,128,142,9,145,8,3,1,True,0.48224637421658656
2025-01-07 20:20:25,Fail to pick,187,112,0,0,0,0,0,0,0,0,False,0
2025-01-07 20:20:25,persegiMerah,190,113,144,129,19,59,19,60,0,1,False,0.16123843309509894
2025-01-07 20:20:25,Fail to pick,190,113,0,0,0,0,0,0,0,0,False,0
2025-01-07 20:20:25,persegiMerah,187,112,145,126,0,92,-2,87,2,5,True,0.3504291715761413
2025-01-07 20:20:25,Fail to pick,187,112,0,0,0,0,0,0,0,0,False,0
2025-01-07 20:20:25,persegiMerah,190,111,147,126,32,76,34,74,2,2,True,0.44216525751975533
2025-01-07 20:20:26,Fail to pick,190,111,0,0,0,0,0,0,0,0,False,0
2025-01-07 20:20:26,persegiMerah,189,113,144,128,150,86,150,85,0,1,True,0.29527989397912335
2025-01-07 20:20:26,Fail to pick,189,113,0,0,0,0,0,0,0,0,False,0
2025-01-07 20:20:26,persegiMerah,189,108,147,133,15,10,11,12,4,2,True,0.35728727879966937
2025-01-07 20:20:26,Fail to pick,189,108,0,0,0,0,0,0,0,0,False,0
2025-01-07 20:20:26,persegiMerah,192,114,151,129,127,15,122,19,5,4,True,0.2564352138884346
2025-01-07 20:20:26,Fail to pick,192,114,0,0,0,0,0,0,0,0,False,0
2025-01-07 20:20:26,persegiMerah,186,117,147,128,25,89,29,85,4,4,True,0.3228181659277072
2025-01-07 20:20:26,Fail to pick,186,117,0,0,0,0,0,0,0,0,False,0
2025-01-07 20:20:26,persegiMerah,187,112,144,128,112,75,109,74,3,1,True,0.39128357712855966
2025-01-07 20:20:26,Fail to pick,187,112,0,0,0,0,0,0,0,0,False,0
2025-01-07 20:20:26,persegiMerah,194,110,146,128,127,32,122,36,5,4,True,0.19579207047862512
2025-01-07 20:20:26,Fail to pick,194,110,0,0,0,0,0,0,0,0,False,0
2025-01-07 20:20:26,persegiMerah,188,113,147,130,25,10,22,6,3,4,True,0.29347599906282706
2025-01-07 20:20:26,Fail to pick,188,113,0,0,0,0,0,0,0,0,False,0
2025-01-07 20:20:27,persegiMerah,185,112,143,131,74,43,70,47,4,4,True,0.40723146815264666
2025-01-07 20:20:27,Fail to pick,185,112,0,0,0,0,0,0,0,0,False,0
2025-01-07 20:20:27,persegiMerah,179,115,139,127,185,75,185,75,0,0,True,0.3772215961840679
2025-01-07 20:20:27,Fail to pick,179,115,0,0,0,0,0,0,0,0,False,0
2025-01-07 20:20:40,persegiMerah,317,486,134,109,104,29,99,33,5,4,True,0.16877398208114552
2025-01-07 20:20:40,Merah,317,486,tensor(134.4763),tensor(109.8307),65,29,62,32,3,3,True,0.0
2025-01-07 20:20:41,persegiMerah,325,486,138,112,108,29,109,33,1,4,True,0.23407752728126865
2025-01-07 20:20:41,Fail to pick,325,486,0,0,0,0,0,0,0,0,False,0
2025-01-07 20:20:41,persegiMerah,319,487,133,111,162,85,165,88,3,3,True,0.3941072133621518
2025-01-07 20:20:41,Fail to pick,319,487,0,0,0,0,0,0,0,0,False,0
2025-01-07 20:20:41,persegiMerah,317,484,135,109,187,45,182,46,5,1,True,0.3901580664559372
2025-01-07 20:20:41,Fail to pick,317,484,0,0,0,0,0,0,0,0,False,0
2025-01-07 20:20:41,persegiMerah,324,484,135,110,43,49,38,44,5,5,True,0.406783493037154
2025-01-07 20:20:41,Fail to pick,324,484,0,0,0,0,0,0,0,0,False,0
2025-01-07 20:20:41,persegiMerah,324,485,135,111,164,90,162,92,2,2,True,0.4027626909343579
2025-01-07 20:20:41,Fail to pick,324,485,0,0,0,0,0,0,0,0,False,0
2025-01-07 20:20:42,persegiMerah,324,484,137,113,15,88,16,85,1,3,True,0.10965310206370585
2025-01-07 20:20:42,Fail to pick,324,484,0,0,0,0,0,0,0,0,False,0
2025-01-07 20:20:42,persegiMerah,319,486,139,109,1,70,-3,74,4,4,True,0.2891521699642018
2025-01-07 20:20:42,Fail to pick,319,486,0,0,0,0,0,0,0,0,False,0
2025-01-07 20:20:42,persegiMerah,323,484,135,112,144,58,143,60,1,2,True,0.40206713351327406
2025-01-07 20:20:42,Fail to pick,323,484,0,0,0,0,0,0,0,0,False,0
2025-01-07 20:20:42,persegiMerah,322,485,136,110,0,89,3,87,3,2,True,0.43558564982937586
2025-01-07 20:20:42,Fail to pick,322,485,0,0,0,0,0,0,0,0,False,0
2025-01-07 20:20:42,persegiMerah,320,484,139,111,130,93,127,95,3,2,True,0.24318004022748876
2025-01-07 20:20:42,Fail to pick,320,484,0,0,0,0,0,0,0,0,False,0
2025-01-07 20:20:42,persegiMerah,326,485,142,112,40,18,43,14,3,4,True,0.11940784046669717
2025-01-07 20:20:42,Fail to pick,326,485,0,0,0,0,0,0,0,0,False,0
2025-01-07 20:20:42,persegiMerah,322,484,135,112,182,6,178,1,4,5,True,0.3262256289326241
2025-01-07 20:20:42,Fail to pick,322,484,0,0,0,0,0,0,0,0,False,0
2025-01-07 20:20:42,persegiMerah,321,485,136,112,124,0,120,-4,4,4,True,0.3754243108092784
2025-01-07 20:20:42,Fail to pick,321,485,0,0,0,0,0,0,0,0,False,0
2025-01-07 20:20:47,persegiMerah,424,521,157,126,6,47,3,50,3,3,True,0.43943535525430677
2025-01-07 20:20:48,persegiMerah,408,529,155,118,157,91,154,91,3,0,False,0.2909435516768788
2025-01-07 20:20:48,persegiMerah,407,528,157,120,72,58,74,56,2,2,True,0.26160395941048914
2025-01-07 20:20:48,Fail to pick,407,528,0,0,0,0,0,0,0,0,False,0
2025-01-07 20:20:48,persegiMerah,412,526,154,120,88,40,87,40,1,0,True,0.4964850681624424
2025-01-07 20:20:48,Fail to pick,412,526,0,0,0,0,0,0,0,0,False,0
2025-01-07 20:20:49,persegiMerah,408,531,157,122,15,76,14,76,1,0,True,0.3595014912787218
2025-01-07 20:20:49,Fail to pick,408,531,0,0,0,0,0,0,0,0,False,0
2025-01-07 20:20:49,persegiMerah,374,512,154,127,198,95,201,91,3,4,True,0.49877631447628645
2025-01-07 20:21:02,persegiMerah,187,359,141,115,68,26,71,22,3,4,True,0.35058170415495427
2025-01-07 20:21:02,Merah,187,359,tensor(141.0019),tensor(115.7060),100,17,99,19,1,2,True,0.0
2025-01-07 20:21:02,persegiMerah,159,343,137,120,185,54,183,53,2,1,False,0.30984303055116513
2025-01-07 20:21:02,persegiMerah,186,366,145,121,70,73,67,76,3,3,True,0.4834468337692023
2025-01-07 20:21:02,persegiMerah,183,364,145,118,109,87,108,82,1,5,True,0.43811577718777317
2025-01-07 20:21:02,Fail to pick,183,364,0,0,0,0,0,0,0,0,False,0
2025-01-07 20:21:02,persegiMerah,186,362,148,116,115,59,111,61,4,2,True,0.17771568431631876
2025-01-07 20:21:02,Fail to pick,186,362,0,0,0,0,0,0,0,0,False,0
2025-01-07 20:21:02,persegiMerah,188,361,146,118,21,68,21,70,0,2,True,0.49467904605592006
2025-01-07 20:21:02,Fail to pick,188,361,0,0,0,0,0,0,0,0,False,0
2025-01-07 20:21:03,persegiMerah,187,362,145,115,14,64,10,66,4,2,True,0.23804549977796705
2025-01-07 20:21:03,Fail to pick,187,362,0,0,0,0,0,0,0,0,False,0
2025-01-07 20:21:03,persegiMerah,189,361,146,118,82,56,80,59,2,3,True,0.49703815457163525
2025-01-07 20:21:03,Fail to pick,189,361,0,0,0,0,0,0,0,0,False,0
2025-01-07 20:21:03,persegiMerah,185,365,143,118,105,83,100,87,5,4,True,0.3752231471447832
2025-01-07 20:21:03,Fail to pick,185,365,0,0,0,0,0,0,0,0,False,0
2025-01-07 20:21:03,persegiMerah,188,365,144,122,158,26,156,29,2,3,False,0.4428725475306655
2025-01-07 20:21:03,Fail to pick,188,365,0,0,0,0,0,0,0,0,False,0
2025-01-07 20:21:03,persegiMerah,181,369,139,122,38,33,40,34,2,1,True,0.16501191657908743
2025-01-07 20:21:03,Fail to pick,181,369,0,0,0,0,0,0,0,0,False,0
2025-01-07 20:21:03,persegiMerah,187,365,143,121,194,94,193,93,1,1,True,0.3364466739165488
2025-01-07 20:21:03,Fail to pick,187,365,0,0,0,0,0,0,0,0,False,0
2025-01-07 20:21:03,persegiMerah,183,367,146,120,31,86,30,86,1,0,False,0.10693194691019517
2025-01-07 20:21:03,Fail to pick,183,367,0,0,0,0,0,0,0,0,False,0
2025-01-07 20:21:03,persegiMerah,186,368,148,120,105,44,103,46,2,2,True,0.2329120818612198
2025-01-07 20:21:03,Fail to pick,186,368,0,0,0,0,0,0,0,0,False,0
2025-01-07 20:21:04,persegiMerah,188,364,147,118,151,74,153,74,2,0,True,0.14088766150228305
2025-01-07 20:21:04,Fail to pick,188,364,0,0,0,0,0,0,0,0,False,0
2025-01-07 20:21:04,persegiMerah,187,361,144,114,100,65,102,64,2,1,True,0.34540551586977075
2025-01-07 20:21:04,Fail to pick,187,361,0,0,0,0,0,0,0,0,False,0
2025-01-07 20:54:57,persegiMerah,219,441,133,132,103,23,100,20,3,3,False,0.3755146119526831
2025-01-07 20:54:57,Merah,219,441,tensor(133.9305),tensor(132.2298),77,20,79,17,2,3,True,0.000499725341796875
2025-01-07 20:54:58,persegiMerah,215,438,131,131,84,12,83,13,1,1,True,0.2647378312894882
2025-01-07 20:54:58,Fail to pick,215,438,0,0,0,0,0,0,0,0,False,0
2025-01-07 20:54:58,segienamKuning,69,169,116,95,129,95,124,95,5,0,True,0.4941294309775458
2025-01-07 20:54:59,segienamKuning,90,113,109,89,77,75,75,73,2,2,True,0.2760301045638892
2025-01-07 20:54:59,Kuning,90,113,tensor(109.1987),tensor(89.6736),168,8,166,5,2,3,True,0.0
2025-01-07 20:54:59,segienamKuning,77,142,108,95,50,20,47,19,3,1,True,0.4009888490218626
2025-01-07 20:55:00,segienamKuning,122,155,116,92,133,3,135,7,2,4,True,0.31703545674506195
2025-01-07 20:55:00,segienamKuning,115,157,112,90,146,78,147,74,1,4,True,0.17120168360929522
2025-01-07 20:55:00,Fail to pick,115,157,0,0,0,0,0,0,0,0,False,0
2025-01-07 20:55:00,persegiMerah,250,407,131,141,89,49,93,48,4,1,True,0.1187154618921428
2025-01-07 20:55:00,Merah,250,407,tensor(131.8659),tensor(141.7335),86,23,90,18,4,5,True,0.0
2025-01-07 20:55:00,segienamKuning,121,168,113,94,198,13,199,14,1,1,True,0.3272452408317521
2025-01-07 20:55:01,segienamKuning,99,161,105,85,90,32,94,35,4,3,True,0.1845959130212171
2025-01-07 20:55:01,persegiMerah,243,407,136,140,13,62,13,60,0,2,True,0.44630676974549777
2025-01-07 20:55:01,segienamKuning,80,195,108,90,24,17,27,17,3,0,True,0.3550796876515726
2025-01-07 20:55:01,persegiMerah,254,450,141,135,17,45,12,47,5,2,True,0.23209724348938043
2025-01-07 20:55:01,lingkaranKuning,42,212,82,88,193,14,196,9,3,5,True,0.24280290319147335
2025-01-07 20:55:02,persegiMerah,249,412,132,139,42,21,42,16,0,5,True,0.27191643846023716
2025-01-07 20:55:02,segienamKuning,102,157,106,88,44,87,47,91,3,4,True,0.42457718835690395
2025-01-07 20:55:02,Merah,249,412,tensor(132.1258),tensor(139.1097),85,23,84,18,1,5,True,0.0
2025-01-07 20:55:02,persegiMerah,249,406,131,141,184,15,185,18,1,3,True,0.13417923439672952
2025-01-07 20:55:02,segienamKuning,93,143,110,94,118,68,114,67,4,1,True,0.3152649776841234
2025-01-07 20:55:02,segienamKuning,94,140,107,94,84,39,83,34,1,5,True,0.3987856237805004
2025-01-07 20:55:02,Fail to pick,94,140,0,0,0,0,0,0,0,0,False,0
2025-01-07 20:55:03,segienamKuning,77,158,100,82,29,80,29,82,0,2,False,0.18227684846404013
2025-01-07 20:55:03,segienamKuning,78,126,109,88,170,48,172,49,2,1,True,0.4665417072162079
2025-01-07 20:55:03,segienamKuning,74,117,101,92,153,66,149,70,4,4,True,0.3139565124495596
2025-01-07 20:55:03,Fail to pick,74,117,0,0,0,0,0,0,0,0,False,0
2025-01-07 20:55:03,segienamKuning,75,91,110,95,134,16,131,20,3,4,True,0.49767593938124677
2025-01-07 20:55:03,persegiMerah,244,382,143,144,178,47,182,44,4,3,True,0.17124270631862004
2025-01-07 20:55:03,Kuning,75,91,tensor(110.5149),tensor(95.3405),174,6,173,5,1,1,True,0.0
2025-01-07 20:55:04,segienamKuning,72,107,104,91,94,13,98,15,4,2,True,0.4710048848738515
2025-01-07 20:55:04,persegiMerah,240,392,135,140,72,7,72,11,0,4,True,0.4956221394474828
2025-01-07 20:55:04,segienamKuning,69,122,109,94,73,84,75,81,2,3,True,0.22961773647221878
2025-01-07 20:55:04,segienamKuning,75,116,107,95,123,37,122,38,1,1,True,0.2305463135135092
2025-01-07 20:55:04,Fail to pick,75,116,0,0,0,0,0,0,0,0,False,0
2025-01-07 20:55:04,segienamKuning,74,108,106,93,163,40,158,38,5,2,True,0.40867906641361806
2025-01-07 20:55:04,persegiMerah,237,402,135,140,42,19,39,15,3,4,True,0.16526596378809044
2025-01-07 20:55:04,Fail to pick,74,108,0,0,0,0,0,0,0,0,False,0
2025-01-07 20:55:04,persegiMerah,221,442,130,133,174,32,178,33,4,1,True,0.18385849885919173
2025-01-07 20:55:13,persegiMerah,784,518,134,123,82,28,80,26,2,2,True,0.2169379671798891
2025-01-07 20:55:13,Merah,784,518,tensor(134.7474),tensor(123.2695),56,72,51,72,5,0,True,0.0
2025-01-07 20:56:02,persegiMerah,777,534,152,136,157,71,158,66,1,5,False,0.187404478039467
2025-01-07 20:56:02,Merah,777,534,tensor(152.2794),tensor(136.8091),51,71,54,68,3,3,True,0.0004992485046386719
2025-01-07 20:57:59,persegiKuning,274,404,124,136,88,57,84,52,4,5,True,0.38690498930473993
2025-01-07 20:57:59,persegiKuning,270,405,114,135,173,3,176,2,3,1,False,0.13050181192696955
2025-01-07 20:57:59,Fail to pick,270,405,0,0,0,0,0,0,0,0,False,0
2025-01-07 20:58:06,persegiKuning,264,416,117,123,161,12,161,7,0,5,True,0.4843304990571776
2025-01-07 20:58:06,persegiKuning,297,398,122,126,130,89,125,89,5,0,True,0.3093738722594251
2025-01-07 20:58:15,persegiMerah,851,615,150,122,69,13,71,9,2,4,True,0.11426499837291547
2025-01-07 20:58:15,Merah,851,615,tensor(150.5354),tensor(122.9092),29,78,32,74,3,4,True,0.0
2025-01-07 20:59:11,persegiMerah,890,550,132,116,67,70,65,66,2,4,True,0.3730524826108289
2025-01-07 20:59:11,Merah,890,550,tensor(132.3253),tensor(116.7841),47,82,49,79,2,3,True,0.0005002021789550781
2025-01-07 20:59:11,persegiMerah,894,552,130,119,178,21,178,16,0,5,True,0.3505144679454021
2025-01-07 20:59:11,Fail to pick,894,552,0,0,0,0,0,0,0,0,False,0
2025-01-07 20:59:11,persegiMerah,896,550,132,119,132,32,127,33,5,1,True,0.3932782297312033
2025-01-07 20:59:11,Fail to pick,896,550,0,0,0,0,0,0,0,0,False,0
2025-01-07 20:59:11,persegiMerah,895,551,134,119,11,87,8,86,3,1,True,0.32477184334113585
2025-01-07 20:59:11,Fail to pick,895,551,0,0,0,0,0,0,0,0,False,0
2025-01-07 20:59:12,persegiMerah,892,549,134,120,68,98,69,95,1,3,True,0.28502851320050526
2025-01-07 20:59:12,Fail to pick,892,549,0,0,0,0,0,0,0,0,False,0
2025-01-07 20:59:12,persegiMerah,898,547,134,118,12,32,10,33,2,1,True,0.45809922949082504
2025-01-07 20:59:12,Fail to pick,898,547,0,0,0,0,0,0,0,0,False,0
2025-01-07 20:59:12,persegiMerah,895,550,134,120,166,44,169,47,3,3,True,0.17118354536064095
2025-01-07 20:59:12,Merah,895,550,tensor(134.4958),tensor(120.0333),47,82,45,86,2,4,True,0.0004999637603759766
2025-01-07 20:59:12,Fail to pick,895,550,0,0,0,0,0,0,0,0,False,0
2025-01-07 20:59:12,persegiMerah,886,548,135,119,184,83,185,83,1,0,True,0.2651412299095214
2025-01-07 20:59:12,Fail to pick,886,548,0,0,0,0,0,0,0,0,False,0
2025-01-07 20:59:12,persegiMerah,892,550,130,117,3,15,-2,17,5,2,True,0.11293587323741106
2025-01-07 20:59:12,Fail to pick,892,550,0,0,0,0,0,0,0,0,False,0
2025-01-07 20:59:12,persegiMerah,895,547,126,119,93,78,90,74,3,4,True,0.4450196129883589
2025-01-07 20:59:12,Fail to pick,895,547,0,0,0,0,0,0,0,0,False,0
2025-01-07 20:59:13,persegiMerah,891,549,131,119,181,49,178,50,3,1,True,0.4880770877868269
2025-01-07 20:59:13,Fail to pick,891,549,0,0,0,0,0,0,0,0,False,0
2025-01-07 20:59:13,persegiMerah,894,550,131,121,32,11,28,10,4,1,True,0.23855190622445252
2025-01-07 20:59:13,Fail to pick,894,550,0,0,0,0,0,0,0,0,False,0
2025-01-07 20:59:13,persegiMerah,888,556,127,119,191,95,194,99,3,4,True,0.13609107886226593
2025-01-07 20:59:13,Fail to pick,888,556,0,0,0,0,0,0,0,0,False,0
2025-01-07 20:59:13,persegiMerah,893,552,127,114,172,27,171,22,1,5,True,0.36498861167372354
2025-01-07 20:59:13,Fail to pick,893,552,0,0,0,0,0,0,0,0,False,0
2025-01-07 20:59:13,persegiMerah,891,551,131,118,11,65,9,69,2,4,True,0.29734047051349344
2025-01-07 20:59:13,Merah,891,551,tensor(131.9564),tensor(118.6664),46,82,50,84,4,2,True,0.0
2025-01-07 20:59:13,Fail to pick,891,551,0,0,0,0,0,0,0,0,False,0
2025-01-07 20:59:13,persegiMerah,858,583,127,117,133,83,130,86,3,3,True,0.4528622399129927
2025-01-07 20:59:14,persegiMerah,864,577,136,117,41,4,38,1,3,3,True,0.16428373444662325
2025-01-07 20:59:14,Fail to pick,864,577,0,0,0,0,0,0,0,0,False,0
2025-01-07 20:59:14,persegiMerah,858,585,126,114,88,89,88,92,0,3,True,0.1821995448529095
2025-01-07 20:59:14,Fail to pick,858,585,0,0,0,0,0,0,0,0,False,0
2025-01-07 20:59:14,persegiMerah,855,592,135,117,162,21,158,25,4,4,True,0.3782208816340431
2025-01-07 20:59:14,Fail to pick,855,592,0,0,0,0,0,0,0,0,False,0
2025-01-07 20:59:14,persegiMerah,857,589,133,117,150,20,145,17,5,3,True,0.2953848862197125
2025-01-07 20:59:14,Fail to pick,857,589,0,0,0,0,0,0,0,0,False,0
2025-01-07 20:59:14,persegiMerah,860,583,131,115,68,29,71,28,3,1,True,0.21310735977652648
2025-01-07 20:59:14,Fail to pick,860,583,0,0,0,0,0,0,0,0,False,0
2025-01-07 20:59:14,persegiMerah,861,586,128,112,99,93,103,95,4,2,True,0.2664748321066655
2025-01-07 20:59:14,Fail to pick,861,586,0,0,0,0,0,0,0,0,False,0
2025-01-07 20:59:14,persegiMerah,868,576,130,114,107,72,111,67,4,5,True,0.3877258752906779
2025-01-07 20:59:14,Merah,868,576,tensor(130.0961),tensor(114.9648),40,80,39,78,1,2,True,0.0
2025-01-07 20:59:15,persegiMerah,856,588,138,114,75,73,79,72,4,1,True,0.48454242001617465
2025-01-07 20:59:15,persegiMerah,863,580,139,115,93,68,91,64,2,4,True,0.2851389697108536
2025-01-07 20:59:15,Fail to pick,863,580,0,0,0,0,0,0,0,0,False,0
2025-01-07 20:59:15,persegiMerah,853,593,135,113,55,38,55,38,0,0,True,0.12095074086864402
2025-01-07 21:00:50,persegiMerah,838,628,140,127,5,79,3,81,2,2,True,0.23964415855301643
2025-01-07 21:00:50,Merah,838,628,tensor(140.2955),tensor(127.1296),25,77,22,73,3,4,True,0.000499725341796875
2025-01-07 21:00:50,persegiMerah,842,612,149,127,45,28,44,25,1,3,True,0.12709556916825515
2025-01-07 21:00:50,persegiMerah,881,561,136,120,12,43,13,41,1,2,True,0.3196824317602951
2025-01-07 21:00:50,persegiMerah,881,560,134,120,54,59,58,60,4,1,True,0.3264973315176515
2025-01-07 21:00:50,Fail to pick,881,560,0,0,0,0,0,0,0,0,False,0
2025-01-07 21:00:50,persegiMerah,880,555,142,115,173,18,174,14,1,4,True,0.3948660610357769
2025-01-07 21:00:50,Fail to pick,880,555,0,0,0,0,0,0,0,0,False,0
2025-01-07 21:00:51,persegiMerah,848,592,142,119,67,50,66,49,1,1,True,0.4224285844547623
2025-01-07 21:00:51,persegiMerah,853,590,131,116,136,79,131,78,5,1,True,0.39050240711998807
2025-01-07 21:00:51,Merah,853,590,tensor(131.3399),tensor(116.0076),36,78,35,80,1,2,True,0.0004990100860595703
2025-01-07 21:00:51,Fail to pick,853,590,0,0,0,0,0,0,0,0,False,0
2025-01-07 21:00:51,persegiMerah,872,571,133,123,172,2,174,-1,2,3,True,0.2694445119322477
2025-01-07 21:00:52,persegiMerah,860,586,138,116,71,32,69,35,2,3,True,0.24863691359840046
2025-01-07 21:00:52,persegiMerah,853,590,136,116,60,15,61,13,1,2,True,0.24909062634528129
2025-01-07 21:00:52,Fail to pick,853,590,0,0,0,0,0,0,0,0,False,0
2025-01-07 21:00:52,persegiMerah,861,584,130,115,95,68,96,63,1,5,True,0.4666214681100086
2025-01-07 21:00:52,Fail to pick,861,584,0,0,0,0,0,0,0,0,False,0
2025-01-07 21:00:52,persegiMerah,855,587,133,117,166,99,166,98,0,1,True,0.42547251924306784
2025-01-07 21:00:52,Merah,855,587,tensor(133.7789),tensor(117.7962),36,79,40,78,4,1,True,0.0
2025-01-07 21:00:52,Fail to pick,855,587,0,0,0,0,0,0,0,0,False,0
2025-01-07 21:00:53,persegiMerah,893,549,133,120,0,59,-2,61,2,2,True,0.2911163002738437
2025-01-07 21:00:53,persegiMerah,886,556,136,121,38,39,35,36,3,3,True,0.24551449944783213
2025-01-07 21:00:53,Fail to pick,886,556,0,0,0,0,0,0,0,0,False,0
2025-01-07 21:00:53,persegiMerah,872,558,136,122,84,12,85,7,1,5,False,0.4377204779106977
2025-01-07 21:00:53,persegiMerah,858,582,135,124,182,50,177,52,5,2,False,0.34691637984265894
2025-01-07 21:00:53,persegiMerah,839,613,135,115,78,30,78,33,0,3,True,0.3190023613631149
2025-01-07 21:00:53,persegiMerah,878,579,138,120,27,40,24,42,3,2,True,0.4833877401509912
2025-01-07 21:00:53,persegiMerah,875,589,142,126,49,1,50,0,1,1,True,0.19105330062251055
2025-01-07 21:00:53,Merah,875,589,tensor(142.0306),tensor(126.0582),36,81,31,85,5,4,True,0.0009272098541259766
2025-01-07 21:00:54,persegiMerah,859,562,163,132,37,70,35,65,2,5,True,0.46122373704205144
2025-01-07 21:00:54,persegiMerah,888,537,153,132,165,41,162,45,3,4,True,0.2068573226590904
2025-01-07 21:00:54,Merah,888,537,tensor(153.4641),tensor(132.1175),50,82,47,77,3,5,True,0.0
2025-01-07 21:00:55,persegiMerah,881,538,152,131,78,77,74,78,4,1,True,0.3716275467104314
2025-01-07 21:00:55,Fail to pick,881,538,0,0,0,0,0,0,0,0,False,0
2025-01-07 21:00:55,persegiMerah,852,590,155,132,137,9,135,4,2,5,True,0.36381861476470956
2025-01-07 21:00:55,persegiMerah,855,587,150,129,14,37,11,41,3,4,True,0.31791290731031285
2025-01-07 21:00:55,Fail to pick,855,587,0,0,0,0,0,0,0,0,False,0
2025-01-07 21:00:55,persegiMerah,857,578,152,128,166,28,161,30,5,2,True,0.4047608429014803
2025-01-07 21:00:55,Fail to pick,857,578,0,0,0,0,0,0,0,0,False,0
2025-01-07 21:00:55,persegiMerah,846,584,169,130,65,6,69,1,4,5,True,0.13666840838699612
2025-01-07 21:00:55,persegiMerah,852,585,160,125,169,61,171,56,2,5,True,0.3807859615023055
2025-01-07 21:00:55,Fail to pick,852,585,0,0,0,0,0,0,0,0,False,0
2025-01-07 21:00:56,persegiMerah,893,563,153,131,157,35,161,37,4,2,True,0.148948220823529
2025-01-07 21:00:56,Merah,893,563,tensor(153.3463),tensor(131.8063),43,82,45,85,2,3,True,0.0
2025-01-07 21:00:56,persegiMerah,857,566,159,130,19,61,23,57,4,4,True,0.18081032089943108
2025-01-07 21:00:56,persegiMerah,844,358,160,140,172,70,169,73,3,3,True,0.13310389174302673
2025-01-07 21:00:57,persegiMerah,838,352,160,142,133,60,132,59,1,1,True,0.21843526362950408
2025-01-07 21:00:57,Merah,838,352,tensor(160.8486),tensor(142.6030),102,77,100,80,2,3,True,0.0
2025-01-07 21:00:57,Fail to pick,838,352,0,0,0,0,0,0,0,0,False,0
2025-01-07 21:00:57,persegiMerah,811,385,159,143,131,13,129,14,2,1,True,0.48401638037546446
2025-01-07 21:00:57,persegiMerah,812,379,159,150,86,46,89,45,3,1,True,0.2744810363934745
2025-01-07 21:00:57,Fail to pick,812,379,0,0,0,0,0,0,0,0,False,0
2025-01-07 21:01:00,persegiMerah,276,319,151,144,174,35,178,32,4,3,True,0.13983882869810604
2025-01-07 21:01:00,persegiMerah,291,317,156,141,54,17,52,16,2,1,True,0.17418670433176953
2025-01-07 21:01:00,persegiMerah,266,327,157,137,82,39,83,42,1,3,True,0.2128278298962381
2025-01-07 21:01:00,persegiMerah,262,328,159,138,156,17,152,12,4,5,False,0.1606800117488957
2025-01-07 21:01:00,Fail to pick,262,328,0,0,0,0,0,0,0,0,False,0
2025-01-07 21:02:02,persegiMerah,283,311,148,148,185,9,182,9,3,0,True,0.20181138771183327
2025-01-07 21:02:02,Merah,283,311,tensor(148.4135),tensor(148.2182),113,26,113,26,0,0,True,0.0
2025-01-07 21:02:02,persegiMerah,279,312,146,151,138,53,137,57,1,4,False,0.14217512216833184
2025-01-07 21:02:02,Fail to pick,279,312,0,0,0,0,0,0,0,0,False,0
2025-01-07 21:02:03,persegiMerah,278,312,145,150,144,56,139,60,5,4,True,0.3688154974074459
2025-01-07 21:02:03,Fail to pick,278,312,0,0,0,0,0,0,0,0,False,0
2025-01-07 21:02:03,persegiMerah,276,318,155,145,156,18,156,14,0,4,True,0.2314171561625214
2025-01-07 21:02:03,Fail to pick,276,318,0,0,0,0,0,0,0,0,False,0
2025-01-07 21:02:03,persegiMerah,278,313,147,151,76,19,72,14,4,5,True,0.15713592628026174
2025-01-07 21:02:03,Fail to pick,278,313,0,0,0,0,0,0,0,0,False,0
2025-01-07 21:02:03,persegiMerah,277,318,155,145,152,74,152,70,0,4,True,0.15284033123429352
2025-01-07 21:02:03,Fail to pick,277,318,0,0,0,0,0,0,0,0,False,0
2025-01-07 21:02:04,persegiMerah,290,312,152,140,30,14,30,12,0,2,True,0.40222835115715405
2025-01-07 21:02:04,persegiMerah,284,321,151,143,128,49,123,52,5,3,True,0.4125295400071124
2025-01-07 21:02:04,Fail to pick,284,321,0,0,0,0,0,0,0,0,False,0
2025-01-07 21:02:04,persegiMerah,280,319,148,144,129,34,129,38,0,4,True,0.37464520080376584
2025-01-07 21:02:04,Fail to pick,280,319,0,0,0,0,0,0,0,0,False,0
2025-01-07 21:02:04,persegiMerah,284,316,146,143,93,98,97,102,4,4,True,0.14351564924523538
2025-01-07 21:02:04,Fail to pick,284,316,0,0,0,0,0,0,0,0,False,0
2025-01-07 21:02:04,persegiMerah,279,319,149,145,175,1,176,2,1,1,True,0.2717222327404637
2025-01-07 21:02:04,Fail to pick,279,319,0,0,0,0,0,0,0,0,False,0
2025-01-07 21:02:04,persegiMerah,291,308,148,147,77,31,75,32,2,1,True,0.35793686189629714
2025-01-07 21:02:05,persegiMerah,281,315,144,142,178,20,180,16,2,4,True,0.1366419825069346
2025-01-07 21:02:05,persegiMerah,290,315,151,141,40,60,43,61,3,1,True,0.4317364509630406
2025-01-07 21:02:05,Fail to pick,290,315,0,0,0,0,0,0,0,0,False,0
2025-01-07 21:02:05,persegiMerah,295,309,147,140,197,83,195,87,2,4,True,0.10797597673383211
2025-01-07 21:02:05,Fail to pick,295,309,0,0,0,0,0,0,0,0,False,0
2025-01-07 21:02:05,persegiMerah,290,312,149,140,87,0,91,-4,4,4,True,0.39970751979144514
2025-01-07 21:02:05,Fail to pick,290,312,0,0,0,0,0,0,0,0,False,0
2025-01-07 21:02:05,persegiMerah,292,313,154,142,137,46,137,45,0,1,True,0.30845757720061334
2025-01-07 21:02:05,Fail to pick,292,313,0,0,0,0,0,0,0,0,False,0
2025-01-07 21:02:05,persegiMerah,294,312,148,141,64,6,65,9,1,3,True,0.1057447489289253
2025-01-07 21:02:05,Fail to pick,294,312,0,0,0,0,0,0,0,0,False,0
2025-01-07 21:02:05,persegiMerah,293,310,147,142,174,93,171,96,3,3,True,0.4636961159193729
2025-01-07 21:02:05,Fail to pick,293,310,0,0,0,0,0,0,0,0,False,0
2025-01-07 21:02:05,persegiMerah,291,313,154,142,113,46,110,50,3,4,True,0.3134896954002373
2025-01-07 21:02:05,Fail to pick,291,313,0,0,0,0,0,0,0,0,False,0
2025-01-07 21:02:05,persegiMerah,294,311,148,140,46,47,46,42,0,5,True,0.19571660529239204
2025-01-07 21:02:05,Fail to pick,294,311,0,0,0,0,0,0,0,0,False,0
2025-01-07 21:02:06,persegiMerah,287,316,143,140,195,16,192,19,3,3,True,0.4686772930298939
2025-01-07 21:02:06,Fail to pick,287,316,0,0,0,0,0,0,0,0,False,0
2025-01-07 21:02:06,persegiMerah,296,313,143,140,115,23,119,26,4,3,True,0.4273361569884244
2025-01-07 21:02:06,Fail to pick,296,313,0,0,0,0,0,0,0,0,False,0
2025-01-07 21:02:06,persegiMerah,297,312,144,139,142,60,141,58,1,2,True,0.32513134328689075
2025-01-07 21:02:06,Fail to pick,297,312,0,0,0,0,0,0,0,0,False,0
2025-01-07 21:02:06,persegiMerah,286,312,147,139,152,34,155,37,3,3,False,0.23661693576786008
2025-01-07 21:02:06,persegiMerah,281,317,145,141,16,68,20,64,4,4,True,0.2684888177057063
2025-01-07 21:02:06,Fail to pick,281,317,0,0,0,0,0,0,0,0,False,0
2025-01-07 21:02:06,persegiMerah,292,312,150,138,177,55,179,50,2,5,True,0.17207731283921604
2025-01-07 21:02:06,persegiMerah,285,316,146,141,140,66,135,68,5,2,True,0.4944440456743947
2025-01-07 21:02:06,Fail to pick,285,316,0,0,0,0,0,0,0,0,False,0
2025-01-07 21:02:06,persegiMerah,286,310,144,140,109,83,111,80,2,3,False,0.4317020222334448
2025-01-07 21:02:06,Fail to pick,286,310,0,0,0,0,0,0,0,0,False,0
2025-01-07 21:02:07,persegiMerah,286,314,147,141,101,61,101,65,0,4,True,0.2773782748422132
2025-01-07 21:02:07,Fail to pick,286,314,0,0,0,0,0,0,0,0,False,0
2025-01-07 21:02:07,persegiMerah,284,314,147,141,171,28,172,27,1,1,True,0.4644885360222746
2025-01-07 21:02:07,Fail to pick,284,314,0,0,0,0,0,0,0,0,False,0
2025-01-07 21:02:07,persegiMerah,286,311,150,138,112,31,116,28,4,3,True,0.2013660156799981
2025-01-07 21:02:07,Fail to pick,286,311,0,0,0,0,0,0,0,0,False,0
2025-01-07 21:02:07,persegiMerah,289,315,151,140,197,73,193,73,4,0,True,0.3642212247496799
2025-01-07 21:02:07,Fail to pick,289,315,0,0,0,0,0,0,0,0,False,0
2025-01-07 21:02:07,persegiMerah,241,339,161,141,121,31,122,35,1,4,True,0.34751532346367064
2025-01-07 21:02:07,persegiMerah,239,338,154,140,46,32,50,36,4,4,True,0.1957780093542203
2025-01-07 21:02:07,Fail to pick,239,338,0,0,0,0,0,0,0,0,False,0
2025-01-07 21:02:07,persegiMerah,230,339,150,139,174,75,177,70,3,5,True,0.17508408688371813
2025-01-07 21:02:07,Fail to pick,230,339,0,0,0,0,0,0,0,0,False,0
2025-01-07 21:02:14,persegiMerah,887,498,143,133,52,30,51,32,1,2,True,0.46575445219028677
2025-01-07 21:02:14,persegiMerah,890,492,142,130,185,11,188,6,3,5,True,0.47034371466617886
2025-01-07 21:02:14,Merah,890,492,tensor(142.1310),tensor(130.7131),63,82,58,79,5,3,True,0.0
2025-01-07 21:02:14,Fail to pick,890,492,0,0,0,0,0,0,0,0,False,0
2025-01-07 21:02:14,persegiMerah,891,466,147,127,65,41,68,44,3,3,False,0.3759910614957559
2025-01-07 21:02:14,persegiMerah,899,448,144,125,44,82,44,86,0,4,True,0.30438235584977813
2025-01-07 21:02:14,persegiMerah,900,441,142,126,175,77,177,72,2,5,True,0.49623537327589784
2025-01-07 21:02:14,Fail to pick,900,441,0,0,0,0,0,0,0,0,False,0
2025-01-07 21:02:15,persegiMerah,892,444,151,122,122,13,119,16,3,3,True,0.4559962979169624
2025-01-07 21:02:15,Fail to pick,892,444,0,0,0,0,0,0,0,0,False,0
2025-01-07 21:02:15,persegiMerah,900,437,144,124,161,9,161,13,0,4,True,0.43825856916823025
2025-01-07 21:02:15,Fail to pick,900,437,0,0,0,0,0,0,0,0,False,0
2025-01-07 21:02:15,persegiMerah,890,446,145,124,183,41,180,39,3,2,True,0.34842873191439916
2025-01-07 21:02:15,persegiMerah,848,411,140,129,9,82,10,80,1,2,True,0.2959530345919196
2025-01-07 21:02:15,persegiMerah,903,441,144,122,66,10,63,9,3,1,True,0.4859983625486133
2025-01-07 21:02:15,Merah,903,441,tensor(144.1028),tensor(122.5952),77,83,79,78,2,5,True,0.0
2025-01-07 21:02:15,persegiMerah,850,405,147,135,34,96,36,92,2,4,True,0.2738426281379486
2025-01-07 21:02:15,persegiMerah,901,438,146,123,129,95,130,91,1,4,True,0.4769201030214717
2025-01-07 21:02:16,persegiMerah,901,440,146,125,24,42,27,44,3,2,True,0.1255964649996075
2025-01-07 21:02:16,Fail to pick,901,440,0,0,0,0,0,0,0,0,False,0
2025-01-07 21:02:16,persegiMerah,888,443,145,124,189,1,188,0,1,1,True,0.2700759585672199
2025-01-07 21:02:16,persegiMerah,890,444,150,122,191,31,188,35,3,4,True,0.17617876439848576
2025-01-07 21:02:16,Fail to pick,890,444,0,0,0,0,0,0,0,0,False,0
2025-01-07 21:02:16,persegiMerah,898,440,147,123,173,20,175,24,2,4,True,0.45154001284803036
2025-01-07 21:02:16,Fail to pick,898,440,0,0,0,0,0,0,0,0,False,0
2025-01-07 21:02:16,persegiMerah,895,444,149,121,147,52,150,50,3,2,True,0.3666919926140907
2025-01-07 21:02:16,Fail to pick,895,444,0,0,0,0,0,0,0,0,False,0
2025-01-07 21:02:16,persegiMerah,892,450,146,123,119,38,123,41,4,3,True,0.23388271008762507
2025-01-07 21:02:16,Fail to pick,892,450,0,0,0,0,0,0,0,0,False,0
2025-01-07 21:02:16,persegiMerah,896,444,146,121,190,74,185,73,5,1,True,0.2658730533756238
2025-01-07 21:02:16,Fail to pick,896,444,0,0,0,0,0,0,0,0,False,0
2025-01-07 21:02:16,persegiMerah,902,440,142,123,15,4,15,5,0,1,True,0.15709176599018063
2025-01-07 21:02:16,Merah,902,440,tensor(142.7704),tensor(123.6941),77,83,79,81,2,2,True,0.0
2025-01-07 21:02:16,Fail to pick,902,440,0,0,0,0,0,0,0,0,False,0
2025-01-07 21:02:16,persegiMerah,899,445,141,122,160,91,162,89,2,2,True,0.4660707453251012
2025-01-07 21:02:16,Fail to pick,899,445,0,0,0,0,0,0,0,0,False,0
2025-01-07 21:02:17,persegiMerah,913,444,142,122,149,47,151,51,2,4,True,0.3048307812697528
2025-01-07 21:02:17,persegiMerah,911,442,142,124,138,85,137,83,1,2,True,0.4555388232162473
2025-01-07 21:02:17,Fail to pick,911,442,0,0,0,0,0,0,0,0,False,0
2025-01-07 21:02:17,persegiMerah,903,446,143,122,6,82,8,85,2,3,False,0.47578994649544104
2025-01-07 21:02:17,Fail to pick,903,446,0,0,0,0,0,0,0,0,False,0
2025-01-07 21:02:17,persegiMerah,900,442,146,126,75,53,73,49,2,4,True,0.2638722962928546
2025-01-07 21:02:17,Fail to pick,900,442,0,0,0,0,0,0,0,0,False,0
2025-01-07 21:02:17,persegiMerah,904,447,142,126,16,21,13,22,3,1,True,0.39235029422062295
2025-01-07 21:02:17,Fail to pick,904,447,0,0,0,0,0,0,0,0,False,0
2025-01-07 21:02:17,persegiMerah,900,451,148,126,148,85,150,87,2,2,True,0.3298656162646758
2025-01-07 21:02:17,Fail to pick,900,451,0,0,0,0,0,0,0,0,False,0
2025-01-07 21:02:17,persegiMerah,905,449,143,126,18,32,21,36,3,4,True,0.45332551018340383
2025-01-07 21:02:17,Fail to pick,905,449,0,0,0,0,0,0,0,0,False,0
2025-01-07 21:02:17,persegiMerah,911,445,146,125,11,18,9,21,2,3,True,0.1301468532723063
2025-01-07 21:02:17,Merah,911,445,tensor(146.4847),tensor(125.2847),76,84,74,84,2,0,True,0.0
2025-01-07 21:02:17,Fail to pick,911,445,0,0,0,0,0,0,0,0,False,0
2025-01-07 21:02:17,persegiMerah,903,449,148,127,2,19,3,22,1,3,True,0.4504887312326493
2025-01-07 21:02:17,Fail to pick,903,449,0,0,0,0,0,0,0,0,False,0
2025-01-07 21:02:18,persegiMerah,861,405,152,136,95,16,95,12,0,4,True,0.3699102953103036
2025-01-07 21:02:18,persegiMerah,911,445,143,125,64,19,66,20,2,1,True,0.13271588323863215
2025-01-07 21:02:18,persegiMerah,905,445,142,126,25,81,21,78,4,3,True,0.39988031691309134
2025-01-07 21:02:18,Fail to pick,905,445,0,0,0,0,0,0,0,0,False,0
2025-01-07 21:02:18,persegiMerah,902,450,142,126,118,62,118,62,0,0,True,0.11974348646884132
2025-01-07 21:02:18,Fail to pick,902,450,0,0,0,0,0,0,0,0,False,0
2025-01-07 21:02:18,persegiMerah,912,443,146,125,41,6,43,3,2,3,True,0.18778937730172776
2025-01-07 21:02:18,persegiMerah,905,446,148,126,106,23,105,24,1,1,True,0.47537615967578406
2025-01-07 21:02:18,Fail to pick,905,446,0,0,0,0,0,0,0,0,False,0
2025-01-07 21:02:18,persegiMerah,913,450,141,125,11,10,6,5,5,5,True,0.330832606299566
2025-01-07 21:02:18,Fail to pick,913,450,0,0,0,0,0,0,0,0,False,0
2025-01-07 21:02:18,persegiMerah,905,451,142,124,68,76,70,80,2,4,False,0.4466729152026899
2025-01-07 21:02:18,Fail to pick,905,451,0,0,0,0,0,0,0,0,False,0
2025-01-07 21:02:18,persegiMerah,910,447,141,125,51,30,54,30,3,0,True,0.3821617516931771
2025-01-07 21:02:18,Merah,910,447,tensor(141.6127),tensor(125.0814),75,84,70,82,5,2,True,0.0
2025-01-07 21:02:18,Fail to pick,910,447,0,0,0,0,0,0,0,0,False,0
2025-01-07 21:02:19,persegiMerah,900,455,141,127,191,9,186,5,5,4,True,0.13513110131432746
2025-01-07 21:02:19,persegiMerah,877,402,148,138,1,12,2,13,1,1,True,0.4026171835301945
2025-01-07 21:02:19,persegiMerah,909,446,142,125,164,44,164,45,0,1,True,0.3194965987087997
2025-01-07 21:02:19,persegiMerah,914,449,140,126,54,74,56,72,2,2,True,0.4921401976601546
2025-01-07 21:02:19,Fail to pick,914,449,0,0,0,0,0,0,0,0,False,0
2025-01-07 21:02:19,persegiMerah,919,447,143,123,131,39,129,41,2,2,True,0.3983552244080013
2025-01-07 21:02:19,Fail to pick,919,447,0,0,0,0,0,0,0,0,False,0
2025-01-07 21:02:19,persegiMerah,914,445,145,124,23,94,26,92,3,2,True,0.15750838920346238
2025-01-07 21:02:19,Fail to pick,914,445,0,0,0,0,0,0,0,0,False,0
2025-01-07 21:02:19,persegiMerah,906,447,142,125,161,3,161,2,0,1,True,0.30242500078970935
2025-01-07 21:02:19,Fail to pick,906,447,0,0,0,0,0,0,0,0,False,0
2025-01-07 21:02:19,persegiMerah,906,446,144,125,133,23,135,19,2,4,True,0.23751781994403479
2025-01-07 21:02:19,Fail to pick,906,446,0,0,0,0,0,0,0,0,False,0
2025-01-07 21:02:21,persegiMerah,914,444,144,123,41,5,37,7,4,2,True,0.13747847777889147
2025-01-07 21:02:21,Merah,914,444,tensor(144.0427),tensor(123.1852),76,84,78,87,2,3,True,0.0
2025-01-07 21:02:21,Fail to pick,914,444,0,0,0,0,0,0,0,0,False,0
2025-01-07 21:02:21,persegiMerah,911,446,143,127,27,60,24,63,3,3,False,0.22891136797076525
2025-01-07 21:02:21,Fail to pick,911,446,0,0,0,0,0,0,0,0,False,0
2025-01-07 21:02:21,persegiMerah,907,446,144,126,134,80,136,78,2,2,True,0.10929528803031596
2025-01-07 21:02:21,Fail to pick,907,446,0,0,0,0,0,0,0,0,False,0
2025-01-07 21:02:21,persegiMerah,904,443,141,127,62,24,62,19,0,5,True,0.33329279359353703
2025-01-07 21:02:21,Fail to pick,904,443,0,0,0,0,0,0,0,0,False,0
2025-01-07 21:02:21,persegiMerah,909,447,142,127,4,69,3,64,1,5,False,0.3751435278954275
2025-01-07 21:02:21,Fail to pick,909,447,0,0,0,0,0,0,0,0,False,0
2025-01-07 21:02:21,persegiMerah,907,439,142,128,181,61,184,62,3,1,True,0.1509993831845237
2025-01-07 21:02:21,Fail to pick,907,439,0,0,0,0,0,0,0,0,False,0
2025-01-07 21:02:21,persegiMerah,900,439,143,127,121,30,118,33,3,3,True,0.13100376019965077
2025-01-07 21:02:21,Fail to pick,900,439,0,0,0,0,0,0,0,0,False,0
2025-01-07 21:02:21,persegiMerah,899,441,149,129,52,73,52,69,0,4,True,0.20234310668948716
2025-01-07 21:02:21,Fail to pick,899,441,0,0,0,0,0,0,0,0,False,0
2025-01-07 21:02:22,persegiMerah,906,447,145,125,23,93,24,88,1,5,True,0.24602443071396662
2025-01-07 21:02:22,Fail to pick,906,447,0,0,0,0,0,0,0,0,False,0
2025-01-07 21:02:22,persegiMerah,893,478,142,129,174,62,169,66,5,4,True,0.4967721149234351
2025-01-07 21:02:22,persegiMerah,922,496,145,130,115,54,112,58,3,4,True,0.2683854271259727
2025-01-07 21:02:22,Merah,922,496,tensor(145.5238),tensor(130.2796),62,85,66,81,4,4,True,0.0005002021789550781
2025-01-07 21:02:26,persegiMerah,900,433,157,139,192,59,188,61,4,2,True,0.1402398487330855
2025-01-07 21:02:26,Merah,900,433,tensor(157.1833),tensor(139.6849),79,83,81,84,2,1,True,0.0
2025-01-07 21:02:26,persegiMerah,908,425,156,135,49,71,49,69,0,2,True,0.40780384823687965
2025-01-07 21:02:26,Fail to pick,908,425,0,0,0,0,0,0,0,0,False,0
2025-01-07 21:02:26,persegiMerah,899,425,153,137,133,52,132,49,1,3,True,0.24258831005490322
2025-01-07 21:02:26,Fail to pick,899,425,0,0,0,0,0,0,0,0,False,0
2025-01-07 21:02:26,persegiMerah,901,429,150,134,107,37,108,40,1,3,True,0.10716615903181625
2025-01-07 21:02:26,Fail to pick,901,429,0,0,0,0,0,0,0,0,False,0
2025-01-07 21:02:26,persegiMerah,900,437,148,132,7,55,9,56,2,1,True,0.13836486363647316
2025-01-07 21:02:26,Fail to pick,900,437,0,0,0,0,0,0,0,0,False,0
2025-01-07 21:02:26,persegiMerah,899,435,146,134,62,80,59,77,3,3,True,0.4474932025096152
2025-01-07 21:02:26,Fail to pick,899,435,0,0,0,0,0,0,0,0,False,0
2025-01-07 21:02:26,persegiMerah,889,437,150,139,133,15,131,11,2,4,True,0.48675382907767384
2025-01-07 21:02:26,persegiMerah,866,471,149,135,168,75,170,78,2,3,True,0.24088739036324164
2025-01-07 21:02:26,persegiMerah,870,467,152,135,4,25,-1,28,5,3,True,0.14898575245089787
2025-01-07 21:02:26,Fail to pick,870,467,0,0,0,0,0,0,0,0,False,0
2025-01-07 21:02:27,persegiMerah,864,471,153,138,131,2,129,-1,2,3,True,0.18418718988206792
2025-01-07 21:02:27,Merah,864,471,tensor(153.6218),tensor(138.1177),69,80,71,77,2,3,True,0.0
2025-01-07 21:02:27,Fail to pick,864,471,0,0,0,0,0,0,0,0,False,0
2025-01-07 21:02:27,persegiMerah,865,466,150,135,190,50,192,50,2,0,True,0.24951791633566014
2025-01-07 21:02:27,Fail to pick,865,466,0,0,0,0,0,0,0,0,False,0
2025-01-07 21:02:27,persegiMerah,867,409,151,143,158,3,159,3,1,0,True,0.4288200193007168
2025-01-07 21:02:27,persegiMerah,866,471,148,135,161,96,162,99,1,3,True,0.3902949541686358
2025-01-07 21:02:27,persegiMerah,869,463,158,137,24,12,22,16,2,4,True,0.13962370654253375
2025-01-07 21:02:27,Fail to pick,869,463,0,0,0,0,0,0,0,0,False,0
2025-01-07 21:02:27,persegiMerah,870,465,157,138,84,26,81,22,3,4,True,0.31170239654179255
2025-01-07 21:02:27,Fail to pick,870,465,0,0,0,0,0,0,0,0,False,0
2025-01-07 21:02:27,persegiMerah,869,465,156,138,154,39,151,43,3,4,True,0.2920298436934988
2025-01-07 21:02:27,Fail to pick,869,465,0,0,0,0,0,0,0,0,False,0
2025-01-07 21:02:27,persegiMerah,870,464,155,140,134,91,129,86,5,5,True,0.3793639077903441
2025-01-07 21:02:27,Fail to pick,870,464,0,0,0,0,0,0,0,0,False,0
2025-01-07 21:02:27,persegiMerah,874,462,152,140,22,61,18,65,4,4,True,0.3295256461668379
2025-01-07 21:02:27,Fail to pick,874,462,0,0,0,0,0,0,0,0,False,0
2025-01-07 21:02:28,persegiMerah,868,465,157,134,106,12,102,8,4,4,True,0.4990806131111687
2025-01-07 21:02:28,Fail to pick,868,465,0,0,0,0,0,0,0,0,False,0
2025-01-07 21:02:28,persegiMerah,870,470,157,136,70,8,69,6,1,2,True,0.3949741710094026
2025-01-07 21:02:28,Merah,870,470,tensor(157.4409),tensor(136.2906),69,80,72,84,3,4,True,0.0005090236663818359
2025-01-07 21:02:28,Fail to pick,870,470,0,0,0,0,0,0,0,0,False,0
2025-01-07 21:02:28,persegiMerah,868,470,157,137,1,19,5,18,4,1,True,0.18121545879571085
2025-01-07 21:02:28,Fail to pick,868,470,0,0,0,0,0,0,0,0,False,0
2025-01-07 21:02:28,persegiMerah,870,457,155,139,131,85,131,80,0,5,True,0.16463141585896607
2025-01-07 21:02:28,persegiMerah,870,459,157,142,119,39,123,34,4,5,True,0.31941176644108116
2025-01-07 21:02:28,Fail to pick,870,459,0,0,0,0,0,0,0,0,False,0
2025-01-07 21:02:28,persegiMerah,869,463,155,138,85,1,83,4,2,3,True,0.43184130517611174
2025-01-07 21:02:28,Fail to pick,869,463,0,0,0,0,0,0,0,0,False,0
2025-01-07 21:02:28,persegiMerah,865,468,156,139,104,63,106,61,2,2,True,0.351568792878058
2025-01-07 21:02:28,Fail to pick,865,468,0,0,0,0,0,0,0,0,False,0
2025-01-07 21:02:28,persegiMerah,869,467,151,137,119,18,118,20,1,2,True,0.20573297343527042
2025-01-07 21:02:28,Fail to pick,869,467,0,0,0,0,0,0,0,0,False,0
2025-01-07 21:02:28,persegiMerah,861,467,149,139,196,57,195,56,1,1,True,0.1444966081830463
2025-01-07 21:02:28,Fail to pick,861,467,0,0,0,0,0,0,0,0,False,0
2025-01-07 21:02:29,persegiMerah,866,462,151,141,26,53,28,48,2,5,True,0.11025635332200144
2025-01-07 21:02:29,Fail to pick,866,462,0,0,0,0,0,0,0,0,False,0
2025-01-07 21:02:29,persegiMerah,869,463,152,141,86,96,82,93,4,3,True,0.24864847938388365
2025-01-07 21:02:29,Merah,869,463,tensor(152.4376),tensor(141.7456),71,80,71,77,0,3,True,0.0
2025-01-07 21:02:29,Fail to pick,869,463,0,0,0,0,0,0,0,0,False,0
2025-01-07 21:02:29,persegiMerah,865,466,155,139,33,93,31,96,2,3,True,0.1515955118332698
2025-01-07 21:02:29,Fail to pick,865,466,0,0,0,0,0,0,0,0,False,0
2025-01-07 21:02:29,persegiMerah,864,464,155,139,45,28,41,29,4,1,True,0.2755710002939725
2025-01-07 21:02:29,Fail to pick,864,464,0,0,0,0,0,0,0,0,False,0
2025-01-07 21:02:29,persegiMerah,868,467,151,140,110,65,105,60,5,5,True,0.14342599635128916
2025-01-07 21:02:29,Fail to pick,868,467,0,0,0,0,0,0,0,0,False,0
2025-01-07 21:02:29,persegiMerah,871,463,155,141,161,4,164,7,3,3,True,0.11106508541026933
2025-01-07 21:02:29,Fail to pick,871,463,0,0,0,0,0,0,0,0,False,0
2025-01-07 21:02:29,persegiMerah,868,459,153,137,53,2,51,3,2,1,False,0.14245076423602876
2025-01-07 21:02:29,Fail to pick,868,459,0,0,0,0,0,0,0,0,False,0
2025-01-07 21:02:29,persegiMerah,863,469,154,139,166,11,161,12,5,1,True,0.4706506716361112
2025-01-07 21:02:29,persegiMerah,865,464,150,140,22,53,25,50,3,3,True,0.2857643976876173
2025-01-07 21:02:29,Fail to pick,865,464,0,0,0,0,0,0,0,0,False,0
2025-01-07 21:02:30,persegiMerah,866,465,155,135,15,11,12,8,3,3,True,0.34081939326048494
2025-01-07 21:02:30,Fail to pick,866,465,0,0,0,0,0,0,0,0,False,0
2025-01-07 21:02:30,persegiMerah,862,475,154,136,194,35,190,34,4,1,False,0.11798127472117792
2025-01-07 21:02:30,persegiMerah,876,461,148,140,54,37,52,36,2,1,True,0.36193996147674856
2025-01-07 21:02:30,persegiMerah,884,470,150,134,44,69,39,67,5,2,True,0.4402481094166527
2025-01-07 21:02:30,Merah,884,470,tensor(150.3857),tensor(134.9966),69,81,64,77,5,4,True,0.0
2025-01-07 21:02:30,Fail to pick,884,470,0,0,0,0,0,0,0,0,False,0
2025-01-07 21:02:30,persegiMerah,874,477,151,134,148,23,150,27,2,4,True,0.15743130225382124
2025-01-07 21:02:30,persegiMerah,886,479,151,139,192,6,194,2,2,4,True,0.11636174164562743
2025-01-07 21:02:30,persegiMerah,929,466,151,133,161,94,157,92,4,2,True,0.1296473377853619
2025-01-07 21:02:30,persegiMerah,872,487,155,138,55,72,52,68,3,4,True,0.23554277267733048
2025-01-07 21:02:30,persegiMerah,877,486,147,137,13,33,16,36,3,3,True,0.3668969606460085
2025-01-07 21:02:30,Fail to pick,877,486,0,0,0,0,0,0,0,0,False,0
2025-01-07 21:02:31,persegiMerah,878,480,148,138,124,14,124,12,0,2,True,0.26723109013971136
2025-01-07 21:02:31,Fail to pick,878,480,0,0,0,0,0,0,0,0,False,0
2025-01-07 21:02:31,persegiMerah,886,463,148,140,39,34,40,35,1,1,True,0.2046673531584698
2025-01-07 21:02:31,persegiMerah,902,451,147,140,91,20,89,16,2,4,True,0.22173104689595477
2025-01-07 21:02:31,persegiMerah,873,460,152,141,43,62,47,61,4,1,True,0.19024615919368013
2025-01-07 21:02:31,Merah,873,460,tensor(152.4398),tensor(141.6089),72,80,68,82,4,2,True,0.0
2025-01-07 21:02:31,persegiMerah,869,462,150,140,176,80,174,75,2,5,True,0.3997339750111042
2025-01-07 21:02:31,Fail to pick,869,462,0,0,0,0,0,0,0,0,False,0
2025-01-07 21:02:31,persegiMerah,861,479,151,136,141,27,136,30,5,3,True,0.19716523726145865
2025-01-07 21:02:31,persegiMerah,877,458,151,138,121,99,119,98,2,1,True,0.14595841326407855
2025-01-07 21:02:31,persegiMerah,869,465,156,141,143,3,140,0,3,3,True,0.3711044194902615
2025-01-07 21:02:31,Fail to pick,869,465,0,0,0,0,0,0,0,0,False,0
2025-01-07 21:02:32,persegiMerah,867,468,151,138,150,24,148,21,2,3,True,0.16560818288181284
2025-01-07 21:02:32,Fail to pick,867,468,0,0,0,0,0,0,0,0,False,0
2025-01-07 21:02:32,persegiMerah,862,466,163,143,178,61,176,58,2,3,True,0.40914012002060596
2025-01-07 21:02:32,Fail to pick,862,466,0,0,0,0,0,0,0,0,False,0
2025-01-07 21:02:32,persegiMerah,866,459,155,144,173,32,170,29,3,3,True,0.2762570233668693
2025-01-07 21:02:32,Fail to pick,866,459,0,0,0,0,0,0,0,0,False,0
2025-01-07 21:02:32,persegiMerah,856,475,155,140,152,71,150,72,2,1,True,0.47492953905228064
2025-01-07 21:02:32,persegiMerah,864,462,156,140,124,61,127,58,3,3,True,0.47192971739845
2025-01-07 21:02:32,Merah,864,462,tensor(156.8571),tensor(140.5647),71,80,72,78,1,2,True,0.0
2025-01-07 21:02:32,persegiMerah,865,461,155,140,37,69,40,68,3,1,False,0.1264675133157904
2025-01-07 21:02:32,Fail to pick,865,461,0,0,0,0,0,0,0,0,False,0
2025-01-07 21:02:32,persegiMerah,858,472,152,138,33,19,30,16,3,3,True,0.4544345970756566
2025-01-07 21:02:32,persegiMerah,879,452,150,139,1,32,0,35,1,3,True,0.15817967138482447
2025-01-07 21:02:32,persegiMerah,877,454,158,141,19,55,18,54,1,1,True,0.10712947431225711
2025-01-07 21:02:32,Fail to pick,877,454,0,0,0,0,0,0,0,0,False,0
2025-01-07 21:02:32,persegiMerah,865,468,154,142,68,54,65,56,3,2,True,0.20580809828090021
2025-01-07 21:02:33,persegiMerah,870,466,158,146,168,18,169,19,1,1,True,0.4314175641524627
2025-01-07 21:02:33,Fail to pick,870,466,0,0,0,0,0,0,0,0,False,0
2025-01-07 21:02:33,persegiMerah,868,463,158,141,44,47,47,51,3,4,True,0.34092256070484994
2025-01-07 21:02:33,Fail to pick,868,463,0,0,0,0,0,0,0,0,False,0
2025-01-07 21:02:33,persegiMerah,869,467,155,141,79,59,81,57,2,2,True,0.2685556003748334
2025-01-07 21:02:33,Fail to pick,869,467,0,0,0,0,0,0,0,0,False,0
2025-01-07 21:02:33,persegiMerah,864,462,157,143,142,84,141,80,1,4,True,0.12298910852890468
2025-01-07 21:02:33,Fail to pick,864,462,0,0,0,0,0,0,0,0,False,0
2025-01-07 21:02:33,persegiMerah,868,465,154,142,135,63,132,62,3,1,True,0.39789672855852054
2025-01-07 21:02:33,Merah,868,465,tensor(154.6003),tensor(142.5710),70,80,66,78,4,2,True,0.0004990100860595703
2025-01-07 21:02:33,Fail to pick,868,465,0,0,0,0,0,0,0,0,False,0
2025-01-07 21:02:33,persegiMerah,872,462,161,145,93,87,88,91,5,4,True,0.24629443803681794
2025-01-07 21:02:33,Fail to pick,872,462,0,0,0,0,0,0,0,0,False,0
2025-01-07 21:02:33,persegiMerah,866,463,155,143,24,47,19,43,5,4,True,0.2963060246289211
2025-01-07 21:02:33,Fail to pick,866,463,0,0,0,0,0,0,0,0,False,0
2025-01-07 21:02:33,persegiMerah,875,455,155,140,191,65,189,62,2,3,True,0.30359611177935575
2025-01-07 21:02:33,Fail to pick,875,455,0,0,0,0,0,0,0,0,False,0
2025-01-07 21:02:33,persegiMerah,852,475,154,140,60,15,56,12,4,3,True,0.3632904305732112
2025-01-07 21:02:34,persegiMerah,865,468,154,139,22,60,21,64,1,4,True,0.3801218845387456
2025-01-07 21:02:34,persegiMerah,870,462,155,139,189,66,186,63,3,3,True,0.4729793274635714
2025-01-07 21:02:34,Fail to pick,870,462,0,0,0,0,0,0,0,0,False,0
2025-01-07 21:02:34,persegiMerah,862,463,152,144,117,58,114,56,3,2,True,0.4925999138749013
2025-01-07 21:02:34,Fail to pick,862,463,0,0,0,0,0,0,0,0,False,0
2025-01-07 21:02:34,persegiMerah,874,461,149,140,11,66,13,67,2,1,True,0.479515247508822
2025-01-07 21:02:34,persegiMerah,870,462,156,145,59,44,63,43,4,1,False,0.24951431206102873
2025-01-07 21:02:34,Fail to pick,870,462,0,0,0,0,0,0,0,0,False,0
2025-01-07 21:02:34,persegiMerah,864,467,153,140,125,38,120,37,5,1,True,0.2495128561736371
2025-01-07 21:02:34,Merah,864,467,tensor(153.0869),tensor(140.7421),70,80,72,83,2,3,True,0.0
2025-01-07 21:02:34,Fail to pick,864,467,0,0,0,0,0,0,0,0,False,0
2025-01-07 21:02:34,persegiMerah,861,473,150,138,11,92,11,90,0,2,True,0.12904502484045086
2025-01-07 21:02:34,Fail to pick,861,473,0,0,0,0,0,0,0,0,False,0
2025-01-07 21:02:34,persegiMerah,875,459,148,139,194,38,189,36,5,2,True,0.46420125144863866
2025-01-07 21:02:34,persegiMerah,864,474,157,137,181,78,179,80,2,2,True,0.14344275909050488
2025-01-07 21:02:35,persegiMerah,864,473,151,138,27,3,30,2,3,1,True,0.4115207935788965
2025-01-07 21:02:35,Fail to pick,864,473,0,0,0,0,0,0,0,0,False,0
2025-01-07 21:02:35,persegiMerah,868,467,156,137,19,58,19,53,0,5,True,0.46831199721484196
2025-01-07 21:02:35,Fail to pick,868,467,0,0,0,0,0,0,0,0,False,0
2025-01-07 21:02:35,persegiMerah,856,483,162,136,95,54,99,50,4,4,True,0.11900956024996426
2025-01-07 21:02:35,persegiMerah,870,464,156,141,32,96,30,96,2,0,True,0.1363257769893351
2025-01-07 21:02:35,persegiMerah,856,474,159,138,166,8,168,3,2,5,True,0.4251123289249128
2025-01-07 21:02:35,persegiMerah,855,473,158,138,139,10,140,8,1,2,True,0.15916800283022103
2025-01-07 21:02:35,Fail to pick,855,473,0,0,0,0,0,0,0,0,False,0
2025-01-07 21:02:35,persegiMerah,857,480,155,142,13,68,17,64,4,4,True,0.3702006080529435
2025-01-07 21:02:35,Merah,857,480,tensor(155.1705),tensor(142.0181),66,79,61,76,5,3,True,0.0
2025-01-07 21:02:35,Fail to pick,857,480,0,0,0,0,0,0,0,0,False,0
2025-01-07 21:02:35,persegiMerah,857,480,156,139,93,33,93,34,0,1,True,0.3914060743952391
2025-01-07 21:02:35,Fail to pick,857,480,0,0,0,0,0,0,0,0,False,0
2025-01-07 21:02:35,persegiMerah,858,480,155,135,60,61,61,57,1,4,True,0.2404537379511083
2025-01-07 21:02:35,Fail to pick,858,480,0,0,0,0,0,0,0,0,False,0
2025-01-07 21:02:36,persegiMerah,869,459,159,140,37,87,32,84,5,3,True,0.388215106983237
2025-01-07 21:02:36,persegiMerah,866,469,156,138,92,72,92,76,0,4,True,0.2595773350849139
2025-01-07 21:02:36,persegiMerah,870,466,157,139,45,35,48,35,3,0,True,0.34062654734823844
2025-01-07 21:02:36,Fail to pick,870,466,0,0,0,0,0,0,0,0,False,0
2025-01-07 21:02:36,persegiMerah,862,476,158,145,41,50,44,51,3,1,True,0.22154736870709735
2025-01-07 21:02:47,persegiMerah,192,224,152,144,83,9,84,10,1,1,True,0.2556276398658698
2025-01-07 21:02:47,segienamKuning,296,66,98,73,34,75,30,76,4,1,True,0.2970004102668473
2025-01-07 21:02:47,Kuning,296,66,tensor(98.9275),tensor(73.8914),181,27,179,24,2,3,True,0.0
2025-01-07 21:02:47,persegiMerah,222,197,159,145,153,42,157,43,4,1,True,0.20487482868365992
2025-01-07 21:02:47,persegiMerah,212,208,161,142,115,53,117,55,2,2,True,0.22739518225675132
2025-01-07 21:02:47,persegiMerah,206,218,156,147,114,10,112,8,2,2,True,0.48067736884001466
2025-01-07 21:02:48,persegiMerah,208,225,159,145,1,75,-1,70,2,5,True,0.12572028412185052
2025-01-07 21:02:48,Fail to pick,208,225,0,0,0,0,0,0,0,0,False,0
2025-01-07 21:02:51,persegiMerah,189,227,164,138,47,71,43,73,4,2,True,0.38285841234034457
2025-01-07 21:02:52,persegiMerah,183,231,167,140,57,11,59,6,2,5,True,0.24793523806939552
2025-01-07 21:02:52,Fail to pick,183,231,0,0,0,0,0,0,0,0,False,0
2025-01-07 21:02:52,persegiMerah,186,225,162,138,153,64,151,63,2,1,False,0.2915710317847018
2025-01-07 21:02:52,Fail to pick,186,225,0,0,0,0,0,0,0,0,False,0
2025-01-07 21:02:52,persegiMerah,130,253,168,141,59,66,63,65,4,1,True,0.18975164439186631
2025-01-07 21:02:52,Merah,130,253,tensor(168.3505),tensor(141.7135),129,12,131,8,2,4,True,0.0
2025-01-07 21:02:52,persegiMerah,200,213,160,140,129,78,124,78,5,0,True,0.11865957090432327
2025-01-07 21:02:52,persegiMerah,182,232,158,139,105,0,105,1,0,1,False,0.12378924420453292
2025-01-07 21:02:52,persegiMerah,177,234,161,140,57,68,59,72,2,4,True,0.4983810012717206
2025-01-07 21:02:52,Fail to pick,177,234,0,0,0,0,0,0,0,0,False,0
2025-01-07 21:02:52,persegiMerah,188,224,156,143,19,98,22,102,3,4,True,0.36167130629442035
2025-01-07 21:02:52,persegiMerah,172,235,150,140,68,28,71,29,3,1,True,0.2932267310593307
2025-01-07 21:02:53,persegiMerah,173,237,154,138,18,78,21,74,3,4,True,0.1022396584691049
2025-01-07 21:02:53,Fail to pick,173,237,0,0,0,0,0,0,0,0,False,0
2025-01-07 21:02:53,persegiMerah,177,235,154,138,33,62,29,64,4,2,True,0.38959310459885677
2025-01-07 21:02:53,Fail to pick,177,235,0,0,0,0,0,0,0,0,False,0
2025-01-07 21:02:53,persegiMerah,180,236,156,138,91,3,93,5,2,2,True,0.11112267754720695
2025-01-07 21:02:53,Fail to pick,180,236,0,0,0,0,0,0,0,0,False,0
2025-01-07 21:02:53,persegiMerah,169,241,151,141,62,72,65,71,3,1,True,0.26023570786031885
2025-01-07 21:02:53,persegiMerah,177,242,155,138,195,8,193,12,2,4,True,0.21927379618565285
2025-01-07 21:02:53,Fail to pick,177,242,0,0,0,0,0,0,0,0,False,0
2025-01-07 21:02:53,persegiMerah,177,238,154,140,115,14,114,10,1,4,True,0.13739925441423578
2025-01-07 21:02:53,Fail to pick,177,238,0,0,0,0,0,0,0,0,False,0
2025-01-07 21:02:53,persegiMerah,174,240,152,139,82,52,84,55,2,3,False,0.10773284559909468
2025-01-07 21:02:53,Fail to pick,174,240,0,0,0,0,0,0,0,0,False,0
2025-01-07 21:02:53,persegiMerah,183,236,158,143,96,94,96,92,0,2,True,0.2739607190071385
2025-01-07 21:02:53,Fail to pick,183,236,0,0,0,0,0,0,0,0,False,0
2025-01-07 21:02:53,persegiMerah,180,237,156,139,19,80,14,82,5,2,True,0.3742886173883525
2025-01-07 21:02:53,Fail to pick,180,237,0,0,0,0,0,0,0,0,False,0
2025-01-07 21:02:54,persegiMerah,190,238,157,139,100,17,95,13,5,4,True,0.22436198386658926
2025-01-07 21:02:54,persegiMerah,178,239,165,136,80,16,79,19,1,3,False,0.3375231720360979
2025-01-07 21:02:54,persegiMerah,177,238,155,139,122,80,118,78,4,2,True,0.1250334671944817
2025-01-07 21:02:54,Fail to pick,177,238,0,0,0,0,0,0,0,0,False,0
2025-01-07 21:02:54,persegiMerah,173,239,153,139,191,75,188,74,3,1,True,0.16804282931400022
2025-01-07 21:02:54,Fail to pick,173,239,0,0,0,0,0,0,0,0,False,0
2025-01-07 21:02:54,persegiMerah,176,236,156,141,13,15,17,15,4,0,False,0.454935815268244
2025-01-07 21:02:54,Fail to pick,176,236,0,0,0,0,0,0,0,0,False,0
2025-01-07 21:02:54,persegiMerah,179,231,157,140,142,38,141,40,1,2,True,0.39021594261781156
2025-01-07 21:02:54,Fail to pick,179,231,0,0,0,0,0,0,0,0,False,0
2025-01-07 21:02:54,persegiMerah,182,234,155,138,182,80,183,77,1,3,True,0.26614598243460186
2025-01-07 21:02:54,Fail to pick,182,234,0,0,0,0,0,0,0,0,False,0
2025-01-07 21:02:54,persegiMerah,179,236,152,138,151,76,151,75,0,1,True,0.16547504153279893
2025-01-07 21:02:54,Fail to pick,179,236,0,0,0,0,0,0,0,0,False,0
2025-01-07 21:02:54,persegiMerah,197,214,153,144,1,46,5,47,4,1,True,0.29989691366136795
2025-01-07 21:02:55,persegiMerah,176,239,154,136,119,75,117,73,2,2,True,0.35909032672825536
2025-01-07 21:02:55,persegiMerah,172,235,152,137,135,23,139,27,4,4,True,0.23499468085865483
2025-01-07 21:02:55,Fail to pick,172,235,0,0,0,0,0,0,0,0,False,0
2025-01-07 21:02:55,persegiMerah,181,238,160,138,124,21,128,19,4,2,True,0.4077379263902752
2025-01-07 21:02:55,Fail to pick,181,238,0,0,0,0,0,0,0,0,False,0
2025-01-07 21:02:55,persegiMerah,173,235,153,138,106,57,101,59,5,2,False,0.15983543120524094
2025-01-07 21:02:55,Fail to pick,173,235,0,0,0,0,0,0,0,0,False,0
2025-01-07 21:02:55,persegiMerah,173,235,158,140,53,87,54,84,1,3,True,0.1503300595236492
2025-01-07 21:02:55,Fail to pick,173,235,0,0,0,0,0,0,0,0,False,0
2025-01-07 21:02:55,persegiMerah,169,236,155,139,10,16,10,14,0,2,False,0.3372049782403752
2025-01-07 21:02:55,Fail to pick,169,236,0,0,0,0,0,0,0,0,False,0
2025-01-07 21:02:55,persegiMerah,174,234,155,142,26,91,24,92,2,1,True,0.17249552867290655
2025-01-07 21:02:55,Fail to pick,174,234,0,0,0,0,0,0,0,0,False,0
2025-01-07 21:02:55,persegiMerah,173,235,158,139,102,94,104,98,2,4,True,0.3816772612666238
2025-01-07 21:02:55,Fail to pick,173,235,0,0,0,0,0,0,0,0,False,0
2025-01-07 21:02:55,persegiMerah,178,233,160,141,86,20,89,18,3,2,True,0.4882581454947674
2025-01-07 21:02:55,Fail to pick,178,233,0,0,0,0,0,0,0,0,False,0
2025-01-07 21:02:55,persegiMerah,173,238,157,141,107,98,108,93,1,5,True,0.3412469411038169
2025-01-07 21:02:55,Fail to pick,173,238,0,0,0,0,0,0,0,0,False,0
2025-01-07 21:02:56,persegiMerah,165,236,159,136,164,90,160,89,4,1,True,0.1726598240614463
2025-01-07 21:02:56,Fail to pick,165,236,0,0,0,0,0,0,0,0,False,0
2025-01-07 21:02:56,persegiMerah,192,221,156,139,29,4,32,6,3,2,True,0.21498558233105466
2025-01-07 21:02:56,persegiMerah,180,233,159,139,73,95,77,92,4,3,True,0.2589354012965228
2025-01-07 21:02:56,persegiMerah,187,230,156,137,71,51,70,47,1,4,True,0.36067327514532
2025-01-07 21:02:56,Fail to pick,187,230,0,0,0,0,0,0,0,0,False,0
2025-01-07 21:02:56,persegiMerah,168,238,164,135,166,22,166,25,0,3,True,0.4022783031786299
2025-01-07 21:02:56,persegiMerah,190,226,153,136,153,94,149,93,4,1,True,0.4509290595191219
2025-01-07 21:02:56,persegiMerah,185,231,154,138,98,99,98,102,0,3,True,0.4366993825197668
2025-01-07 21:02:56,Fail to pick,185,231,0,0,0,0,0,0,0,0,False,0
2025-01-07 21:02:56,persegiMerah,193,222,152,136,22,48,19,47,3,1,True,0.2864821424415679
2025-01-07 21:02:56,Fail to pick,193,222,0,0,0,0,0,0,0,0,False,0
2025-01-07 21:02:56,persegiMerah,192,226,154,136,152,60,155,55,3,5,True,0.16945198417893187
2025-01-07 21:02:56,Fail to pick,192,226,0,0,0,0,0,0,0,0,False,0
2025-01-07 21:02:57,persegiMerah,183,236,152,137,128,31,126,29,2,2,True,0.19149720737990356
2025-01-07 21:02:57,persegiMerah,179,237,157,137,123,43,120,39,3,4,True,0.49916623851941466
2025-01-07 21:02:57,Fail to pick,179,237,0,0,0,0,0,0,0,0,False,0
2025-01-07 21:02:57,persegiMerah,175,238,148,138,16,46,11,42,5,4,True,0.4179915704787893
2025-01-07 21:02:57,Fail to pick,175,238,0,0,0,0,0,0,0,0,False,0
2025-01-07 21:02:57,persegiMerah,193,218,152,140,95,55,99,59,4,4,True,0.10674935054675366
2025-01-07 21:02:57,persegiMerah,175,237,153,136,173,69,174,72,1,3,True,0.20593455222337026
2025-01-07 21:02:57,persegiMerah,197,216,155,140,101,49,98,53,3,4,True,0.30770232046602675
2025-01-07 21:02:57,persegiMerah,180,234,156,137,102,11,106,14,4,3,True,0.16035073402662736
2025-01-07 21:02:57,persegiMerah,186,229,155,139,107,27,111,22,4,5,True,0.37355974837466766
2025-01-07 21:02:57,Fail to pick,186,229,0,0,0,0,0,0,0,0,False,0
2025-01-07 21:02:57,persegiMerah,169,241,150,138,27,64,29,59,2,5,True,0.11829065104954047
2025-01-07 21:05:42,persegiMerah,785,386,142,134,109,57,106,59,3,2,True,0.21033067948817163
2025-01-07 21:05:45,persegiMerah,779,380,141,134,168,36,170,40,2,4,True,0.10157938426138871
2025-01-07 21:05:45,Fail to pick,779,380,0,0,0,0,0,0,0,0,False,0
2025-01-07 21:05:45,persegiMerah,772,386,143,136,105,65,107,64,2,1,False,0.41468847943841036
2025-01-07 21:05:45,Merah,772,386,tensor(143.5747),tensor(136.2674),92,71,96,75,4,4,True,0.0
2025-01-07 21:05:45,Fail to pick,772,386,0,0,0,0,0,0,0,0,False,0
2025-01-07 21:05:46,persegiMerah,783,386,134,134,65,56,65,52,0,4,True,0.10818532896931776
2025-01-07 21:05:46,persegiMerah,773,385,136,134,67,65,65,68,2,3,True,0.491406043332269
2025-01-07 21:05:46,persegiMerah,775,382,136,133,149,42,147,43,2,1,True,0.3535346559510957
2025-01-07 21:05:46,Merah,775,382,tensor(136.7888),tensor(133.9509),93,71,92,68,1,3,True,0.0
2025-01-07 21:05:46,Fail to pick,775,382,0,0,0,0,0,0,0,0,False,0
2025-01-07 21:05:46,persegiMerah,778,384,136,131,183,32,186,32,3,0,True,0.4205518307094174
2025-01-07 21:05:46,Fail to pick,778,384,0,0,0,0,0,0,0,0,False,0
2025-01-07 21:05:47,persegiMerah,773,379,136,136,188,45,190,49,2,4,True,0.30905960906124075
2025-01-07 21:05:47,Fail to pick,773,379,0,0,0,0,0,0,0,0,False,0
2025-01-07 21:05:47,persegiMerah,779,381,136,131,157,67,152,69,5,2,True,0.11154303149925462
2025-01-07 21:05:47,Fail to pick,779,381,0,0,0,0,0,0,0,0,False,0
2025-01-07 21:05:47,persegiMerah,779,385,140,131,44,70,43,71,1,1,True,0.29331904404513176
2025-01-07 21:05:47,Merah,779,385,tensor(140.2001),tensor(131.1005),93,72,96,67,3,5,True,0.0
2025-01-07 21:05:47,Fail to pick,779,385,0,0,0,0,0,0,0,0,False,0
2025-01-07 21:05:48,persegiMerah,766,396,137,143,23,12,23,16,0,4,True,0.228842212619157
2025-01-07 21:05:48,persegiMerah,755,399,139,146,153,52,156,54,3,2,True,0.30082700124237727
2025-01-07 21:05:50,persegiKuning,762,362,125,153,66,79,61,76,5,3,True,0.4038687029333218
2025-01-07 21:05:50,Kuning,762,362,tensor(125.2585),tensor(153.3211),99,70,94,66,5,4,True,0.0004987716674804688
2025-01-07 21:05:50,persegiMerah,775,379,129,139,157,47,153,42,4,5,True,0.2675855619954682
2025-01-07 21:05:51,persegiMerah,777,377,132,141,178,1,179,1,1,0,False,0.23659246316775995
2025-01-07 21:05:51,Fail to pick,777,377,0,0,0,0,0,0,0,0,False,0
2025-01-07 21:05:51,persegiMerah,783,387,138,138,137,73,137,76,0,3,True,0.10022193549078735
2025-01-07 21:05:51,Merah,783,387,tensor(138.9603),tensor(138.4276),92,72,88,74,4,2,True,0.0
2025-01-07 21:05:51,persegiMerah,781,386,133,133,25,81,27,79,2,2,True,0.24076480666875444
2025-01-07 21:05:51,Fail to pick,781,386,0,0,0,0,0,0,0,0,False,0
2025-01-07 21:05:52,persegiMerah,783,382,138,136,104,54,103,57,1,3,False,0.44834544468625304
2025-01-07 21:05:52,Fail to pick,783,382,0,0,0,0,0,0,0,0,False,0
2025-01-07 21:05:52,persegiMerah,780,383,135,136,85,19,85,15,0,4,True,0.3525810070199058
2025-01-07 21:05:52,Fail to pick,780,383,0,0,0,0,0,0,0,0,False,0
2025-01-07 21:05:52,persegiMerah,779,383,139,135,122,24,119,22,3,2,False,0.15038536292188778
2025-01-07 21:05:52,Fail to pick,779,383,0,0,0,0,0,0,0,0,False,0
2025-01-07 21:05:53,persegiMerah,777,381,134,136,64,83,59,85,5,2,True,0.452944151801586
2025-01-07 21:05:53,Merah,777,381,tensor(134.2907),tensor(136.1265),94,71,90,74,4,3,True,0.0
2025-01-07 21:05:53,Fail to pick,777,381,0,0,0,0,0,0,0,0,False,0
2025-01-07 21:05:53,persegiMerah,780,383,139,133,143,83,140,82,3,1,True,0.15857470201243276
2025-01-07 21:05:53,Fail to pick,780,383,0,0,0,0,0,0,0,0,False,0
2025-01-07 21:05:54,persegiMerah,784,383,139,131,103,77,104,76,1,1,True,0.3956045402123852
2025-01-07 21:05:54,Fail to pick,784,383,0,0,0,0,0,0,0,0,False,0
2025-01-07 21:05:54,persegiMerah,777,384,136,132,179,95,176,91,3,4,True,0.39561274058033247
2025-01-07 21:05:54,Merah,777,384,tensor(136.5486),tensor(132.1539),93,71,95,74,2,3,True,0.0004985332489013672
2025-01-07 21:05:54,Fail to pick,777,384,0,0,0,0,0,0,0,0,False,0
2025-01-07 21:05:54,persegiMerah,786,388,146,132,118,80,122,81,4,1,True,0.3856926378721792
2025-01-07 21:05:54,Fail to pick,786,388,0,0,0,0,0,0,0,0,False,0
2025-01-07 21:05:55,persegiMerah,788,379,146,132,11,62,11,64,0,2,True,0.42036086593573074
2025-01-07 21:05:55,Fail to pick,788,379,0,0,0,0,0,0,0,0,False,0
2025-01-07 21:05:55,persegiMerah,779,390,135,136,122,80,120,81,2,1,True,0.3391508269171686
2025-01-07 21:05:55,Merah,779,390,tensor(135.8489),tensor(136.9170),91,72,91,71,0,1,True,0.0
2025-01-07 21:05:55,persegiMerah,782,387,139,136,44,15,42,17,2,2,True,0.3265203107055663
2025-01-07 21:05:55,Fail to pick,782,387,0,0,0,0,0,0,0,0,False,0
2025-01-07 21:05:55,persegiMerah,784,384,140,134,68,81,68,80,0,1,True,0.24807934992411065
2025-01-07 21:05:55,Fail to pick,784,384,0,0,0,0,0,0,0,0,False,0
2025-01-07 21:05:56,persegiMerah,784,384,140,132,169,77,170,76,1,1,True,0.12650422310768183
2025-01-07 21:05:56,Fail to pick,784,384,0,0,0,0,0,0,0,0,False,0
2025-01-07 21:05:56,persegiMerah,783,380,138,136,63,55,60,56,3,1,True,0.3569443154657791
2025-01-07 21:05:56,Fail to pick,783,380,0,0,0,0,0,0,0,0,False,0
2025-01-07 21:05:56,persegiMerah,780,381,137,133,93,9,89,11,4,2,True,0.3500797398797588
2025-01-07 21:05:56,Merah,780,381,tensor(137.4080),tensor(133.4795),94,72,96,73,2,1,True,0.0
2025-01-07 21:05:56,Fail to pick,780,381,0,0,0,0,0,0,0,0,False,0
2025-01-07 21:05:56,persegiMerah,775,385,137,132,78,53,81,54,3,1,True,0.3012240650994935
2025-01-07 21:05:56,Fail to pick,775,385,0,0,0,0,0,0,0,0,False,0
2025-01-07 21:05:57,persegiMerah,780,390,138,135,45,29,40,29,5,0,True,0.38915464907988573
2025-01-07 21:05:57,Fail to pick,780,390,0,0,0,0,0,0,0,0,False,0
2025-01-07 21:05:58,persegiMerah,784,379,136,134,27,48,28,45,1,3,True,0.4523053541972776
2025-01-07 21:05:58,Merah,784,379,tensor(136.9495),tensor(134.6867),94,72,97,71,3,1,True,0.0004990100860595703
2025-01-07 21:05:58,persegiMerah,782,385,138,133,101,81,105,81,4,0,True,0.32478496598163364
2025-01-07 21:05:58,Fail to pick,782,385,0,0,0,0,0,0,0,0,False,0
2025-01-07 21:05:58,persegiMerah,783,385,140,131,68,37,72,37,4,0,True,0.28036547114279864
2025-01-07 21:05:58,Fail to pick,783,385,0,0,0,0,0,0,0,0,False,0
2025-01-07 21:06:00,persegiMerah,772,391,141,135,164,26,159,24,5,2,True,0.4706623627090524
2025-01-07 21:06:00,Merah,772,391,tensor(141.2181),tensor(135.3302),91,71,93,72,2,1,True,0.0005002021789550781
2025-01-07 21:06:00,persegiMerah,783,384,139,129,104,66,102,67,2,1,False,0.10436657249749373
2025-01-07 21:06:00,persegiMerah,785,385,137,131,23,58,20,60,3,2,True,0.2650060366384504
2025-01-07 21:06:00,Fail to pick,785,385,0,0,0,0,0,0,0,0,False,0
2025-01-07 21:06:00,persegiMerah,781,382,140,134,3,19,4,15,1,4,True,0.10166079748287893
2025-01-07 21:06:00,Fail to pick,781,382,0,0,0,0,0,0,0,0,False,0
2025-01-07 21:06:25,persegiKuning,759,368,124,133,43,83,46,78,3,5,True,0.2382153937111681
2025-01-07 21:06:25,Kuning,759,368,tensor(124.2970),tensor(133.7812),97,70,101,65,4,5,True,0.0
2025-01-07 21:06:27,persegiBiru,814,373,128,111,118,90,119,86,1,4,True,0.16264922908672444
2025-01-07 21:06:27,Biru,814,373,tensor(128.8966),tensor(111.2253),96,75,95,79,1,4,True,0.0
2025-01-07 21:06:27,persegiBiru,807,371,126,107,41,10,42,10,1,0,True,0.31849253622027757
2025-01-07 21:06:27,Fail to pick,807,371,0,0,0,0,0,0,0,0,False,0
2025-01-07 21:06:27,persegiBiru,802,356,131,115,89,78,92,78,3,0,True,0.33795392247960265
2025-01-07 21:06:29,persegiBiru,747,325,125,112,61,92,58,92,3,0,True,0.48514853999641583
2025-01-07 21:06:29,Biru,747,325,tensor(125.8052),tensor(112.1247),109,69,110,68,1,1,True,0.0004992485046386719
2025-01-07 21:06:29,persegiBiru,800,359,127,111,5,85,4,84,1,1,True,0.24908544298853835
2025-01-07 21:06:29,persegiBiru,803,356,135,110,29,98,27,101,2,3,True,0.3568068289419136
2025-01-07 21:06:29,Fail to pick,803,356,0,0,0,0,0,0,0,0,False,0
2025-01-07 21:06:29,persegiBiru,799,358,135,110,105,50,106,45,1,5,True,0.3546611911026284
2025-01-07 21:06:29,Fail to pick,799,358,0,0,0,0,0,0,0,0,False,0
2025-01-07 21:06:30,persegiBiru,811,378,130,111,156,92,156,88,0,4,True,0.17485517939397754
2025-01-07 21:06:30,Biru,811,378,tensor(130.6322),tensor(111.8657),95,75,99,74,4,1,True,0.0004944801330566406
2025-01-07 21:06:31,persegiBiru,800,364,131,108,196,42,200,40,4,2,True,0.35597521193239523
2025-01-07 21:06:31,persegiBiru,798,358,134,109,120,27,124,22,4,5,True,0.34695684321049886
2025-01-07 21:06:31,Biru,798,358,tensor(134.9193),tensor(109.5342),100,73,98,71,2,2,True,0.0
2025-01-07 21:06:31,Fail to pick,798,358,0,0,0,0,0,0,0,0,False,0
2025-01-07 21:06:33,persegiBiru,803,381,129,111,105,84,108,84,3,0,True,0.4594943223575755
2025-01-07 21:06:33,Biru,803,381,tensor(129.9194),tensor(111.1644),94,74,98,74,4,0,True,0.0005002021789550781
2025-01-07 21:06:33,persegiBiru,789,363,128,111,99,54,103,50,4,4,True,0.24174823757956
2025-01-07 21:06:33,persegiBiru,802,356,129,113,45,73,48,69,3,4,True,0.4477010262230544
2025-01-07 21:06:33,persegiBiru,762,328,129,119,183,13,183,9,0,4,True,0.35237558670021185
2025-01-07 21:06:34,persegiMerah,813,378,132,122,63,86,58,89,5,3,True,0.4848462689453884
2025-01-07 21:06:34,Merah,813,378,tensor(132.7792),tensor(122.2667),95,75,91,71,4,4,True,0.000499725341796875
2025-01-07 21:06:34,persegiMerah,790,365,130,126,38,24,34,27,4,3,True,0.2543030312637305
2025-01-07 21:06:35,persegiMerah,806,362,129,135,180,12,182,10,2,2,True,0.12184144346640564
2025-01-07 21:06:35,Merah,806,362,tensor(129.5835),tensor(135.4226),99,74,95,69,4,5,True,0.0
2025-01-07 21:06:35,persegiMerah,812,375,130,136,11,11,9,13,2,2,True,0.3696853045453563
2025-01-07 21:06:35,persegiMerah,813,358,141,115,89,60,89,63,0,3,True,0.48078972384495466
2025-01-07 21:06:36,persegiBiru,792,392,130,120,28,33,29,28,1,5,True,0.2320328160822862
2025-01-07 21:06:36,Biru,792,392,tensor(130.6623),tensor(120.3045),91,73,87,77,4,4,True,0.0
2025-01-07 21:06:37,persegiBiru,790,358,133,116,174,48,176,48,2,0,False,0.1338312914047537
2025-01-07 21:06:37,Biru,790,358,tensor(133.4013),tensor(116.3275),100,73,104,72,4,1,True,0.0
2025-01-07 21:06:37,persegiBiru,795,359,136,119,159,50,154,45,5,5,True,0.45559628690201315
2025-01-07 21:06:37,Fail to pick,795,359,0,0,0,0,0,0,0,0,False,0
2025-01-07 21:06:37,persegiBiru,807,376,123,114,131,80,126,75,5,5,True,0.1892077759947425
2025-01-07 21:06:38,persegiBiru,756,347,119,117,186,95,188,95,2,0,True,0.12357085808470375
2025-01-07 21:06:38,persegiBiru,765,336,132,116,84,19,85,15,1,4,True,0.37691125018604155
2025-01-07 21:06:38,Biru,765,336,tensor(132.9829),tensor(116.0428),106,70,104,70,2,0,True,0.0005002021789550781
2025-01-07 21:06:39,persegiBiru,789,360,131,123,187,68,189,68,2,0,True,0.4146604589044218
2025-01-07 21:06:39,persegiBiru,807,373,125,116,121,99,116,98,5,1,True,0.4405153921761339
2025-01-07 21:06:39,persegiBiru,786,357,127,113,59,18,55,19,4,1,True,0.47259760698433373
2025-01-07 21:06:40,persegiBiru,760,338,129,120,73,83,77,79,4,4,True,0.4110574644398618
2025-01-07 21:06:40,persegiBiru,753,344,118,116,147,21,149,17,2,4,True,0.35177715762673434
2025-01-07 21:06:40,Biru,753,344,tensor(118.1727),tensor(116.2524),104,69,104,66,0,3,True,0.0
2025-01-07 21:06:40,Fail to pick,753,344,0,0,0,0,0,0,0,0,False,0
2025-01-07 21:06:40,persegiBiru,764,334,125,114,38,95,41,90,3,5,True,0.23767994787927194
2025-01-07 21:06:41,persegiBiru,786,356,125,116,104,94,100,89,4,5,True,0.16283905445340255
2025-01-07 21:06:41,persegiBiru,794,356,133,116,145,27,145,31,0,4,True,0.3036968347171019
2025-01-07 21:06:41,Biru,794,356,tensor(133.8318),tensor(116.9109),101,73,105,76,4,3,True,0.0004999637603759766
2025-01-07 21:06:41,Fail to pick,794,356,0,0,0,0,0,0,0,0,False,0
2025-01-07 21:06:41,persegiBiru,813,371,125,113,116,40,118,40,2,0,True,0.4790508365696934
2025-01-07 21:06:42,persegiBiru,790,356,128,115,116,57,115,54,1,3,True,0.29815332314263987
2025-01-07 21:06:42,persegiBiru,790,363,129,114,61,55,59,59,2,4,True,0.3848690153911384
2025-01-07 21:06:42,Fail to pick,790,363,0,0,0,0,0,0,0,0,False,0
2025-01-07 21:06:42,persegiBiru,812,372,127,114,46,33,45,31,1,2,True,0.38713038142655565
2025-01-07 21:06:42,persegiBiru,766,341,120,117,179,71,178,68,1,3,True,0.43837445516433804
2025-01-07 21:06:43,persegiBiru,762,344,124,117,69,94,69,90,0,4,True,0.20741411389549605
2025-01-07 21:06:43,Biru,762,344,tensor(124.2729),tensor(117.5389),104,70,104,72,0,2,True,0.0
2025-01-07 21:06:43,Fail to pick,762,344,0,0,0,0,0,0,0,0,False,0
2025-01-07 21:06:43,persegiBiru,748,352,120,118,17,6,13,10,4,4,True,0.36873116412709805
2025-01-07 21:06:43,persegiBiru,801,355,129,119,190,88,185,86,5,2,True,0.11067581836434207
2025-01-07 21:06:43,persegiBiru,790,357,128,117,123,25,121,27,2,2,True,0.25107267769581787
2025-01-07 21:06:44,persegiMerah,812,369,123,113,67,87,62,86,5,1,True,0.14492393287102712
2025-01-07 21:06:44,persegiBiru,808,370,120,111,54,77,58,76,4,1,True,0.43714772680750646
2025-01-07 21:06:44,Fail to pick,808,370,0,0,0,0,0,0,0,0,False,0
2025-01-07 21:06:44,persegiBiru,789,360,130,117,87,52,82,50,5,2,False,0.4404806099449694
2025-01-07 21:06:44,Biru,789,360,tensor(130.1797),tensor(117.2358),100,73,98,70,2,3,True,0.0004990100860595703
2025-01-07 21:06:44,persegiBiru,758,343,119,117,189,55,190,51,1,4,True,0.15399229378926435
2025-01-07 21:06:44,persegiBiru,787,358,128,116,173,87,175,90,2,3,True,0.4868576298540319
2025-01-07 21:06:45,persegiBiru,790,360,128,118,71,97,74,101,3,4,True,0.3145699896045341
2025-01-07 21:06:45,Fail to pick,790,360,0,0,0,0,0,0,0,0,False,0
2025-01-07 21:06:45,persegiBiru,789,360,126,117,74,65,74,60,0,5,True,0.271282547210716
2025-01-07 21:06:45,Fail to pick,789,360,0,0,0,0,0,0,0,0,False,0
2025-01-07 21:06:45,persegiBiru,783,361,131,117,49,21,51,18,2,3,True,0.4704421491648971
2025-01-07 21:06:45,Fail to pick,783,361,0,0,0,0,0,0,0,0,False,0
2025-01-07 21:06:45,persegiBiru,765,334,122,117,188,10,192,5,4,5,True,0.27242723754007964
2025-01-07 21:06:45,persegiBiru,806,373,122,119,147,90,145,86,2,4,True,0.23836563567415014
2025-01-07 21:06:45,Biru,806,373,tensor(122.7231),tensor(119.6008),96,74,92,71,4,3,True,0.0
2025-01-07 21:06:47,persegiBiru,789,357,127,115,138,67,141,70,3,3,False,0.496751747283003
2025-01-07 21:06:47,persegiBiru,759,337,129,120,83,7,86,10,3,3,True,0.3496063091399009
2025-01-07 21:06:47,persegiBiru,814,370,125,117,62,15,65,10,3,5,True,0.38315126150644196
2025-01-07 21:06:47,Biru,814,370,tensor(125.9883),tensor(117.4021),97,75,99,75,2,0,True,0.0004994869232177734
2025-01-07 21:06:48,persegiBiru,768,332,126,120,181,13,180,17,1,4,True,0.4461752027911824
2025-01-07 21:06:48,persegiBiru,793,357,130,118,146,10,147,5,1,5,True,0.2833239620500465
2025-01-07 21:06:48,persegiBiru,768,342,128,117,114,77,112,76,2,1,True,0.4572473466718707
2025-01-07 21:06:49,persegiBiru,755,342,124,119,101,26,96,22,5,4,True,0.2796149861797421
2025-01-07 21:06:49,Biru,755,342,tensor(124.0338),tensor(119.7268),105,69,100,70,5,1,True,0.000499725341796875
2025-01-07 21:06:50,persegiBiru,809,380,123,107,74,42,73,40,1,2,True,0.4031289339168942
2025-01-07 21:06:50,persegiBiru,776,371,123,110,188,20,183,17,5,3,True,0.29976873696726836
2025-01-07 21:06:50,Biru,776,371,tensor(123.2572),tensor(110.5540),96,71,94,66,2,5,True,0.0
2025-01-07 21:06:51,persegiBiru,778,367,129,111,40,94,43,93,3,1,True,0.4813117858864111
2025-01-07 21:06:51,Fail to pick,778,367,0,0,0,0,0,0,0,0,False,0
2025-01-07 21:06:51,persegiBiru,740,351,136,113,51,3,54,2,3,1,True,0.346703916132944
2025-01-07 21:06:51,persegiBiru,731,357,128,112,135,11,135,6,0,5,True,0.21820777872066605
2025-01-07 21:06:51,Fail to pick,731,357,0,0,0,0,0,0,0,0,False,0
2025-01-07 21:06:51,persegiBiru,772,384,130,114,110,22,108,18,2,4,True,0.12280683755745443
2025-01-07 21:06:51,persegiBiru,775,408,128,111,108,76,106,71,2,5,True,0.13399112965040083
2025-01-07 21:06:52,persegiBiru,787,403,137,110,75,87,71,91,4,4,True,0.16423086401137493
2025-01-07 21:06:52,Biru,787,403,tensor(137.0684),tensor(110.1622),88,72,88,73,0,1,True,0.0
2025-01-07 21:06:53,persegiBiru,773,408,129,113,160,36,156,33,4,3,True,0.3041974537479635
2025-01-07 21:06:53,persegiBiru,772,409,127,112,153,88,155,87,2,1,True,0.490283070383407
2025-01-07 21:06:53,Fail to pick,772,409,0,0,0,0,0,0,0,0,False,0
2025-01-07 21:06:53,persegiBiru,769,407,121,116,123,84,127,80,4,4,False,0.4945290606472976
2025-01-07 21:06:53,Fail to pick,769,407,0,0,0,0,0,0,0,0,False,0
2025-01-07 21:06:54,persegiBiru,788,367,128,112,160,85,162,86,2,1,True,0.4539697121463958
2025-01-07 21:06:54,Biru,788,367,tensor(128.5370),tensor(112.0804),98,72,98,76,0,4,True,0.0005064010620117188
2025-01-07 21:06:54,persegiBiru,808,381,125,113,198,62,195,61,3,1,True,0.1183071191312723
2025-01-07 21:06:54,persegiBiru,798,358,129,117,180,81,182,79,2,2,True,0.24182544687294236
2025-01-07 21:06:54,persegiBiru,789,364,127,113,185,98,180,98,5,0,True,0.3050944015585235
2025-01-07 21:06:54,Fail to pick,789,364,0,0,0,0,0,0,0,0,False,0
2025-01-07 21:06:55,persegiBiru,756,341,122,115,134,27,129,30,5,3,True,0.3126200297213968
2025-01-07 21:06:55,persegiBiru,808,378,125,113,187,95,187,94,0,1,True,0.4418963671419919
2025-01-07 21:06:55,Biru,808,378,tensor(125.8767),tensor(113.1786),95,74,97,74,2,0,True,0.0004980564117431641
2025-01-07 21:06:56,persegiBiru,789,359,132,115,137,16,139,17,2,1,True,0.45276369867462496
2025-01-07 21:06:57,persegiBiru,806,374,130,111,180,86,179,89,1,3,True,0.2916362400086337
2025-01-07 21:06:57,Biru,806,374,tensor(130.7612),tensor(111.6037),96,74,98,69,2,5,True,0.0004994869232177734
2025-01-07 21:06:57,persegiBiru,812,373,127,114,124,89,123,89,1,0,True,0.2377407708317204
2025-01-07 21:06:57,Fail to pick,812,373,0,0,0,0,0,0,0,0,False,0
2025-01-07 21:06:57,persegiMerah,809,374,130,116,64,29,66,26,2,3,False,0.3193194547401811
2025-01-07 21:06:57,Fail to pick,809,374,0,0,0,0,0,0,0,0,False,0
2025-01-07 21:06:57,persegiBiru,754,334,128,118,194,81,192,85,2,4,True,0.15038397814648927
2025-01-07 21:06:57,persegiBiru,757,332,124,117,128,38,124,41,4,3,True,0.27954603359061836
2025-01-07 21:06:57,Fail to pick,757,332,0,0,0,0,0,0,0,0,False,0
2025-01-07 21:06:58,persegiBiru,762,332,131,118,103,94,103,93,0,1,True,0.11246465937668577
2025-01-07 21:06:58,Biru,762,332,tensor(131.3671),tensor(118.5237),107,70,107,70,0,0,True,0.0
2025-01-07 21:06:58,Fail to pick,762,332,0,0,0,0,0,0,0,0,False,0
2025-01-07 21:06:58,persegiBiru,762,334,130,118,126,29,128,24,2,5,True,0.24833538363178295
2025-01-07 21:06:58,Fail to pick,762,334,0,0,0,0,0,0,0,0,False,0
2025-01-07 21:06:58,persegiBiru,755,342,123,117,119,41,121,37,2,4,True,0.17690905237404086
2025-01-07 21:06:58,Fail to pick,755,342,0,0,0,0,0,0,0,0,False,0
2025-01-07 21:06:59,persegiBiru,759,340,130,115,167,24,171,26,4,2,True,0.28808457580127267
2025-01-07 21:06:59,Fail to pick,759,340,0,0,0,0,0,0,0,0,False,0
2025-01-07 21:06:59,persegiBiru,755,341,128,118,168,94,168,92,0,2,True,0.34153961337879746
2025-01-07 21:06:59,Biru,755,341,tensor(128.4850),tensor(118.8614),105,69,101,64,4,5,True,0.0
2025-01-07 21:06:59,Fail to pick,755,341,0,0,0,0,0,0,0,0,False,0
2025-01-07 21:06:59,persegiMerah,839,407,118,110,18,65,22,68,4,3,True,0.36947958056604413
2025-01-07 21:07:00,persegiMerah,159,313,133,121,15,88,15,87,0,1,True,0.48791981976971266
2025-01-07 21:07:00,persegiMerah,163,314,135,124,195,22,193,24,2,2,True,0.18638069432732382
2025-01-07 21:07:00,Fail to pick,163,314,0,0,0,0,0,0,0,0,False,0
2025-01-07 21:07:00,persegiMerah,151,319,131,127,171,61,172,60,1,1,True,0.2261796203778885
2025-01-07 21:07:01,persegiMerah,165,331,134,124,160,14,162,13,2,1,True,0.4828614592078332
2025-01-07 21:07:01,persegiMerah,171,336,136,123,54,0,51,3,3,3,True,0.17814008091351452
2025-01-07 21:07:01,Fail to pick,171,336,0,0,0,0,0,0,0,0,False,0
2025-01-07 21:07:01,persegiMerah,190,372,140,131,154,20,157,18,3,2,True,0.10975156554486452
2025-01-07 21:07:01,Merah,190,372,tensor(140.9442),tensor(131.0438),96,17,98,19,2,2,True,0.000499725341796875
2025-01-07 21:07:01,persegiMerah,175,380,137,128,174,83,171,85,3,2,True,0.34253003321358155
2025-01-07 21:07:01,persegiMerah,174,379,141,129,146,85,149,88,3,3,True,0.43914193801670154
2025-01-07 21:07:01,Fail to pick,174,379,0,0,0,0,0,0,0,0,False,0
2025-01-07 21:07:01,persegiMerah,154,359,134,132,42,93,43,91,1,2,True,0.27282415771757607
2025-01-07 21:07:01,persegiMerah,175,370,137,127,173,86,177,81,4,5,True,0.10124878482455704
2025-01-07 21:07:01,persegiMerah,179,342,137,125,193,72,195,67,2,5,True,0.41478830585698445
2025-01-07 21:07:01,persegiMerah,177,337,133,122,166,36,163,39,3,3,True,0.4919538892950974
2025-01-07 21:07:01,Fail to pick,177,337,0,0,0,0,0,0,0,0,False,0
2025-01-07 21:07:01,persegiMerah,176,335,135,126,22,59,19,57,3,2,True,0.13428026944151916
2025-01-07 21:07:01,Fail to pick,176,335,0,0,0,0,0,0,0,0,False,0
2025-01-07 21:07:02,persegiMerah,179,336,139,124,104,13,100,14,4,1,True,0.16291977926746917
2025-01-07 21:07:02,Fail to pick,179,336,0,0,0,0,0,0,0,0,False,0
2025-01-07 21:07:02,persegiMerah,171,326,138,125,51,65,49,63,2,2,True,0.29670762844750015
2025-01-07 21:07:02,persegiMerah,168,330,138,122,139,2,142,1,3,1,True,0.26695791252000534
2025-01-07 21:07:02,Fail to pick,168,330,0,0,0,0,0,0,0,0,False,0
2025-01-07 21:07:02,persegiMerah,167,330,137,121,46,87,44,88,2,1,True,0.11386364676178262
2025-01-07 21:07:02,Fail to pick,167,330,0,0,0,0,0,0,0,0,False,0
2025-01-07 21:07:02,persegiMerah,168,334,137,123,37,88,36,90,1,2,False,0.14542273450900153
2025-01-07 21:07:02,Fail to pick,168,334,0,0,0,0,0,0,0,0,False,0
2025-01-07 21:07:02,persegiMerah,166,329,138,123,79,64,76,68,3,4,True,0.36296815331938836
2025-01-07 21:07:02,Fail to pick,166,329,0,0,0,0,0,0,0,0,False,0
2025-01-07 21:07:02,persegiMerah,168,328,135,123,11,68,15,66,4,2,True,0.3626354295381583
2025-01-07 21:07:02,Fail to pick,168,328,0,0,0,0,0,0,0,0,False,0
2025-01-07 21:07:02,persegiMerah,164,331,135,121,196,71,200,68,4,3,True,0.46560790543709063
2025-01-07 21:07:02,Fail to pick,164,331,0,0,0,0,0,0,0,0,False,0
2025-01-07 21:07:02,persegiMerah,171,326,144,123,96,7,91,4,5,3,True,0.21384088846176375
2025-01-07 21:07:02,Fail to pick,171,326,0,0,0,0,0,0,0,0,False,0
2025-01-07 21:07:03,persegiMerah,165,328,134,120,18,0,20,-5,2,5,True,0.1668229838553969
2025-01-07 21:07:03,Fail to pick,165,328,0,0,0,0,0,0,0,0,False,0
2025-01-07 21:07:03,persegiMerah,169,331,138,121,3,45,-1,48,4,3,True,0.10899374816596669
2025-01-07 21:07:03,Fail to pick,169,331,0,0,0,0,0,0,0,0,False,0
2025-01-07 21:07:03,persegiMerah,168,329,136,120,33,9,31,5,2,4,True,0.254465297190021
2025-01-07 21:07:03,Fail to pick,168,329,0,0,0,0,0,0,0,0,False,0
2025-01-07 21:07:03,persegiMerah,150,313,129,119,128,42,130,40,2,2,True,0.3793303332281799
2025-01-07 21:07:03,persegiMerah,170,331,137,121,3,95,7,93,4,2,True,0.19002785976752318
2025-01-07 21:07:03,persegiMerah,170,335,141,120,17,7,19,6,2,1,True,0.3810288965829235
2025-01-07 21:07:03,Fail to pick,170,335,0,0,0,0,0,0,0,0,False,0
2025-01-07 21:07:03,persegiMerah,165,333,138,123,133,5,129,1,4,4,True,0.17482511459496752
2025-01-07 21:07:03,Fail to pick,165,333,0,0,0,0,0,0,0,0,False,0
2025-01-07 21:07:03,persegiMerah,152,316,128,126,80,45,76,42,4,3,True,0.11624485171708457
2025-01-07 21:07:03,persegiMerah,172,324,137,123,42,18,46,22,4,4,True,0.32255859352385224
2025-01-07 21:07:04,persegiMerah,155,312,128,121,167,72,170,72,3,0,True,0.1703990264920731
2025-01-07 21:07:04,persegiMerah,176,327,137,120,126,2,129,-3,3,5,True,0.12819656526951834
2025-01-07 21:07:04,persegiMerah,168,331,134,122,72,39,68,34,4,5,True,0.35725316514358685
2025-01-07 21:07:04,Fail to pick,168,331,0,0,0,0,0,0,0,0,False,0
2025-01-07 21:07:04,persegiMerah,169,324,136,127,71,24,72,24,1,0,True,0.17663695545806424
2025-01-07 21:07:04,Fail to pick,169,324,0,0,0,0,0,0,0,0,False,0
2025-01-07 21:07:04,persegiMerah,172,328,134,120,180,0,177,-4,3,4,True,0.3127766111911371
2025-01-07 21:07:04,Fail to pick,172,328,0,0,0,0,0,0,0,0,False,0
2025-01-07 21:07:04,persegiMerah,176,326,136,121,151,25,146,25,5,0,False,0.10632547573595869
2025-01-07 21:07:04,Fail to pick,176,326,0,0,0,0,0,0,0,0,False,0
2025-01-07 21:07:04,persegiMerah,148,316,126,123,67,22,71,25,4,3,True,0.3613417257143504
2025-01-07 21:07:04,persegiMerah,168,331,134,121,90,5,94,9,4,4,True,0.11914985942722917
2025-01-07 21:07:04,persegiMerah,171,330,135,120,61,98,58,98,3,0,True,0.2529955292023663
2025-01-07 21:07:04,Fail to pick,171,330,0,0,0,0,0,0,0,0,False,0
2025-01-07 21:07:05,persegiMerah,146,319,128,125,28,23,27,26,1,3,False,0.4622398707011417
2025-01-07 21:07:05,persegiMerah,169,330,133,121,175,30,171,29,4,1,True,0.2489709613106466
2025-01-07 21:07:05,persegiMerah,152,307,128,121,50,48,54,47,4,1,True,0.1142098035032698
2025-01-07 21:07:05,persegiMerah,150,314,128,123,70,22,71,24,1,2,True,0.4151558699752317
2025-01-07 21:07:05,Fail to pick,150,314,0,0,0,0,0,0,0,0,False,0
2025-01-07 21:07:05,persegiMerah,145,312,127,127,131,94,129,95,2,1,True,0.3959963120660218
2025-01-07 21:07:05,Fail to pick,145,312,0,0,0,0,0,0,0,0,False,0
2025-01-07 21:07:05,persegiMerah,167,332,140,122,45,87,46,91,1,4,True,0.22867653674420851
2025-01-07 21:07:05,persegiMerah,151,309,131,125,15,50,19,49,4,1,False,0.2245789974063267
2025-01-07 21:07:05,persegiMerah,173,327,143,121,125,40,128,42,3,2,True,0.4823520846967032
2025-01-07 21:07:05,persegiMerah,178,337,137,118,29,22,26,25,3,3,True,0.20275081013559282
2025-01-07 21:07:05,persegiMerah,166,332,131,118,104,86,107,83,3,3,True,0.37901757266568203
2025-01-07 21:07:06,persegiMerah,172,329,132,120,155,66,152,61,3,5,True,0.4084556320499554
2025-01-07 21:07:06,Fail to pick,172,329,0,0,0,0,0,0,0,0,False,0
2025-01-07 21:07:06,persegiMerah,177,326,135,121,115,67,119,71,4,4,True,0.2736300016380142
2025-01-07 21:07:06,Fail to pick,177,326,0,0,0,0,0,0,0,0,False,0
2025-01-07 21:07:06,persegiMerah,166,331,134,122,24,49,26,48,2,1,False,0.3346211955072521
2025-01-07 21:07:06,persegiMerah,167,328,135,120,29,63,30,61,1,2,True,0.1877248784010364
2025-01-07 21:07:06,Fail to pick,167,328,0,0,0,0,0,0,0,0,False,0
2025-01-07 21:07:06,persegiMerah,167,329,134,120,169,46,164,43,5,3,True,0.3219413227797502
2025-01-07 21:07:06,Fail to pick,167,329,0,0,0,0,0,0,0,0,False,0
2025-01-07 21:07:06,persegiMerah,170,327,139,121,146,11,145,7,1,4,True,0.19660978257842554
2025-01-07 21:07:06,Fail to pick,170,327,0,0,0,0,0,0,0,0,False,0
2025-01-07 21:07:06,persegiMerah,167,331,134,122,123,2,125,0,2,2,True,0.2909879161381914
2025-01-07 21:07:06,Fail to pick,167,331,0,0,0,0,0,0,0,0,False,0
2025-01-07 21:07:06,persegiMerah,172,328,137,120,25,57,29,56,4,1,True,0.1093063258084698
2025-01-07 21:07:06,Fail to pick,172,328,0,0,0,0,0,0,0,0,False,0
2025-01-07 21:07:06,persegiMerah,169,332,139,124,147,81,144,80,3,1,True,0.2512122275239098
2025-01-07 21:07:06,Fail to pick,169,332,0,0,0,0,0,0,0,0,False,0
2025-01-07 21:07:07,persegiMerah,166,331,137,119,120,1,116,5,4,4,True,0.24363258137690652
2025-01-07 21:07:07,Fail to pick,166,331,0,0,0,0,0,0,0,0,False,0
2025-01-07 21:07:07,persegiMerah,166,331,135,119,36,55,35,56,1,1,True,0.4199090779577791
2025-01-07 21:07:07,Fail to pick,166,331,0,0,0,0,0,0,0,0,False,0
2025-01-07 21:07:07,persegiMerah,167,328,137,120,97,45,96,44,1,1,True,0.4541204333696285
2025-01-07 21:07:07,Fail to pick,167,328,0,0,0,0,0,0,0,0,False,0
2025-01-07 21:07:07,persegiMerah,166,327,135,120,118,33,118,29,0,4,True,0.3021635860653976
2025-01-07 21:07:07,Fail to pick,166,327,0,0,0,0,0,0,0,0,False,0
2025-01-07 21:07:07,persegiMerah,145,317,129,122,188,54,186,50,2,4,True,0.14674704124215732
2025-01-07 21:07:07,persegiMerah,173,328,137,119,39,81,34,80,5,1,True,0.3305486272712249
2025-01-07 21:07:07,persegiMerah,165,330,131,119,43,0,44,1,1,1,True,0.22018720880066434
2025-01-07 21:07:07,Fail to pick,165,330,0,0,0,0,0,0,0,0,False,0
2025-01-07 21:07:07,persegiMerah,169,332,138,120,20,27,18,24,2,3,True,0.21327441444433065
2025-01-07 21:07:07,Fail to pick,169,332,0,0,0,0,0,0,0,0,False,0
2025-01-07 21:07:07,persegiMerah,167,330,136,121,149,72,149,67,0,5,True,0.42018894356077086
2025-01-07 21:07:07,Fail to pick,167,330,0,0,0,0,0,0,0,0,False,0
2025-01-07 21:07:07,persegiMerah,171,331,137,122,15,51,13,46,2,5,True,0.38507024177083804
2025-01-07 21:07:07,Fail to pick,171,331,0,0,0,0,0,0,0,0,False,0
2025-01-07 21:07:08,persegiMerah,166,332,135,122,89,7,85,10,4,3,True,0.4686419661998803
2025-01-07 21:07:08,Fail to pick,166,332,0,0,0,0,0,0,0,0,False,0
2025-01-07 21:07:08,persegiMerah,167,334,131,119,78,13,74,13,4,0,True,0.12146260331138779
2025-01-07 21:07:08,Fail to pick,167,334,0,0,0,0,0,0,0,0,False,0
2025-01-07 21:07:08,persegiMerah,165,330,134,119,146,56,150,52,4,4,True,0.1322792049066695
2025-01-07 21:07:08,Fail to pick,165,330,0,0,0,0,0,0,0,0,False,0
2025-01-07 21:07:08,persegiMerah,169,334,137,118,116,77,119,72,3,5,True,0.19583890885672034
2025-01-07 21:07:08,Fail to pick,169,334,0,0,0,0,0,0,0,0,False,0
2025-01-07 21:07:08,persegiMerah,171,331,137,119,90,84,92,80,2,4,True,0.405677785717809
2025-01-07 21:07:08,Fail to pick,171,331,0,0,0,0,0,0,0,0,False,0
2025-01-07 21:07:08,persegiMerah,166,333,133,121,13,17,10,13,3,4,True,0.3690752915863491
2025-01-07 21:07:08,Fail to pick,166,333,0,0,0,0,0,0,0,0,False,0
2025-01-07 21:07:08,persegiMerah,167,331,135,118,15,40,13,36,2,4,True,0.4825734031820018
2025-01-07 21:07:08,Fail to pick,167,331,0,0,0,0,0,0,0,0,False,0
2025-01-07 21:07:08,persegiMerah,168,331,132,119,119,21,116,21,3,0,True,0.4468052497780446
2025-01-07 21:07:08,Fail to pick,168,331,0,0,0,0,0,0,0,0,False,0
2025-01-07 21:07:08,persegiMerah,167,334,136,118,107,76,110,78,3,2,True,0.4834096088166878
2025-01-07 21:07:08,Fail to pick,167,334,0,0,0,0,0,0,0,0,False,0
2025-01-07 21:07:09,persegiMerah,166,336,135,119,62,38,65,42,3,4,True,0.4372160799248803
2025-01-07 21:07:09,Fail to pick,166,336,0,0,0,0,0,0,0,0,False,0
2025-01-07 21:07:09,persegiMerah,172,326,139,118,88,49,91,51,3,2,False,0.1398659971225223
2025-01-07 21:07:09,persegiMerah,146,315,124,119,144,36,146,33,2,3,True,0.1428558408173607
2025-01-07 21:07:09,persegiMerah,148,313,130,118,32,35,28,37,4,2,True,0.21735684573842493
2025-01-07 21:07:09,Fail to pick,148,313,0,0,0,0,0,0,0,0,False,0
2025-01-07 21:07:09,persegiMerah,164,334,136,120,180,74,178,74,2,0,True,0.4261539037505401
2025-01-07 21:07:09,persegiMerah,150,309,127,119,56,17,55,19,1,2,True,0.13748096003851007
2025-01-07 21:07:09,persegiMerah,168,332,134,124,58,92,61,91,3,1,True,0.20624245097652993
2025-01-07 21:07:09,persegiMerah,144,320,124,125,190,31,193,30,3,1,True,0.47868797924853324
2025-01-07 21:07:09,persegiMerah,170,328,135,119,168,70,169,74,1,4,True,0.4228096822808485
2025-01-07 21:07:09,persegiMerah,169,328,136,118,112,58,113,60,1,2,True,0.26051437723978166
2025-01-07 21:07:09,Fail to pick,169,328,0,0,0,0,0,0,0,0,False,0
2025-01-07 21:07:10,persegiMerah,170,329,139,119,199,95,203,99,4,4,False,0.43963711585337284
2025-01-07 21:07:10,Fail to pick,170,329,0,0,0,0,0,0,0,0,False,0
2025-01-07 21:07:10,persegiMerah,149,303,136,117,133,48,137,52,4,4,True,0.46531517393781974
2025-01-07 21:07:10,persegiMerah,167,333,134,121,63,53,67,49,4,4,True,0.19145009170874397
2025-01-07 21:07:10,persegiMerah,165,333,135,117,198,1,194,4,4,3,True,0.28326571442343745
2025-01-07 21:07:10,Fail to pick,165,333,0,0,0,0,0,0,0,0,False,0
2025-01-07 21:07:10,persegiMerah,167,330,135,118,38,69,39,68,1,1,True,0.49481445745804997
2025-01-07 21:07:10,Fail to pick,167,330,0,0,0,0,0,0,0,0,False,0
2025-01-07 21:07:10,persegiMerah,152,310,130,117,176,49,176,52,0,3,True,0.46588027994284553
2025-01-07 21:07:10,persegiMerah,171,329,135,117,71,84,75,88,4,4,True,0.4533851629991572
2025-01-07 21:07:10,persegiMerah,165,328,134,118,80,85,79,89,1,4,True,0.3008053052161048
2025-01-07 21:07:10,Fail to pick,165,328,0,0,0,0,0,0,0,0,False,0
2025-01-07 21:07:10,persegiMerah,162,334,131,118,168,70,170,66,2,4,True,0.13116593839773724
2025-01-07 21:07:10,Fail to pick,162,334,0,0,0,0,0,0,0,0,False,0
2025-01-07 21:07:11,persegiMerah,164,334,131,119,15,66,12,69,3,3,True,0.44989425563126817
2025-01-07 21:07:11,Fail to pick,164,334,0,0,0,0,0,0,0,0,False,0
2025-01-07 21:07:11,persegiMerah,168,331,136,118,112,72,113,72,1,0,True,0.30424067233459945
2025-01-07 21:07:11,Fail to pick,168,331,0,0,0,0,0,0,0,0,False,0
2025-01-07 21:07:11,persegiMerah,173,326,138,118,43,53,41,55,2,2,False,0.17878134954847555
2025-01-07 21:07:11,Fail to pick,173,326,0,0,0,0,0,0,0,0,False,0
2025-01-07 21:07:11,persegiMerah,166,328,136,118,163,21,158,21,5,0,True,0.417700078563809
2025-01-07 21:07:11,Fail to pick,166,328,0,0,0,0,0,0,0,0,False,0
2025-01-07 21:07:11,persegiMerah,146,309,128,120,88,55,88,53,0,2,True,0.3263995109058453
2025-01-07 21:07:11,persegiMerah,177,332,141,118,126,1,130,-3,4,4,True,0.4916377395980326
2025-01-07 21:07:11,persegiMerah,171,329,142,120,88,65,91,65,3,0,True,0.39162443367433986
2025-01-07 21:07:11,Fail to pick,171,329,0,0,0,0,0,0,0,0,False,0
2025-01-07 21:07:11,persegiMerah,169,332,139,119,185,50,181,46,4,4,True,0.28567663760582784
2025-01-07 21:07:11,Fail to pick,169,332,0,0,0,0,0,0,0,0,False,0
2025-01-07 21:07:11,persegiMerah,172,330,139,118,41,28,41,32,0,4,True,0.40164629967749865
2025-01-07 21:07:11,Fail to pick,172,330,0,0,0,0,0,0,0,0,False,0
2025-01-07 21:07:12,persegiMerah,171,328,143,119,175,15,175,13,0,2,True,0.24514314366563325
2025-01-07 21:07:12,Fail to pick,171,328,0,0,0,0,0,0,0,0,False,0
2025-01-07 21:07:12,persegiMerah,171,326,142,120,15,3,16,0,1,3,True,0.17572833818616568
2025-01-07 21:07:12,Fail to pick,171,326,0,0,0,0,0,0,0,0,False,0
2025-01-07 21:07:12,persegiMerah,172,332,141,120,30,12,31,14,1,2,True,0.23057931221649539
2025-01-07 21:07:12,Fail to pick,172,332,0,0,0,0,0,0,0,0,False,0
2025-01-07 21:07:12,persegiMerah,172,332,141,120,123,40,122,42,1,2,True,0.2599899054073299
2025-01-07 21:07:12,Fail to pick,172,332,0,0,0,0,0,0,0,0,False,0
2025-01-07 21:07:12,persegiMerah,164,339,138,116,57,46,59,43,2,3,True,0.2957134413932874
2025-01-07 21:07:12,Fail to pick,164,339,0,0,0,0,0,0,0,0,False,0
2025-01-07 21:07:12,persegiMerah,167,334,136,120,84,83,81,81,3,2,True,0.19368679349288223
2025-01-07 21:07:12,Fail to pick,167,334,0,0,0,0,0,0,0,0,False,0
2025-01-07 21:07:12,persegiMerah,166,333,139,120,40,45,37,46,3,1,True,0.4052723611439548
2025-01-07 21:07:12,Fail to pick,166,333,0,0,0,0,0,0,0,0,False,0
2025-01-07 21:07:12,persegiMerah,145,302,138,119,34,74,37,76,3,2,True,0.4935797828286468
2025-01-07 21:07:12,persegiMerah,152,307,132,121,196,17,200,20,4,3,True,0.22453103453456041
2025-01-07 21:07:12,Fail to pick,152,307,0,0,0,0,0,0,0,0,False,0
2025-01-07 21:07:13,persegiMerah,147,312,133,119,130,44,125,44,5,0,True,0.22128204698941112
2025-01-07 21:07:13,Fail to pick,147,312,0,0,0,0,0,0,0,0,False,0
2025-01-07 21:07:13,persegiMerah,148,319,135,122,178,50,175,54,3,4,True,0.16917470251940014
2025-01-07 21:07:13,Fail to pick,148,319,0,0,0,0,0,0,0,0,False,0
2025-01-07 21:07:13,persegiMerah,161,334,130,121,98,80,98,79,0,1,True,0.23724592015124754
2025-01-07 21:07:13,persegiMerah,168,324,137,120,191,52,190,51,1,1,True,0.3281404668744957
2025-01-07 21:07:13,persegiMerah,171,329,138,119,3,12,7,10,4,2,True,0.3320467167196054
2025-01-07 21:07:13,Fail to pick,171,329,0,0,0,0,0,0,0,0,False,0
2025-01-07 21:07:13,persegiMerah,153,305,132,118,178,98,173,102,5,4,True,0.20289997119856262
2025-01-07 21:07:13,persegiMerah,163,333,140,118,128,45,128,49,0,4,True,0.4393631800389509
2025-01-07 21:07:13,persegiMerah,170,329,145,119,140,44,141,46,1,2,True,0.42463387045699375
2025-01-07 21:07:13,Fail to pick,170,329,0,0,0,0,0,0,0,0,False,0
2025-01-07 21:07:13,persegiMerah,152,312,132,118,94,61,98,59,4,2,True,0.44368236384058213
2025-01-07 21:07:14,persegiMerah,159,338,135,119,127,95,129,93,2,2,False,0.2673673613863446
2025-01-07 21:07:14,persegiMerah,166,333,138,121,177,33,178,33,1,0,False,0.1933115180927216
2025-01-07 21:07:14,Fail to pick,166,333,0,0,0,0,0,0,0,0,False,0
2025-01-07 21:07:14,persegiMerah,166,332,140,117,12,2,11,0,1,2,True,0.10117122330783253
2025-01-07 21:07:14,Fail to pick,166,332,0,0,0,0,0,0,0,0,False,0
2025-01-07 21:07:14,persegiMerah,152,334,133,120,58,55,54,53,4,2,True,0.3009176138018054
2025-01-07 21:07:14,persegiMerah,137,322,131,122,156,94,158,95,2,1,True,0.3473353468304392
2025-01-07 21:07:14,persegiMerah,136,318,129,121,107,26,108,21,1,5,True,0.494283025367232
2025-01-07 21:07:14,Fail to pick,136,318,0,0,0,0,0,0,0,0,False,0
2025-01-07 21:07:16,persegiMerah,137,316,135,121,53,10,55,5,2,5,True,0.13378793649464896
2025-01-07 21:07:16,Fail to pick,137,316,0,0,0,0,0,0,0,0,False,0
2025-01-07 21:07:16,persegiMerah,153,326,143,122,67,61,63,58,4,3,True,0.1420197117687934
2025-01-07 21:07:16,persegiMerah,139,304,137,120,185,85,186,89,1,4,True,0.32932601621558805
2025-01-07 21:07:16,persegiMerah,143,321,141,121,81,8,76,3,5,5,True,0.22769659941331094
2025-01-07 21:07:16,persegiMerah,125,319,139,122,87,94,88,98,1,4,True,0.1666954508999295
2025-01-07 21:07:16,persegiMerah,120,305,139,122,28,85,27,85,1,0,False,0.3433497558394054
2025-01-07 21:07:16,persegiMerah,93,298,128,118,120,83,120,85,0,2,True,0.26778106315057226
2025-01-07 21:07:17,persegiMerah,103,327,133,119,13,46,8,47,5,1,True,0.47103086686087947
2025-01-07 21:07:17,persegiMerah,113,318,138,119,31,87,34,87,3,0,True,0.15394928744801858
2025-01-07 21:07:17,persegiMerah,123,315,141,118,90,63,89,65,1,2,True,0.13737987632344262
2025-01-07 21:07:17,persegiMerah,116,324,136,119,31,91,35,89,4,2,True,0.3093929784745415
2025-01-07 21:07:17,Fail to pick,116,324,0,0,0,0,0,0,0,0,False,0
2025-01-07 21:07:17,persegiMerah,115,307,139,120,104,48,107,49,3,1,True,0.1342704011770517
2025-01-07 21:07:17,persegiMerah,95,298,130,122,44,96,46,94,2,2,True,0.42527689033063487
2025-01-07 21:07:17,persegiMerah,108,294,138,124,130,73,131,74,1,1,True,0.136475487389664
2025-01-07 21:07:23,persegiMerah,741,85,120,124,29,70,25,72,4,2,True,0.4585071923807368
2025-01-07 21:07:23,Merah,741,85,tensor(120.4216),tensor(124.6169),176,68,178,64,2,4,True,0.0
2025-01-07 21:07:23,persegiMerah,746,104,112,118,145,49,144,53,1,4,False,0.43685229101595124
2025-01-07 21:07:23,persegiKuning,694,57,111,115,178,15,182,10,4,5,True,0.15499454906453028
2025-01-07 21:07:24,persegiMerah,656,74,115,110,96,62,93,61,3,1,True,0.29143296594726564
2025-01-07 21:07:24,persegiMerah,698,56,113,113,101,11,103,12,2,1,True,0.30461121489161547
2025-01-07 21:07:24,Merah,698,56,tensor(113.6422),tensor(113.6771),184,64,182,68,2,4,True,0.0005085468292236328
2025-01-07 21:07:25,persegiMerah,745,87,114,123,98,73,97,69,1,4,True,0.2560493557866433
2025-01-07 21:07:25,persegiMerah,686,53,113,107,110,26,111,23,1,3,True,0.4402188499057884
2025-01-07 21:07:25,Merah,686,53,tensor(113.1488),tensor(107.0571),185,63,183,60,2,3,True,0.0
2025-01-07 21:07:26,persegiMerah,729,78,119,120,177,79,181,80,4,1,True,0.403875455971097
2025-01-07 21:07:26,persegiMerah,677,55,117,111,49,34,51,38,2,4,False,0.19375692199360386
2025-01-07 21:07:26,persegiMerah,724,79,116,116,159,69,163,69,4,0,True,0.3407745004482872
2025-01-07 21:07:26,persegiMerah,684,53,115,107,55,14,50,17,5,3,True,0.4341160973903988
2025-01-07 21:07:26,Merah,684,53,tensor(115.9854),tensor(107.9080),185,63,187,62,2,1,True,0.000499725341796875
2025-01-07 21:07:27,persegiMerah,736,77,136,126,157,76,155,77,2,1,True,0.10918749852651106
2025-01-07 21:07:47,persegiMerah,741,76,114,140,25,67,27,70,2,3,True,0.42019633334216044
2025-01-07 21:07:47,Merah,741,76,tensor(114.7991),tensor(140.7403),178,68,177,72,1,4,True,0.0
2025-01-07 21:07:47,Fail to pick,741,76,0,0,0,0,0,0,0,0,False,0
2025-01-07 21:07:49,persegiMerah,713,81,124,149,114,50,112,51,2,1,True,0.4387476690804205
2025-01-07 21:07:49,Merah,713,81,tensor(124.6047),tensor(149.9775),177,66,177,68,0,2,True,0.0
2025-01-07 21:08:04,persegiMerah,731,86,126,130,43,90,47,92,4,2,True,0.13007421265984176
2025-01-07 21:08:04,Merah,731,86,tensor(126.2158),tensor(130.1888),176,67,172,70,4,3,True,0.0004992485046386719
2025-01-07 21:08:05,persegiKuning,740,90,113,132,109,55,105,55,4,0,True,0.14473259883285958
2025-01-07 21:08:05,Kuning,740,90,tensor(113.9031),tensor(132.9671),175,68,171,67,4,1,True,0.0
2025-01-07 21:08:05,Fail to pick,740,90,0,0,0,0,0,0,0,0,False,0
2025-01-08 13:16:00,persegiKuning,754,455,117,125,80,29,79,30,1,1,True,0.28009737650456135
2025-01-08 13:16:00,Kuning,754,455,tensor(117.4429),tensor(125.7643),73,69,68,64,5,5,True,0.0010225772857666016
2025-01-08 13:16:01,persegiBiru,743,447,124,114,152,39,156,42,4,3,True,0.10400851738981896
2025-01-08 13:16:01,Biru,743,447,tensor(124.0399),tensor(114.4269),75,68,79,69,4,1,True,0.0
2025-01-08 13:16:02,persegiKuning,763,465,122,110,75,7,78,6,3,1,True,0.4474391034670644
2025-01-08 13:16:09,persegiMerah,732,451,130,114,11,2,13,-2,2,4,True,0.23253443620132452
2025-01-08 13:16:09,Merah,732,451,tensor(130.6812),tensor(114.9790),74,67,77,71,3,4,True,0.0004994869232177734
2025-01-08 13:16:09,persegiKuning,750,459,122,118,169,42,170,41,1,1,True,0.3808099225138857
2025-01-08 13:16:22,persegiMerah,144,176,138,117,125,2,128,4,3,2,False,0.42554562161060705
2025-01-08 13:16:22,Merah,144,176,tensor(138.7064),tensor(117.2262),151,13,150,17,1,4,True,0.0
2025-01-08 13:16:22,persegiMerah,174,181,134,114,174,36,171,32,3,4,True,0.4255384851784606
2025-01-08 13:16:23,persegiMerah,198,173,125,111,113,27,114,25,1,2,False,0.13794794589436893
2025-01-08 13:16:23,persegiMerah,190,165,126,113,52,69,52,68,0,1,True,0.31325500299023656
2025-01-08 13:16:23,Fail to pick,190,165,0,0,0,0,0,0,0,0,False,0
2025-01-08 13:16:23,persegiMerah,205,174,130,114,30,24,25,19,5,5,True,0.3659709791140797
2025-01-08 13:16:23,persegiMerah,202,173,129,110,67,57,69,61,2,4,True,0.2631837695340018
2025-01-08 13:16:23,Fail to pick,202,173,0,0,0,0,0,0,0,0,False,0
2025-01-08 13:16:23,persegiMerah,186,164,121,114,173,79,171,79,2,0,True,0.20853045066397546
2025-01-08 13:16:23,persegiMerah,192,171,122,113,133,38,130,36,3,2,True,0.17380385928370892
2025-01-08 13:16:23,Fail to pick,192,171,0,0,0,0,0,0,0,0,False,0
2025-01-08 13:16:23,persegiMerah,194,170,123,112,191,22,187,23,4,1,True,0.324392307003622
2025-01-08 13:16:23,Fail to pick,194,170,0,0,0,0,0,0,0,0,False,0
2025-01-08 13:16:24,persegiMerah,184,146,119,113,104,92,105,87,1,5,True,0.3660707059805115
2025-01-08 13:16:24,Merah,184,146,tensor(119.6667),tensor(113.4256),159,17,161,17,2,0,True,0.0
2025-01-08 13:16:24,persegiMerah,217,180,132,116,150,73,150,72,0,1,False,0.4137343352299293
2025-01-08 13:16:24,persegiMerah,185,165,118,117,114,55,111,57,3,2,True,0.49787913409237095
2025-01-08 13:16:24,persegiMerah,186,168,120,116,89,0,88,1,1,1,True,0.30159213540458785
2025-01-08 13:16:24,Fail to pick,186,168,0,0,0,0,0,0,0,0,False,0
2025-01-08 13:16:24,persegiMerah,211,190,131,120,154,54,151,49,3,5,True,0.35597388973537214
2025-01-08 13:16:24,persegiMerah,181,156,120,115,122,29,117,29,5,0,True,0.2528252456181501
2025-01-08 13:16:24,persegiMerah,204,186,133,123,139,60,140,62,1,2,False,0.3637582079646591
2025-01-08 13:16:25,persegiMerah,184,162,123,116,54,22,54,23,0,1,False,0.3604529351446283
2025-01-08 13:16:25,persegiMerah,188,164,124,115,142,81,146,77,4,4,True,0.46066716571432553
2025-01-08 13:16:25,Fail to pick,188,164,0,0,0,0,0,0,0,0,False,0
2025-01-08 13:16:25,persegiMerah,185,166,122,112,150,97,152,99,2,2,True,0.4329230537568044
2025-01-08 13:16:25,Merah,185,166,tensor(122.8223),tensor(112.0659),153,17,154,16,1,1,True,0.0004999637603759766
2025-01-08 13:16:25,Fail to pick,185,166,0,0,0,0,0,0,0,0,False,0
2025-01-08 13:16:25,persegiMerah,206,182,129,119,186,48,188,45,2,3,True,0.4406092744162562
2025-01-08 13:16:25,persegiMerah,199,175,130,116,185,82,184,79,1,3,True,0.2205932803860479
2025-01-08 13:16:25,Fail to pick,199,175,0,0,0,0,0,0,0,0,False,0
2025-01-08 13:16:25,persegiMerah,179,160,127,115,65,67,65,71,0,4,True,0.3801857550877248
2025-01-08 13:16:25,persegiMerah,224,190,137,121,161,56,158,52,3,4,True,0.29936614455021504
2025-01-08 13:16:26,persegiMerah,174,158,121,115,9,76,7,74,2,2,True,0.4748003478467375
2025-01-08 13:16:26,persegiMerah,186,167,121,116,154,71,156,74,2,3,True,0.33522036666536725
2025-01-08 13:16:26,persegiMerah,186,167,121,116,134,23,135,26,1,3,True,0.3918956662241946
2025-01-08 13:16:26,Fail to pick,186,167,0,0,0,0,0,0,0,0,False,0
2025-01-08 13:16:26,persegiMerah,179,158,121,113,17,88,19,92,2,4,True,0.2760793567666381
2025-01-08 13:16:26,Merah,179,158,tensor(121.4715),tensor(113.3618),156,16,151,16,5,0,True,0.0
2025-01-08 13:16:26,Fail to pick,179,158,0,0,0,0,0,0,0,0,False,0
2025-01-08 13:16:26,persegiMerah,180,159,121,114,94,92,91,92,3,0,True,0.3071365116183966
2025-01-08 13:16:26,Fail to pick,180,159,0,0,0,0,0,0,0,0,False,0
2025-01-08 13:16:26,persegiMerah,188,168,123,115,131,33,134,36,3,3,True,0.18373155963092988
2025-01-08 13:16:26,Fail to pick,188,168,0,0,0,0,0,0,0,0,False,0
2025-01-08 13:16:26,persegiMerah,185,160,120,115,156,1,157,4,1,3,True,0.1612624985141458
2025-01-08 13:16:26,Fail to pick,185,160,0,0,0,0,0,0,0,0,False,0
2025-01-08 13:16:26,persegiMerah,217,189,133,118,175,59,176,57,1,2,True,0.47414503770138583
2025-01-08 13:16:26,persegiMerah,190,169,124,115,180,80,178,79,2,1,True,0.27014905348652307
2025-01-08 13:16:26,persegiMerah,178,159,120,116,6,78,10,74,4,4,False,0.13580194218004438
2025-01-08 13:16:27,persegiMerah,189,166,124,113,173,88,175,88,2,0,True,0.2081543024780766
2025-01-08 13:16:27,persegiMerah,221,193,140,123,77,36,75,39,2,3,True,0.1555781152298005
2025-01-08 13:16:27,persegiMerah,180,158,115,118,84,83,84,82,0,1,True,0.2928146022820214
2025-01-08 13:16:27,persegiMerah,210,187,127,123,166,73,165,73,1,0,True,0.30821351246500905
2025-01-08 13:16:27,Merah,210,187,tensor(127.3618),tensor(123.6134),148,19,151,15,3,4,True,0.0
2025-01-08 13:16:27,persegiMerah,190,165,128,117,186,39,189,36,3,3,True,0.11967108012684613
2025-01-08 13:16:27,persegiMerah,216,185,126,123,2,64,4,67,2,3,True,0.27428460291354273
2025-01-08 13:16:27,persegiMerah,181,159,117,114,194,88,197,86,3,2,True,0.28439168133933923
2025-01-08 13:16:27,persegiMerah,212,186,125,120,185,13,184,12,1,1,False,0.29051062769880787
2025-01-08 13:16:27,persegiMerah,221,175,130,116,125,1,123,3,2,2,True,0.38033926851082
2025-01-08 13:16:28,persegiMerah,219,187,135,119,67,68,69,70,2,2,True,0.22986031200074947
2025-01-08 13:16:28,persegiMerah,185,173,118,116,196,38,197,38,1,0,True,0.2572611091252399
2025-01-08 13:16:28,Merah,185,173,tensor(118.3299),tensor(116.7882),151,17,154,21,3,4,True,0.0
2025-01-08 13:16:28,persegiMerah,195,167,122,113,184,82,182,86,2,4,True,0.24053632007031076
2025-01-08 13:16:28,persegiMerah,187,167,118,116,177,62,173,64,4,2,False,0.19680614005331482
2025-01-08 13:16:28,Fail to pick,187,167,0,0,0,0,0,0,0,0,False,0
2025-01-08 13:16:28,persegiMerah,216,185,125,119,129,58,128,59,1,1,True,0.4050706195869703
2025-01-08 13:16:30,persegiMerah,202,170,126,115,112,52,114,55,2,3,True,0.39480187177074255
2025-01-08 13:16:30,Merah,202,170,tensor(126.6039),tensor(115.7347),152,18,147,17,5,1,True,0.0004994869232177734
2025-01-08 13:16:30,persegiMerah,217,188,129,117,19,61,20,61,1,0,True,0.17280141277458433
2025-01-08 13:16:30,persegiMerah,207,179,129,118,37,34,38,38,1,4,True,0.2476173635867226
2025-01-08 13:16:30,persegiMerah,211,183,123,118,18,41,14,43,4,2,True,0.32160330787284847
2025-01-08 13:16:30,Fail to pick,211,183,0,0,0,0,0,0,0,0,False,0
2025-01-08 13:16:30,persegiMerah,181,160,117,113,147,48,148,52,1,4,True,0.30889341674318566
2025-01-08 13:16:30,persegiMerah,207,183,131,118,82,20,80,15,2,5,True,0.2521750032057622
2025-01-08 13:16:30,persegiMerah,182,161,123,115,165,7,167,6,2,1,False,0.4148528738555539
2025-01-08 13:16:31,persegiMerah,182,161,123,115,160,94,155,94,5,0,True,0.44116304612661505
2025-01-08 13:16:31,Fail to pick,182,161,0,0,0,0,0,0,0,0,False,0
2025-01-08 13:16:31,persegiMerah,183,158,121,111,101,27,100,31,1,4,True,0.33311113236017476
2025-01-08 13:16:31,Fail to pick,183,158,0,0,0,0,0,0,0,0,False,0
2025-01-08 13:16:31,persegiMerah,205,184,132,112,58,92,53,95,5,3,True,0.3598417315738277
2025-01-08 13:16:31,persegiMerah,217,182,134,115,165,92,166,96,1,4,True,0.2997196051226892
2025-01-08 13:16:31,persegiMerah,205,186,133,114,102,0,103,-4,1,4,True,0.3545641031822695
2025-01-08 13:16:31,Merah,205,186,tensor(133.0105),tensor(114.4803),148,18,151,16,3,2,True,0.0004966259002685547
2025-01-08 13:16:31,persegiMerah,188,170,125,111,17,21,19,20,2,1,True,0.4080135847020929
2025-01-08 13:16:31,persegiMerah,178,161,118,112,58,2,61,-2,3,4,True,0.4130885974729416
2025-01-08 13:16:31,persegiMerah,218,190,130,118,179,33,179,34,0,1,True,0.4752144489771597
2025-01-08 13:16:31,persegiMerah,194,172,126,111,168,20,171,19,3,1,False,0.404635326021096
2025-01-08 13:16:32,persegiMerah,191,167,130,114,161,7,161,6,0,1,False,0.20427058036479467
2025-01-08 13:16:32,Fail to pick,191,167,0,0,0,0,0,0,0,0,False,0
2025-01-08 13:16:32,persegiMerah,187,165,124,112,17,72,17,67,0,5,True,0.12200919248845654
2025-01-08 13:16:32,Fail to pick,187,165,0,0,0,0,0,0,0,0,False,0
2025-01-08 13:16:32,persegiMerah,196,175,130,115,5,40,0,43,5,3,True,0.23214064006044702
2025-01-08 13:16:32,persegiMerah,171,157,126,113,143,23,142,18,1,5,True,0.4195345601064919
2025-01-08 13:16:32,persegiMerah,206,185,133,115,54,60,56,61,2,1,False,0.39662097669729024
2025-01-08 13:16:32,persegiMerah,170,156,133,115,31,63,31,58,0,5,True,0.43325176465087234
2025-01-08 13:16:32,Merah,170,156,tensor(133.6383),tensor(115.0471),156,15,160,10,4,5,True,0.0
2025-01-08 13:16:32,persegiMerah,174,158,133,111,15,91,15,95,0,4,True,0.4540694645187351
2025-01-08 13:16:32,Fail to pick,174,158,0,0,0,0,0,0,0,0,False,0
2025-01-08 13:16:32,persegiMerah,166,147,126,109,2,12,-2,9,4,3,False,0.3607577650960525
2025-01-08 13:16:32,persegiMerah,183,169,137,114,102,85,101,86,1,1,True,0.13149627814138967
2025-01-08 13:16:32,persegiMerah,161,152,126,110,71,30,74,32,3,2,False,0.3513378477811444
2025-01-08 13:16:33,persegiMerah,180,164,134,113,47,57,50,53,3,4,True,0.2216309054013207
2025-01-08 13:16:33,persegiMerah,192,171,138,113,187,99,188,95,1,4,True,0.34223017858488247
2025-01-08 13:16:33,persegiMerah,194,175,131,117,48,7,49,6,1,1,True,0.3933697955934462
2025-01-08 13:16:33,Fail to pick,194,175,0,0,0,0,0,0,0,0,False,0
2025-01-08 13:16:33,persegiMerah,217,189,134,121,21,75,23,77,2,2,True,0.17313186388942803
2025-01-08 13:16:33,persegiMerah,206,182,131,113,91,67,90,68,1,1,True,0.11889069080803819
2025-01-08 13:16:33,persegiMerah,182,167,121,112,67,91,62,90,5,1,False,0.20564862770083422
2025-01-08 13:16:33,Merah,182,167,tensor(121.5691),tensor(112.5824),153,16,148,14,5,2,True,0.0005080699920654297
2025-01-08 13:16:33,persegiMerah,210,182,124,117,120,11,115,14,5,3,True,0.3385609368336937
2025-01-08 13:16:33,persegiMerah,185,167,121,113,188,0,191,-3,3,3,True,0.4972558666368726
2025-01-08 13:16:34,persegiMerah,208,185,125,117,109,63,105,62,4,1,True,0.2086078038640126
2025-01-08 13:16:34,persegiMerah,212,189,126,115,119,96,117,94,2,2,False,0.23214398165679517
2025-01-08 13:16:34,Fail to pick,212,189,0,0,0,0,0,0,0,0,False,0
2025-01-08 13:16:34,persegiMerah,211,182,131,115,70,77,72,77,2,0,True,0.2739624395234331
2025-01-08 13:16:34,Fail to pick,211,182,0,0,0,0,0,0,0,0,False,0
2025-01-08 13:16:34,persegiMerah,219,190,131,117,192,99,190,96,2,3,True,0.11838511740145226
2025-01-08 13:16:34,Fail to pick,219,190,0,0,0,0,0,0,0,0,False,0
2025-01-08 13:16:34,persegiMerah,175,164,117,116,46,26,45,28,1,2,True,0.41426078013499523
2025-01-08 13:16:34,persegiMerah,181,160,119,116,14,1,11,2,3,1,True,0.1737994414391657
2025-01-08 13:16:34,Fail to pick,181,160,0,0,0,0,0,0,0,0,False,0
2025-01-08 13:16:34,persegiMerah,187,167,121,115,166,72,167,73,1,1,True,0.23885200835817508
2025-01-08 13:16:34,Merah,187,167,tensor(121.8443),tensor(115.0231),153,17,149,12,4,5,True,0.0005044937133789062
2025-01-08 13:16:34,Fail to pick,187,167,0,0,0,0,0,0,0,0,False,0
2025-01-08 13:16:34,persegiMerah,218,188,131,117,53,12,51,10,2,2,True,0.3665891363815498
2025-01-08 13:16:34,persegiMerah,190,169,122,115,101,19,97,18,4,1,False,0.23380577481482367
2025-01-08 13:16:34,persegiMerah,212,184,123,119,118,89,119,92,1,3,True,0.49383130538799636
2025-01-08 13:16:35,persegiMerah,199,174,123,115,130,63,130,58,0,5,True,0.391923454585284
2025-01-08 13:16:35,persegiMerah,191,172,127,115,9,0,7,-1,2,1,True,0.45521284535882767
2025-01-08 13:16:35,Fail to pick,191,172,0,0,0,0,0,0,0,0,False,0
2025-01-08 13:16:35,persegiMerah,191,169,120,115,191,45,193,47,2,2,True,0.1272541000691225
2025-01-08 13:16:35,Fail to pick,191,169,0,0,0,0,0,0,0,0,False,0
2025-01-08 13:16:35,persegiMerah,192,169,120,114,81,10,85,9,4,1,True,0.3980852934396416
2025-01-08 13:16:35,Fail to pick,192,169,0,0,0,0,0,0,0,0,False,0
2025-01-08 13:16:35,persegiMerah,189,168,117,117,153,39,149,39,4,0,True,0.3503259064904646
2025-01-08 13:16:35,Fail to pick,189,168,0,0,0,0,0,0,0,0,False,0
2025-01-08 13:16:35,persegiMerah,173,165,122,116,95,52,99,53,4,1,True,0.45341172870502977
2025-01-08 13:16:35,persegiMerah,186,169,123,116,121,65,122,68,1,3,True,0.46447252055350785
2025-01-08 13:16:35,Merah,186,169,tensor(123.0102),tensor(116.0272),153,17,151,18,2,1,True,0.000499725341796875
2025-01-08 13:16:35,persegiMerah,196,172,123,113,101,10,99,5,2,5,True,0.257222769843627
2025-01-08 13:16:35,persegiMerah,207,181,125,113,7,37,2,33,5,4,True,0.39325650153250546
2025-01-08 13:16:37,persegiMerah,181,144,115,110,23,2,21,3,2,1,True,0.30331728404216673
2025-01-08 13:16:37,Merah,181,144,tensor(115.1204),tensor(110.5109),160,16,164,19,4,3,True,0.0005075931549072266
2025-01-08 13:16:37,persegiMerah,184,164,115,114,112,19,110,20,2,1,True,0.18147271556219768
2025-01-08 13:16:38,persegiMerah,223,192,128,114,16,22,15,21,1,1,True,0.24269681126625656
2025-01-08 13:16:38,persegiMerah,180,158,112,109,37,91,36,86,1,5,True,0.21778530827944
2025-01-08 13:16:38,persegiMerah,223,190,128,115,12,67,10,63,2,4,True,0.1065288213149024
2025-01-08 13:16:38,persegiMerah,179,164,114,112,181,71,180,69,1,2,True,0.23782406792193106
2025-01-08 13:16:38,persegiMerah,218,189,124,115,125,11,121,7,4,4,True,0.49892676813362924
2025-01-08 13:16:38,persegiMerah,208,182,123,111,94,83,97,82,3,1,True,0.476427374103924
2025-01-08 13:16:38,persegiMerah,212,184,123,111,171,13,173,12,2,1,True,0.45701707993560403
2025-01-08 13:16:38,Fail to pick,212,184,0,0,0,0,0,0,0,0,False,0
2025-01-08 13:16:38,persegiMerah,209,186,121,116,95,81,97,84,2,3,True,0.13762397163026532
2025-01-08 13:16:38,Fail to pick,209,186,0,0,0,0,0,0,0,0,False,0
2025-01-08 13:16:38,persegiMerah,191,167,120,112,74,22,69,19,5,3,True,0.4872181280771223
2025-01-08 13:16:38,Merah,191,167,tensor(120.4445),tensor(112.1337),153,17,150,18,3,1,True,0.0
2025-01-08 13:16:38,persegiMerah,182,160,114,110,1,12,0,15,1,3,True,0.23416764125473732
2025-01-08 13:16:39,Fail to pick,182,160,0,0,0,0,0,0,0,0,False,0
2025-01-08 13:16:39,persegiMerah,225,194,131,115,38,46,40,50,2,4,True,0.12442474684070551
2025-01-08 13:16:39,persegiMerah,210,188,125,115,137,25,136,27,1,2,False,0.21926602535066017
2025-01-08 13:16:39,persegiMerah,220,189,127,116,107,64,104,63,3,1,True,0.28020015766947826
2025-01-08 13:16:39,persegiMerah,220,191,131,116,74,74,72,69,2,5,False,0.14829174772575182
2025-01-08 13:16:39,Fail to pick,220,191,0,0,0,0,0,0,0,0,False,0
2025-01-08 13:16:39,persegiMerah,206,185,129,114,49,70,51,65,2,5,True,0.4805883862316066
2025-01-08 13:16:39,persegiMerah,222,191,133,115,139,22,142,24,3,2,True,0.13774805894872677
2025-01-08 13:16:39,persegiMerah,208,181,130,115,81,83,84,78,3,5,True,0.31270907872344816
2025-01-08 13:16:39,persegiMerah,221,194,132,114,147,85,146,84,1,1,True,0.14420437752488585
2025-01-08 13:16:39,persegiMerah,211,182,127,113,187,52,185,56,2,4,True,0.459987886979096
2025-01-08 13:16:39,Merah,211,182,tensor(127.4456),tensor(113.6163),149,19,144,14,5,5,True,0.0004963874816894531
2025-01-08 13:16:40,persegiMerah,220,191,129,113,86,35,81,37,5,2,True,0.136093182917515
2025-01-08 13:16:40,Fail to pick,220,191,0,0,0,0,0,0,0,0,False,0
2025-01-08 13:16:40,persegiMerah,187,170,120,110,123,97,119,95,4,2,True,0.4918808474703854
2025-01-08 13:16:40,persegiMerah,218,190,132,115,124,98,120,102,4,4,True,0.45005970540589557
2025-01-08 13:16:40,persegiMerah,210,178,128,113,52,55,52,54,0,1,True,0.13455936259412146
2025-01-08 13:16:40,persegiMerah,175,160,120,113,69,82,64,83,5,1,True,0.2893776428392564
2025-01-08 13:16:40,persegiMerah,223,192,131,119,126,33,130,32,4,1,False,0.3522470187232466
2025-01-08 13:16:40,persegiMerah,184,162,119,111,143,58,143,57,0,1,True,0.27820169744807965
2025-01-08 13:16:40,persegiMerah,221,193,131,114,71,2,72,-2,1,4,True,0.4306554436955712
2025-01-08 13:16:40,persegiMerah,225,194,132,114,133,74,133,76,0,2,True,0.22259116078943203
2025-01-08 13:16:40,Fail to pick,225,194,0,0,0,0,0,0,0,0,False,0
2025-01-08 13:16:41,persegiMerah,185,161,122,113,12,76,13,73,1,3,True,0.30302884373447486
2025-01-08 13:16:41,Merah,185,161,tensor(122.3261),tensor(113.0918),155,17,151,21,4,4,True,0.0
2025-01-08 13:16:41,persegiMerah,182,161,119,110,54,96,55,92,1,4,True,0.4938472304314986
2025-01-08 13:16:41,Fail to pick,182,161,0,0,0,0,0,0,0,0,False,0
2025-01-08 13:16:41,persegiMerah,188,168,119,111,85,20,82,16,3,4,True,0.10922363054623446
2025-01-08 13:16:41,Fail to pick,188,168,0,0,0,0,0,0,0,0,False,0
2025-01-08 13:16:41,persegiMerah,185,163,117,111,106,86,110,89,4,3,True,0.26787825451294794
2025-01-08 13:16:41,Fail to pick,185,163,0,0,0,0,0,0,0,0,False,0
2025-01-08 13:16:41,persegiMerah,220,189,128,117,29,31,29,30,0,1,True,0.3018476462087856
2025-01-08 13:16:42,persegiMerah,219,193,131,114,70,48,69,46,1,2,True,0.25163154859355163
2025-01-08 13:16:42,Fail to pick,219,193,0,0,0,0,0,0,0,0,False,0
2025-01-08 13:16:42,persegiMerah,226,190,134,114,75,67,74,62,1,5,True,0.15747208378193706
2025-01-08 13:16:42,Merah,226,190,tensor(134.0083),tensor(114.8718),147,20,145,20,2,0,True,0.0
2025-01-08 13:16:42,Fail to pick,226,190,0,0,0,0,0,0,0,0,False,0
2025-01-08 13:16:42,persegiMerah,214,190,126,116,145,20,146,15,1,5,True,0.44450044518368903
2025-01-08 13:16:42,persegiMerah,214,188,125,116,34,56,29,55,5,1,True,0.15637688350815832
2025-01-08 13:16:42,Fail to pick,214,188,0,0,0,0,0,0,0,0,False,0
2025-01-08 13:16:42,persegiMerah,188,165,119,113,45,52,41,49,4,3,True,0.30936968611747045
2025-01-08 13:16:44,persegiMerah,205,180,135,115,142,15,138,16,4,1,True,0.2457815393177748
2025-01-08 13:16:44,Merah,205,180,tensor(135.9841),tensor(115.7271),150,18,151,21,1,3,True,0.0
2025-01-08 13:16:44,persegiMerah,162,152,118,109,140,46,143,42,3,4,True,0.49047611589221896
2025-01-08 13:16:44,persegiMerah,169,157,129,108,154,54,150,57,4,3,True,0.4064768661736957
2025-01-08 13:16:44,Fail to pick,169,157,0,0,0,0,0,0,0,0,False,0
2025-01-08 13:16:44,persegiMerah,183,183,135,114,197,86,197,86,0,0,True,0.16458653185624553
2025-01-08 13:16:44,persegiMerah,194,178,139,112,46,34,42,33,4,1,True,0.3190913368752928
2025-01-08 13:16:44,persegiMerah,176,167,130,110,108,62,108,62,0,0,True,0.3398491218152516
2025-01-08 13:16:44,persegiMerah,149,152,128,107,26,70,29,69,3,1,True,0.40307633978378343
2025-01-08 13:16:44,persegiMerah,151,151,130,111,73,85,75,89,2,4,True,0.22232999162049571
2025-01-08 13:16:44,Fail to pick,151,151,0,0,0,0,0,0,0,0,False,0
2025-01-08 13:16:44,persegiMerah,189,175,140,112,20,55,24,51,4,4,True,0.21553473638809045
2025-01-08 13:16:44,persegiMerah,181,168,136,111,116,33,119,37,3,4,True,0.2908949165119908
2025-01-08 13:16:44,Fail to pick,181,168,0,0,0,0,0,0,0,0,False,0
2025-01-08 13:16:45,persegiMerah,171,163,131,113,4,26,1,25,3,1,True,0.4559940613680461
2025-01-08 13:16:45,Merah,171,163,tensor(131.5564),tensor(113.1145),154,15,154,15,0,0,True,0.0004987716674804688
2025-01-08 13:16:45,persegiMerah,134,149,120,110,187,13,186,10,1,3,True,0.21925582472094993
2025-01-08 13:16:45,persegiMerah,167,170,134,111,177,69,172,66,5,3,True,0.13215278039838566
2025-01-08 13:16:45,persegiMerah,142,153,127,109,163,29,164,24,1,5,True,0.23170143273709282
2025-01-08 13:16:45,persegiMerah,131,150,121,109,63,12,63,10,0,2,True,0.31889965145059557
2025-01-08 13:16:45,persegiMerah,167,167,141,108,86,94,84,89,2,5,True,0.3206445469128558
2025-01-08 13:16:45,persegiMerah,134,141,122,106,162,35,157,31,5,4,True,0.43249590154634465
2025-01-08 13:17:06,persegiMerah,845,546,135,128,138,67,135,70,3,3,True,0.49056746346574454
2025-01-08 13:17:06,Merah,845,546,tensor(135.8219),tensor(128.5872),48,78,49,77,1,1,True,0.0
2025-01-08 13:17:06,persegiMerah,841,558,130,129,48,59,45,61,3,2,True,0.3851180045272675
2025-01-08 13:17:07,persegiMerah,845,551,130,126,187,10,183,7,4,3,True,0.30196852325296
2025-01-08 13:17:07,Fail to pick,845,551,0,0,0,0,0,0,0,0,False,0
2025-01-08 13:17:07,persegiMerah,842,573,136,125,89,15,91,17,2,2,True,0.2495041904642933
2025-01-08 13:17:07,persegiMerah,849,555,127,123,27,96,22,93,5,3,True,0.22331626368879354
2025-01-08 13:17:07,persegiMerah,869,576,138,120,193,64,190,63,3,1,True,0.49041767468818764
2025-01-08 13:17:07,persegiMerah,864,566,135,122,41,65,39,67,2,2,True,0.2541362174043265
2025-01-08 13:17:07,persegiMerah,846,552,138,123,170,46,171,44,1,2,False,0.25264425347763325
2025-01-08 13:17:07,persegiMerah,868,573,137,127,131,5,130,9,1,4,True,0.29738467094692417
2025-01-08 13:17:07,Merah,868,573,tensor(137.8407),tensor(127.4680),40,80,40,83,0,3,True,0.0
2025-01-08 13:17:07,persegiMerah,857,561,135,131,10,97,11,100,1,3,True,0.15548562329470436
2025-01-08 13:17:08,persegiMerah,861,555,132,123,4,54,4,51,0,3,True,0.3880270967252043
2025-01-08 13:17:08,Fail to pick,861,555,0,0,0,0,0,0,0,0,False,0
2025-01-08 13:17:08,persegiMerah,865,561,134,125,25,26,29,23,4,3,True,0.11208037738716757
2025-01-08 13:17:08,Fail to pick,865,561,0,0,0,0,0,0,0,0,False,0
2025-01-08 13:17:08,persegiMerah,843,572,140,128,164,98,164,96,0,2,True,0.12411247758099374
2025-01-08 13:17:08,persegiMerah,849,568,142,130,33,14,37,13,4,1,True,0.244049200400406
2025-01-08 13:17:08,Fail to pick,849,568,0,0,0,0,0,0,0,0,False,0
2025-01-08 13:17:08,persegiMerah,868,555,131,121,81,39,84,39,3,0,True,0.20485103089567175
2025-01-08 13:17:08,persegiMerah,853,565,142,131,22,51,23,52,1,1,True,0.30339470719379397
2025-01-08 13:17:08,persegiMerah,843,574,141,130,25,39,21,37,4,2,True,0.31277758002906536
2025-01-08 13:17:08,Merah,843,574,tensor(141.1905),tensor(130.5121),40,78,35,73,5,5,True,0.0004978179931640625
2025-01-08 13:17:09,persegiMerah,858,556,141,122,126,51,129,53,3,2,True,0.2687808583895296
2025-01-08 13:17:15,persegiMerah,861,571,137,127,128,89,126,89,2,0,True,0.43246844106311577
2025-01-08 13:17:15,persegiMerah,865,562,143,125,161,82,161,86,0,4,True,0.4282069057619764
2025-01-08 13:17:15,Merah,865,562,tensor(143.3940),tensor(125.5793),43,80,39,83,4,3,True,0.0
2025-01-08 13:17:15,Fail to pick,865,562,0,0,0,0,0,0,0,0,False,0
2025-01-08 13:17:15,persegiMerah,860,560,135,126,63,67,63,68,0,1,True,0.3499583874305861
2025-01-08 13:17:15,Fail to pick,860,560,0,0,0,0,0,0,0,0,False,0
2025-01-08 13:17:15,persegiMerah,863,552,138,125,25,45,20,40,5,5,True,0.3250608756579615
2025-01-08 13:17:15,Fail to pick,863,552,0,0,0,0,0,0,0,0,False,0
2025-01-08 13:17:16,persegiMerah,864,560,137,126,175,7,177,11,2,4,True,0.3544562456144952
2025-01-08 13:17:16,Fail to pick,864,560,0,0,0,0,0,0,0,0,False,0
2025-01-08 13:17:16,persegiMerah,860,579,140,127,67,0,65,0,2,0,True,0.14470438430968052
2025-01-08 13:17:16,persegiMerah,867,564,131,126,141,73,144,71,3,2,True,0.28228246275131075
2025-01-08 13:17:16,persegiMerah,865,557,141,127,143,91,147,88,4,3,True,0.49824572680509294
2025-01-08 13:17:16,Fail to pick,865,557,0,0,0,0,0,0,0,0,False,0
2025-01-08 13:17:16,persegiMerah,887,547,123,120,181,25,185,26,4,1,True,0.4372686860947611
2025-01-08 13:17:16,persegiMerah,860,568,139,133,127,25,126,22,1,3,True,0.27669234894303696
2025-01-08 13:17:16,persegiMerah,851,567,133,132,135,35,135,34,0,1,False,0.3213624626845303
2025-01-08 13:17:16,Merah,851,567,tensor(133.7863),tensor(132.7192),42,78,38,77,4,1,True,0.0
2025-01-08 13:17:16,Fail to pick,851,567,0,0,0,0,0,0,0,0,False,0
2025-01-08 13:17:16,persegiMerah,857,560,133,126,70,68,67,70,3,2,True,0.3040821133643522
2025-01-08 13:17:16,Fail to pick,857,560,0,0,0,0,0,0,0,0,False,0
2025-01-08 13:17:17,persegiMerah,855,560,134,124,27,7,28,3,1,4,True,0.1517409539317205
2025-01-08 13:17:17,Fail to pick,855,560,0,0,0,0,0,0,0,0,False,0
2025-01-08 13:17:17,persegiMerah,852,555,135,124,38,11,42,8,4,3,True,0.14728247272115094
2025-01-08 13:17:17,Fail to pick,852,555,0,0,0,0,0,0,0,0,False,0
2025-01-08 13:17:17,persegiMerah,861,547,125,127,17,29,21,32,4,3,True,0.4396472741045713
2025-01-08 13:17:17,Fail to pick,861,547,0,0,0,0,0,0,0,0,False,0
2025-01-08 13:17:17,persegiMerah,860,541,130,128,134,24,132,21,2,3,True,0.3002841459476594
2025-01-08 13:17:17,Fail to pick,860,541,0,0,0,0,0,0,0,0,False,0
2025-01-08 13:17:17,persegiMerah,856,563,130,129,125,82,129,77,4,5,False,0.2112468806290697
2025-01-08 13:17:17,persegiMerah,860,552,132,126,92,59,94,61,2,2,False,0.4694326271905557
2025-01-08 13:17:17,Merah,860,552,tensor(132.4084),tensor(126.6609),46,79,49,76,3,3,True,0.0005047321319580078
2025-01-08 13:17:18,persegiMerah,865,552,132,127,57,5,60,3,3,2,True,0.4611931446474117
2025-01-08 13:17:18,Fail to pick,865,552,0,0,0,0,0,0,0,0,False,0
2025-01-08 13:17:18,persegiMerah,867,553,132,126,13,23,13,24,0,1,True,0.29154827752823553
2025-01-08 13:17:18,Fail to pick,867,553,0,0,0,0,0,0,0,0,False,0
2025-01-08 13:17:18,persegiMerah,840,570,135,133,166,73,167,77,1,4,True,0.27577507668819246
2025-01-08 13:17:18,persegiMerah,857,568,127,134,157,98,154,95,3,3,True,0.13018953141193115
2025-01-08 13:17:18,persegiMerah,863,565,129,122,130,46,131,46,1,0,True,0.37315592407439013
2025-01-08 13:17:18,Fail to pick,863,565,0,0,0,0,0,0,0,0,False,0
2025-01-08 13:17:18,persegiMerah,857,557,126,122,7,77,2,79,5,2,True,0.10511584976238933
2025-01-08 13:17:18,Fail to pick,857,557,0,0,0,0,0,0,0,0,False,0
2025-01-08 13:17:18,persegiMerah,844,563,139,135,29,67,32,63,3,4,True,0.493499444389108
2025-01-08 13:17:18,persegiMerah,844,576,128,130,134,71,136,74,2,3,False,0.316256723023842
2025-01-08 13:17:18,Merah,844,576,tensor(128.8411),tensor(130.3785),40,78,39,82,1,4,True,0.0004990100860595703
2025-01-08 13:17:19,persegiMerah,849,571,132,133,34,21,29,25,5,4,True,0.3520283074887217
2025-01-08 13:17:19,Fail to pick,849,571,0,0,0,0,0,0,0,0,False,0
2025-01-08 13:17:19,persegiMerah,854,570,123,130,143,38,147,33,4,5,True,0.25907407189809184
2025-01-08 13:17:19,Fail to pick,854,570,0,0,0,0,0,0,0,0,False,0
2025-01-08 13:17:19,persegiMerah,843,566,134,132,13,29,15,25,2,4,True,0.41156313708480574
2025-01-08 13:17:19,persegiMerah,847,576,134,129,55,26,55,29,0,3,True,0.1784045832270294
2025-01-08 13:17:19,persegiMerah,882,549,124,126,84,75,83,70,1,5,True,0.2831617964044433
2025-01-08 13:17:19,persegiMerah,858,564,124,130,96,35,97,30,1,5,True,0.41775355608440123
2025-01-08 13:17:19,persegiMerah,851,569,127,130,69,83,69,83,0,0,True,0.4901613665159914
2025-01-08 13:17:19,Merah,851,569,tensor(127.4303),tensor(130.5972),41,78,45,75,4,3,True,0.0
2025-01-08 13:17:19,Fail to pick,851,569,0,0,0,0,0,0,0,0,False,0
2025-01-08 13:17:20,persegiMerah,869,542,125,129,92,62,92,63,0,1,True,0.13062587685811122
2025-01-08 13:17:20,persegiMerah,863,552,133,128,73,4,75,1,2,3,True,0.36399387302151975
2025-01-08 13:17:20,persegiMerah,871,554,132,125,99,53,95,49,4,4,True,0.1709357485988915
2025-01-08 13:17:20,Fail to pick,871,554,0,0,0,0,0,0,0,0,False,0
2025-01-08 13:17:20,persegiMerah,845,570,137,133,137,83,141,83,4,0,True,0.36764609235021894
2025-01-08 13:17:20,persegiMerah,862,555,134,130,11,96,13,91,2,5,True,0.12129185900849651
2025-01-08 13:17:20,persegiMerah,865,564,133,132,89,84,92,86,3,2,True,0.23218633115916695
2025-01-08 13:17:20,Merah,865,564,tensor(133.7278),tensor(132.5392),43,80,47,79,4,1,True,0.00043201446533203125
2025-01-08 13:17:20,Fail to pick,865,564,0,0,0,0,0,0,0,0,False,0
2025-01-08 13:17:21,persegiMerah,871,584,139,131,11,72,10,68,1,4,False,0.4711193570811939
2025-01-08 13:17:21,persegiMerah,861,571,132,128,40,47,40,42,0,5,True,0.3207702598652782
2025-01-08 13:17:21,persegiMerah,847,562,138,133,137,2,134,0,3,2,True,0.1870024532707043
2025-01-08 13:17:21,persegiMerah,851,575,139,130,143,59,143,58,0,1,True,0.21883255921376785
2025-01-08 13:17:21,persegiMerah,869,579,138,129,139,92,138,92,1,0,True,0.1833888172678233
2025-01-08 13:17:22,persegiMerah,874,556,136,121,71,18,66,14,5,4,True,0.13610192134716598
2025-01-08 13:17:22,Merah,874,556,tensor(136.1284),tensor(121.0207),45,80,42,76,3,4,True,0.0
2025-01-08 13:17:22,persegiMerah,870,555,143,127,118,78,113,81,5,3,True,0.26151729131961277
2025-01-08 13:17:22,Fail to pick,870,555,0,0,0,0,0,0,0,0,False,0
2025-01-08 13:17:22,persegiMerah,858,579,135,129,16,94,16,94,0,0,True,0.3030914085808845
2025-01-08 13:17:22,persegiMerah,875,562,138,126,191,98,190,99,1,1,True,0.19097160946557992
2025-01-08 13:17:22,persegiMerah,860,566,136,133,107,3,111,4,4,1,False,0.4511830529072234
2025-01-08 13:17:22,persegiMerah,852,575,135,130,108,42,106,45,2,3,True,0.4345522442886871
2025-01-08 13:17:22,Fail to pick,852,575,0,0,0,0,0,0,0,0,False,0
2025-01-08 13:17:22,persegiMerah,859,579,132,132,99,79,101,79,2,0,True,0.16846014984663377
2025-01-08 13:17:22,Fail to pick,859,579,0,0,0,0,0,0,0,0,False,0
2025-01-08 13:17:22,persegiMerah,861,576,135,130,126,43,124,45,2,2,True,0.31329378725343515
2025-01-08 13:17:22,Fail to pick,861,576,0,0,0,0,0,0,0,0,False,0
2025-01-08 13:17:23,persegiMerah,870,569,127,132,144,95,148,95,4,0,True,0.3156952991518105
2025-01-08 13:17:23,Fail to pick,870,569,0,0,0,0,0,0,0,0,False,0
2025-01-08 13:19:24,persegiMerah,874,574,125,131,190,87,188,89,2,2,True,0.2909256169371607
2025-01-08 13:19:24,Merah,874,574,tensor(125.6543),tensor(131.8075),40,80,42,81,2,1,True,0.0004990100860595703
2025-01-08 13:19:25,persegiMerah,887,551,120,127,180,17,181,18,1,1,True,0.12223429435392648
2025-01-08 13:19:25,persegiMerah,888,567,117,126,16,75,13,75,3,0,True,0.3968060328035157
2025-01-08 13:19:26,persegiMerah,885,580,120,127,80,12,78,15,2,3,True,0.22967942985291714
2025-01-08 13:19:26,Merah,885,580,tensor(120.6248),tensor(127.8218),38,81,33,79,5,2,True,0.0
2025-01-08 13:19:26,persegiMerah,883,577,131,127,25,66,22,66,3,0,True,0.4585971166369843
2025-01-08 13:19:26,Fail to pick,883,577,0,0,0,0,0,0,0,0,False,0
2025-01-08 13:19:26,persegiMerah,899,572,120,122,31,12,33,10,2,2,False,0.12295628050991235
2025-01-08 13:19:26,persegiMerah,901,563,119,123,22,42,24,41,2,1,True,0.3513495110821392
2025-01-08 13:19:26,Fail to pick,901,563,0,0,0,0,0,0,0,0,False,0
2025-01-08 13:19:26,persegiMerah,898,568,123,132,29,83,25,83,4,0,True,0.354053574503537
2025-01-08 13:19:26,Fail to pick,898,568,0,0,0,0,0,0,0,0,False,0
2025-01-08 13:19:26,persegiMerah,898,565,120,126,49,32,46,35,3,3,False,0.3266565405696683
2025-01-08 13:19:26,Fail to pick,898,565,0,0,0,0,0,0,0,0,False,0
2025-01-08 13:19:26,persegiMerah,895,560,119,125,2,16,1,11,1,5,True,0.4786699308921788
2025-01-08 13:19:26,Fail to pick,895,560,0,0,0,0,0,0,0,0,False,0
2025-01-08 13:19:27,persegiMerah,886,563,127,132,156,58,154,53,2,5,True,0.35459416035559943
2025-01-08 13:19:27,Merah,886,563,tensor(127.4166),tensor(132.9982),43,82,44,80,1,2,True,0.0004944801330566406
2025-01-08 13:19:27,Fail to pick,886,563,0,0,0,0,0,0,0,0,False,0
2025-01-08 13:19:34,persegiMerah,875,572,129,128,97,57,101,53,4,4,True,0.29177621956282607
2025-01-08 13:19:34,Merah,875,572,tensor(129.7748),tensor(128.4894),41,81,41,76,0,5,True,0.0
2025-01-08 13:19:34,persegiMerah,885,561,122,126,150,92,148,91,2,1,True,0.19380373221237313
2025-01-08 13:19:34,persegiMerah,874,570,118,131,140,0,138,3,2,3,True,0.26708158706739715
2025-01-08 13:19:34,persegiMerah,880,569,125,134,91,10,90,7,1,3,True,0.48943629631146446
2025-01-08 13:19:34,Fail to pick,880,569,0,0,0,0,0,0,0,0,False,0
2025-01-08 13:19:34,persegiMerah,885,556,127,125,169,10,167,11,2,1,True,0.41534097559866123
2025-01-08 13:19:34,persegiMerah,885,557,136,132,95,56,91,59,4,3,True,0.24721287710664278
2025-01-08 13:19:34,Fail to pick,885,557,0,0,0,0,0,0,0,0,False,0
2025-01-08 13:19:34,persegiMerah,883,563,127,135,5,26,0,23,5,3,True,0.4828210154382361
2025-01-08 13:19:34,Fail to pick,883,563,0,0,0,0,0,0,0,0,False,0
2025-01-08 13:19:35,persegiMerah,893,563,137,128,146,30,148,32,2,2,True,0.24681836774488303
2025-01-08 13:19:35,Merah,893,563,tensor(137.7166),tensor(128.8688),43,82,42,78,1,4,True,0.0004975795745849609
2025-01-08 13:19:37,persegiMerah,196,357,121,135,21,90,23,92,2,2,True,0.3270736414205213
2025-01-08 13:19:37,Merah,196,357,tensor(121.0937),tensor(135.5525),100,18,96,17,4,1,True,0.0005056858062744141
2025-01-08 13:19:37,persegiMerah,194,353,120,134,103,18,107,16,4,2,True,0.24114121355370136
2025-01-08 13:19:37,Fail to pick,194,353,0,0,0,0,0,0,0,0,False,0
2025-01-08 13:19:38,persegiMerah,205,350,128,134,160,74,161,69,1,5,True,0.10059928606443674
2025-01-08 13:19:38,persegiMerah,193,353,124,135,45,64,48,67,3,3,False,0.26397813173687834
2025-01-08 13:19:38,persegiMerah,197,361,122,135,176,8,180,9,4,1,True,0.15923308956579618
2025-01-08 13:19:38,Fail to pick,197,361,0,0,0,0,0,0,0,0,False,0
2025-01-08 13:19:38,persegiMerah,195,356,126,140,100,3,102,2,2,1,True,0.28457264317891623
2025-01-08 13:19:38,Fail to pick,195,356,0,0,0,0,0,0,0,0,False,0
2025-01-08 13:19:38,persegiMerah,199,350,129,134,153,94,152,92,1,2,True,0.2608830742038411
2025-01-08 13:19:38,Fail to pick,199,350,0,0,0,0,0,0,0,0,False,0
2025-01-08 13:19:38,persegiMerah,198,354,125,135,114,81,117,81,3,0,True,0.2802512798509491
2025-01-08 13:19:38,Fail to pick,198,354,0,0,0,0,0,0,0,0,False,0
2025-01-08 13:19:38,persegiMerah,195,352,125,138,27,32,29,33,2,1,True,0.4801253822113831
2025-01-08 13:19:38,Merah,195,352,tensor(125.8846),tensor(138.1452),102,18,106,17,4,1,True,0.0004999637603759766
2025-01-08 13:19:38,Fail to pick,195,352,0,0,0,0,0,0,0,0,False,0
2025-01-08 13:19:39,persegiMerah,199,351,127,137,67,4,62,0,5,4,True,0.31116209172694853
2025-01-08 13:19:39,Fail to pick,199,351,0,0,0,0,0,0,0,0,False,0
2025-01-08 13:19:39,persegiMerah,200,349,126,136,145,28,140,30,5,2,True,0.2833528854274985
2025-01-08 13:19:39,Fail to pick,200,349,0,0,0,0,0,0,0,0,False,0
2025-01-08 13:19:39,persegiMerah,197,357,123,132,154,23,153,21,1,2,True,0.4216838640419919
2025-01-08 13:19:39,Fail to pick,197,357,0,0,0,0,0,0,0,0,False,0
2025-01-08 13:19:39,persegiMerah,198,351,122,134,5,10,4,7,1,3,True,0.11803225514375618
2025-01-08 13:19:39,Fail to pick,198,351,0,0,0,0,0,0,0,0,False,0
2025-01-08 13:19:39,persegiMerah,193,361,122,133,77,85,77,88,0,3,True,0.12045283762132937
2025-01-08 13:19:39,Merah,193,361,tensor(122.2801),tensor(133.5182),99,17,95,13,4,4,True,0.0
2025-01-08 13:19:40,persegiMerah,199,354,126,137,85,8,84,7,1,1,True,0.38004836421614274
2025-01-08 13:19:40,Fail to pick,199,354,0,0,0,0,0,0,0,0,False,0
2025-01-08 13:19:40,persegiMerah,207,358,125,130,127,37,131,38,4,1,True,0.2143951619037434
2025-01-08 13:19:40,Fail to pick,207,358,0,0,0,0,0,0,0,0,False,0
2025-01-08 13:19:40,persegiMerah,204,352,128,129,197,82,200,81,3,1,True,0.47368968295202696
2025-01-08 13:19:40,Fail to pick,204,352,0,0,0,0,0,0,0,0,False,0
2025-01-08 13:19:48,persegiMerah,232,344,129,128,149,30,151,26,2,4,True,0.4981843475155935
2025-01-08 13:19:48,Merah,232,344,tensor(129.7611),tensor(128.4612),104,21,108,24,4,3,True,0.0004985332489013672
2025-01-08 13:19:48,persegiMerah,192,354,131,129,95,31,92,30,3,1,True,0.23705451500543662
2025-01-08 13:19:48,persegiMerah,216,346,126,132,149,53,153,51,4,2,True,0.38649025228530154
2025-01-08 13:19:49,persegiMerah,180,353,130,129,135,39,134,36,1,3,True,0.384677251619681
2025-01-08 13:19:49,Merah,180,353,tensor(130.2203),tensor(129.9789),101,16,105,13,4,3,True,0.0
2025-01-08 13:19:49,persegiMerah,187,350,140,130,69,32,65,30,4,2,True,0.14300265423766567
2025-01-08 13:19:49,Fail to pick,187,350,0,0,0,0,0,0,0,0,False,0
2025-01-08 13:19:50,persegiMerah,191,344,129,129,137,70,139,71,2,1,True,0.399092252504734
2025-01-08 13:19:50,Fail to pick,191,344,0,0,0,0,0,0,0,0,False,0
2025-01-08 13:19:50,persegiMerah,183,346,127,130,124,93,127,95,3,2,False,0.18229018012690024
2025-01-08 13:19:50,Fail to pick,183,346,0,0,0,0,0,0,0,0,False,0
2025-01-08 13:19:50,persegiMerah,171,351,133,132,190,71,192,69,2,2,False,0.4909272115719314
2025-01-08 13:19:50,Merah,171,351,tensor(133.8605),tensor(132.6771),102,15,105,14,3,1,True,0.0
2025-01-08 13:19:50,persegiMerah,178,349,133,130,171,41,172,45,1,4,True,0.26109038298106496
2025-01-08 13:19:50,Fail to pick,178,349,0,0,0,0,0,0,0,0,False,0
2025-01-08 13:19:50,persegiMerah,203,337,127,127,3,31,6,31,3,0,True,0.19070494457752357
2025-01-08 13:19:51,persegiMerah,196,342,128,131,3,95,6,95,3,0,True,0.11272846271918464
2025-01-08 13:19:51,Fail to pick,196,342,0,0,0,0,0,0,0,0,False,0
2025-01-08 13:19:51,persegiMerah,193,343,128,130,162,50,162,50,0,0,True,0.1752665702749169
2025-01-08 13:19:51,Fail to pick,193,343,0,0,0,0,0,0,0,0,False,0
2025-01-08 13:19:51,persegiMerah,206,337,117,126,177,45,172,40,5,5,True,0.3817107650436926
2025-01-08 13:19:51,Merah,206,337,tensor(117.8223),tensor(126.0786),106,19,110,17,4,2,True,0.0
2025-01-08 13:19:51,persegiMerah,209,333,123,126,121,96,123,98,2,2,True,0.3881176973978938
2025-01-08 13:19:51,Fail to pick,209,333,0,0,0,0,0,0,0,0,False,0
2025-01-08 13:19:53,persegiMerah,179,346,133,131,16,13,19,9,3,4,False,0.14145539748871233
2025-01-08 13:19:53,Merah,179,346,tensor(133.7372),tensor(131.9440),103,16,103,14,0,2,True,0.0
2025-01-08 13:20:02,persegiMerah,220,318,127,130,107,27,109,25,2,2,True,0.10683019881353006
2025-01-08 13:20:03,persegiMerah,221,321,128,130,129,56,131,56,2,0,True,0.338162520011375
2025-01-08 13:20:03,Merah,221,321,tensor(128.9535),tensor(130.1193),110,20,107,20,3,0,True,0.0005061626434326172
2025-01-08 13:20:03,Fail to pick,221,321,0,0,0,0,0,0,0,0,False,0
2025-01-08 13:20:03,persegiMerah,226,317,130,133,64,11,60,12,4,1,True,0.2882024687384658
2025-01-08 13:20:03,Fail to pick,226,317,0,0,0,0,0,0,0,0,False,0
2025-01-08 13:20:03,persegiMerah,224,319,132,130,91,37,95,38,4,1,True,0.2945669829330402
2025-01-08 13:20:03,Fail to pick,224,319,0,0,0,0,0,0,0,0,False,0
2025-01-08 13:20:04,persegiMerah,221,316,128,130,125,76,123,74,2,2,False,0.16876027628582396
2025-01-08 13:20:04,Fail to pick,221,316,0,0,0,0,0,0,0,0,False,0
2025-01-08 13:20:04,persegiMerah,225,320,130,132,182,38,185,37,3,1,True,0.2510215708569632
2025-01-08 13:20:04,Fail to pick,225,320,0,0,0,0,0,0,0,0,False,0
2025-01-08 13:20:04,persegiMerah,219,321,130,132,58,64,54,66,4,2,True,0.3497454116903047
2025-01-08 13:20:04,Merah,219,321,tensor(130.6268),tensor(132.5537),110,20,106,20,4,0,True,0.0
2025-01-08 13:20:04,Fail to pick,219,321,0,0,0,0,0,0,0,0,False,0
2025-01-08 13:20:04,persegiMerah,219,319,130,132,77,83,74,86,3,3,True,0.2655166463606882
2025-01-08 13:20:04,Fail to pick,219,319,0,0,0,0,0,0,0,0,False,0
2025-01-08 13:20:05,persegiMerah,221,320,130,133,9,3,6,-1,3,4,False,0.3639297297975175
2025-01-08 13:20:05,Fail to pick,221,320,0,0,0,0,0,0,0,0,False,0
2025-01-08 13:20:05,persegiMerah,225,321,129,132,127,87,130,87,3,0,True,0.1705165314300579
2025-01-08 13:20:05,Fail to pick,225,321,0,0,0,0,0,0,0,0,False,0
2025-01-08 13:20:05,persegiMerah,224,320,131,134,108,46,107,41,1,5,True,0.23629288449783956
2025-01-08 13:20:05,Merah,224,320,tensor(131.0733),tensor(134.7432),111,20,108,20,3,0,True,0.0
2025-01-08 13:20:05,Fail to pick,224,320,0,0,0,0,0,0,0,0,False,0
2025-01-08 13:20:06,persegiMerah,222,321,131,135,192,88,190,85,2,3,False,0.33554592990374643
2025-01-08 13:20:06,Fail to pick,222,321,0,0,0,0,0,0,0,0,False,0
2025-01-08 13:21:34,persegiMerah,215,372,121,136,162,93,160,95,2,2,True,0.10464008103481084
2025-01-08 13:21:34,Merah,215,372,tensor(121.9439),tensor(136.3401),96,19,96,14,0,5,True,0.0004978179931640625
2025-01-08 13:21:34,persegiMerah,141,408,136,135,173,54,172,57,1,3,True,0.39434076212033486
2025-01-08 13:21:35,persegiMerah,221,388,126,134,163,85,160,81,3,4,True,0.2781370778999831
2025-01-08 13:21:35,persegiMerah,210,350,120,132,14,17,12,15,2,2,True,0.27507867185804646
2025-01-08 13:21:35,persegiMerah,196,376,125,132,182,9,178,13,4,4,True,0.3060835184103346
2025-01-08 13:21:35,persegiMerah,142,374,129,132,100,57,96,61,4,4,True,0.2550824255462074
2025-01-08 13:21:35,persegiMerah,150,378,127,131,148,61,143,56,5,5,True,0.41126303673324693
2025-01-08 13:21:35,Fail to pick,150,378,0,0,0,0,0,0,0,0,False,0
2025-01-08 13:21:35,persegiMerah,178,360,119,130,9,3,11,5,2,2,True,0.31398792519320773
2025-01-08 13:21:35,persegiMerah,156,375,128,134,81,50,76,51,5,1,True,0.36471532710335064
2025-01-08 13:21:35,Merah,156,375,tensor(128.0651),tensor(134.4495),95,14,96,11,1,3,True,0.0
2025-01-08 13:21:35,persegiMerah,158,365,130,132,67,76,62,71,5,5,True,0.25195995898101753
2025-01-08 13:21:36,persegiMerah,171,362,126,133,70,22,69,25,1,3,True,0.27493311010612276
2025-01-08 13:21:36,persegiMerah,155,372,127,134,41,2,44,4,3,2,True,0.1919206348096069
2025-01-08 13:21:36,persegiMerah,204,347,125,133,153,93,156,88,3,5,True,0.2078565007812251
2025-01-08 13:21:36,persegiMerah,171,367,121,134,160,61,163,62,3,1,True,0.13680801767956724
2025-01-08 13:21:36,persegiMerah,153,370,132,135,72,63,70,65,2,2,True,0.3543207895169599
2025-01-08 13:21:36,persegiMerah,164,366,128,134,58,85,59,85,1,0,True,0.2636625789160054
2025-01-08 13:21:36,persegiMerah,201,343,124,136,53,57,55,57,2,0,True,0.2776275160711167
2025-01-08 13:21:36,Merah,201,343,tensor(124.9568),tensor(136.1630),104,18,103,15,1,3,True,0.0
2025-01-08 13:21:36,persegiMerah,158,374,122,133,181,91,178,91,3,0,False,0.11712510442968559
2025-01-08 13:21:37,persegiMerah,158,369,125,139,87,52,90,50,3,2,True,0.18511855364054167
2025-01-08 13:21:37,Fail to pick,158,369,0,0,0,0,0,0,0,0,False,0
2025-01-08 13:21:37,persegiMerah,156,379,129,133,93,36,97,37,4,1,False,0.2568495395992701
2025-01-08 13:21:37,persegiMerah,163,372,130,135,71,75,66,71,5,4,True,0.38467947308994455
2025-01-08 13:21:37,Fail to pick,163,372,0,0,0,0,0,0,0,0,False,0
2025-01-08 13:21:37,persegiMerah,162,370,124,136,33,38,28,33,5,5,True,0.1459681176086126
2025-01-08 13:21:37,Fail to pick,162,370,0,0,0,0,0,0,0,0,False,0
2025-01-08 13:21:37,persegiMerah,161,368,125,137,178,46,179,46,1,0,True,0.29945826646533563
2025-01-08 13:21:37,Fail to pick,161,368,0,0,0,0,0,0,0,0,False,0
2025-01-08 13:21:37,persegiMerah,154,368,132,135,64,88,61,85,3,3,True,0.25654433852239067
2025-01-08 13:21:37,Fail to pick,154,368,0,0,0,0,0,0,0,0,False,0
2025-01-08 13:21:37,persegiMerah,155,371,131,133,8,13,10,8,2,5,True,0.4101013286813774
2025-01-08 13:21:37,Fail to pick,155,371,0,0,0,0,0,0,0,0,False,0
2025-01-08 13:21:37,persegiMerah,150,372,129,137,49,43,53,45,4,2,True,0.3523847454392014
2025-01-08 13:21:37,Merah,150,372,tensor(129.5790),tensor(137.3050),96,13,96,17,0,4,True,0.000499725341796875
2025-01-08 13:21:37,Fail to pick,150,372,0,0,0,0,0,0,0,0,False,0
2025-01-08 13:21:37,persegiMerah,156,367,126,136,62,82,63,80,1,2,True,0.14283313895239336
2025-01-08 13:21:37,Fail to pick,156,367,0,0,0,0,0,0,0,0,False,0
2025-01-08 13:21:38,persegiMerah,138,374,134,133,149,56,148,59,1,3,True,0.16931561079384422
2025-01-08 13:21:38,persegiMerah,201,346,123,131,91,71,93,75,2,4,False,0.47935887395489085
2025-01-08 13:21:38,persegiMerah,168,361,119,133,41,57,41,56,0,1,True,0.2455886182228767
2025-01-08 13:21:38,persegiMerah,170,361,124,133,102,83,100,84,2,1,True,0.4118333502960203
2025-01-08 13:21:38,Fail to pick,170,361,0,0,0,0,0,0,0,0,False,0
2025-01-08 13:21:38,persegiMerah,154,371,127,131,90,1,91,3,1,2,True,0.17978247559357308
2025-01-08 13:21:38,persegiMerah,164,366,121,135,177,18,175,20,2,2,True,0.15278294980357565
2025-01-08 13:21:38,persegiMerah,210,350,119,133,171,89,166,85,5,4,True,0.29226569356333354
2025-01-08 13:21:38,persegiMerah,158,365,118,136,185,90,180,86,5,4,True,0.2410786417376204
2025-01-08 13:21:38,persegiMerah,158,368,119,137,125,33,121,34,4,1,True,0.2120362304556065
2025-01-08 13:21:38,Fail to pick,158,368,0,0,0,0,0,0,0,0,False,0
2025-01-08 13:21:39,persegiMerah,163,372,125,133,128,74,125,69,3,5,True,0.16708065804467923
2025-01-08 13:21:39,Merah,163,372,tensor(125.8207),tensor(133.0403),96,15,96,12,0,3,True,0.0
2025-01-08 13:21:39,Fail to pick,163,372,0,0,0,0,0,0,0,0,False,0
2025-01-08 13:21:39,persegiMerah,150,377,132,136,161,77,158,79,3,2,True,0.15586608627738374
2025-01-08 13:21:39,persegiMerah,202,347,119,135,72,57,69,55,3,2,True,0.4032935028509592
2025-01-08 13:21:39,persegiMerah,168,370,125,141,105,62,100,58,5,4,False,0.3746039640528075
2025-01-08 13:21:39,persegiMerah,155,366,126,137,87,46,83,41,4,5,True,0.42186110100851704
2025-01-08 13:21:39,persegiMerah,164,363,120,133,17,5,14,4,3,1,True,0.4943624234770738
2025-01-08 13:21:39,Fail to pick,164,363,0,0,0,0,0,0,0,0,False,0
2025-01-08 13:21:39,persegiMerah,160,372,124,134,69,34,68,38,1,4,True,0.2874403936067525
2025-01-08 13:21:39,Fail to pick,160,372,0,0,0,0,0,0,0,0,False,0
2025-01-08 13:21:39,persegiMerah,160,367,122,140,67,56,71,55,4,1,True,0.3551476493739323
2025-01-08 13:21:39,Fail to pick,160,367,0,0,0,0,0,0,0,0,False,0
2025-01-08 13:21:40,persegiMerah,178,358,111,130,21,77,25,79,4,2,True,0.2525021205209096
2025-01-08 13:21:40,persegiMerah,167,361,121,136,187,88,183,89,4,1,False,0.27589153195616484
2025-01-08 13:21:40,Merah,167,361,tensor(121.7176),tensor(136.9061),99,15,94,11,5,4,True,0.0
2025-01-08 13:21:40,persegiMerah,158,366,117,136,70,24,72,19,2,5,True,0.21780912426004195
2025-01-08 13:21:40,Fail to pick,158,366,0,0,0,0,0,0,0,0,False,0
2025-01-08 13:21:40,persegiMerah,160,369,124,137,105,56,109,58,4,2,True,0.46575458978161655
2025-01-08 13:21:40,Fail to pick,160,369,0,0,0,0,0,0,0,0,False,0
2025-01-08 13:21:40,persegiMerah,173,362,125,134,0,62,-5,58,5,4,True,0.44075317037675654
2025-01-08 13:21:40,persegiMerah,160,369,124,137,72,53,74,53,2,0,True,0.47600289079174274
2025-01-08 13:21:40,persegiMerah,152,369,115,139,154,78,156,80,2,2,True,0.3093139099513388
2025-01-08 13:21:40,Fail to pick,152,369,0,0,0,0,0,0,0,0,False,0
2025-01-08 13:21:40,persegiMerah,168,370,126,133,140,98,137,101,3,3,True,0.326742447808521
2025-01-08 13:21:40,persegiMerah,164,364,126,133,190,33,192,30,2,3,True,0.4681651768719841
2025-01-08 13:21:40,Fail to pick,164,364,0,0,0,0,0,0,0,0,False,0
2025-01-08 13:21:40,persegiMerah,173,368,126,134,138,76,139,74,1,2,True,0.22729999200252773
2025-01-08 13:21:40,Fail to pick,173,368,0,0,0,0,0,0,0,0,False,0
2025-01-08 13:21:41,persegiMerah,160,367,124,133,181,64,176,65,5,1,True,0.4865613622121998
2025-01-08 13:21:41,persegiMerah,169,360,119,134,124,73,125,77,1,4,False,0.2379066001000182
2025-01-08 13:21:41,Merah,169,360,tensor(119.8431),tensor(134.1337),100,15,104,14,4,1,True,0.0
2025-01-08 13:21:41,Fail to pick,169,360,0,0,0,0,0,0,0,0,False,0
2025-01-08 13:21:41,persegiMerah,173,357,116,132,31,79,30,77,1,2,True,0.4507203280319467
2025-01-08 13:21:41,Fail to pick,173,357,0,0,0,0,0,0,0,0,False,0
2025-01-08 13:21:41,persegiMerah,166,358,120,132,140,92,141,95,1,3,True,0.2961883207703063
2025-01-08 13:21:41,Fail to pick,166,358,0,0,0,0,0,0,0,0,False,0
2025-01-08 13:21:42,persegiMerah,165,367,118,132,70,79,67,81,3,2,True,0.36506764620773446
2025-01-08 13:21:42,Fail to pick,165,367,0,0,0,0,0,0,0,0,False,0
2025-01-08 13:21:42,persegiMerah,155,391,127,131,140,84,135,79,5,5,False,0.27350980944594144
2025-01-08 13:21:42,persegiMerah,166,362,121,128,17,81,16,81,1,0,False,0.31825094112699814
2025-01-08 13:21:42,persegiMerah,165,361,119,129,119,47,114,47,5,0,True,0.3847687205036938
2025-01-08 13:21:42,Fail to pick,165,361,0,0,0,0,0,0,0,0,False,0
2025-01-08 13:21:42,persegiMerah,170,364,121,131,148,98,148,96,0,2,True,0.49169641871727454
2025-01-08 13:21:42,Fail to pick,170,364,0,0,0,0,0,0,0,0,False,0
2025-01-08 13:21:42,persegiMerah,169,358,121,128,85,64,87,68,2,4,False,0.29444405010872987
2025-01-08 13:21:42,Merah,169,358,tensor(121.9691),tensor(128.5141),100,15,98,16,2,1,True,0.0004994869232177734
2025-01-08 13:21:42,Fail to pick,169,358,0,0,0,0,0,0,0,0,False,0
2025-01-08 13:21:42,persegiMerah,177,361,115,132,134,10,130,9,4,1,True,0.31331791401337816
2025-01-08 13:21:42,Fail to pick,177,361,0,0,0,0,0,0,0,0,False,0
2025-01-08 13:21:43,persegiMerah,161,363,118,133,29,86,27,90,2,4,True,0.2524882310324049
2025-01-08 13:21:43,persegiMerah,160,372,124,133,20,66,19,67,1,1,True,0.4160553884474604
2025-01-08 13:21:43,Fail to pick,160,372,0,0,0,0,0,0,0,0,False,0
2025-01-08 13:21:43,persegiMerah,164,366,121,131,32,5,28,0,4,5,True,0.37633612217709256
2025-01-08 13:21:43,Fail to pick,164,366,0,0,0,0,0,0,0,0,False,0
2025-01-08 13:21:43,persegiMerah,172,366,122,132,102,4,97,7,5,3,False,0.12302839083409318
2025-01-08 13:21:43,Fail to pick,172,366,0,0,0,0,0,0,0,0,False,0
2025-01-08 13:21:43,persegiMerah,159,362,116,130,104,79,102,80,2,1,True,0.4929502829289475
2025-01-08 13:21:43,persegiMerah,164,364,119,130,163,36,160,37,3,1,True,0.20423286160202234
2025-01-08 13:21:43,Merah,164,364,tensor(119.3212),tensor(130.7066),98,15,95,15,3,0,True,0.0
2025-01-08 13:21:43,Fail to pick,164,364,0,0,0,0,0,0,0,0,False,0
2025-01-08 13:21:43,persegiMerah,169,357,120,130,102,19,97,16,5,3,True,0.2641366005783946
2025-01-08 13:21:43,Fail to pick,169,357,0,0,0,0,0,0,0,0,False,0
2025-01-08 13:21:44,persegiMerah,163,361,118,131,120,95,119,91,1,4,True,0.3077279957731238
2025-01-08 13:21:44,Fail to pick,163,361,0,0,0,0,0,0,0,0,False,0
2025-01-08 13:21:44,persegiMerah,203,350,117,132,25,16,24,15,1,1,True,0.43828840107245115
2025-01-08 13:21:44,persegiMerah,161,366,118,133,131,88,127,87,4,1,False,0.43168220133126944
2025-01-08 13:21:44,persegiMerah,148,374,122,134,100,29,102,26,2,3,True,0.4448505159158115
2025-01-08 13:21:44,persegiMerah,166,368,121,136,43,92,38,93,5,1,True,0.4765729203813226
2025-01-08 13:21:44,persegiMerah,202,348,119,133,28,37,27,33,1,4,True,0.14232052582800891
2025-01-08 13:21:44,persegiMerah,163,365,122,129,118,49,113,51,5,2,True,0.39685681359241787
2025-01-08 13:21:44,Merah,163,365,tensor(122.3170),tensor(129.8691),98,15,100,18,2,3,True,0.0
2025-01-08 13:21:44,persegiMerah,165,361,122,134,159,80,163,76,4,4,True,0.38785638114429033
2025-01-08 13:21:44,Fail to pick,165,361,0,0,0,0,0,0,0,0,False,0
2025-01-08 13:21:45,persegiMerah,169,359,122,128,49,14,50,12,1,2,True,0.48066988194717497
2025-01-08 13:21:45,Fail to pick,169,359,0,0,0,0,0,0,0,0,False,0
2025-01-08 13:21:45,persegiMerah,166,360,119,133,174,70,177,70,3,0,False,0.1966355683699114
2025-01-08 13:21:45,Fail to pick,166,360,0,0,0,0,0,0,0,0,False,0
2025-01-08 13:21:45,persegiMerah,169,359,123,128,11,20,14,20,3,0,True,0.49602490297767265
2025-01-08 13:21:45,Fail to pick,169,359,0,0,0,0,0,0,0,0,False,0
2025-01-08 13:21:45,persegiMerah,201,342,118,132,37,77,39,81,2,4,False,0.390427433537749
2025-01-08 13:21:45,persegiMerah,162,369,124,139,31,88,28,88,3,0,False,0.13865436697918254
2025-01-08 13:27:39,persegiKuning,372,369,114,132,16,87,20,91,4,4,True,0.3769329579291457
2025-01-08 13:27:39,Kuning,372,369,tensor(114.5901),tensor(132.3923),97,34,96,33,1,1,True,0.0004942417144775391
2025-01-08 13:27:39,persegiKuning,385,375,113,136,86,45,88,41,2,4,True,0.410825530337656
2025-01-08 13:27:39,persegiKuning,367,375,112,127,110,99,109,102,1,3,True,0.4390569446573588
2025-01-08 13:27:40,persegiKuning,384,374,115,130,120,14,122,17,2,3,True,0.239903083816131
2025-01-08 13:27:40,persegiKuning,363,370,116,134,169,35,168,31,1,4,True,0.4130686804274425
2025-01-08 13:27:40,persegiKuning,361,374,121,129,17,51,15,55,2,4,True,0.3539091062227372
2025-01-08 13:27:40,Kuning,361,374,tensor(121.0400),tensor(129.0090),96,33,99,34,3,1,True,0.0
2025-01-08 13:27:40,Fail to pick,361,374,0,0,0,0,0,0,0,0,False,0
2025-01-08 13:27:40,persegiMerah,363,380,125,130,198,20,197,15,1,5,True,0.16180738767925462
2025-01-08 13:27:40,Fail to pick,363,380,0,0,0,0,0,0,0,0,False,0
2025-01-08 13:27:41,persegiKuning,343,376,110,131,99,20,98,18,1,2,True,0.41306710960707327
2025-01-08 13:27:41,persegiKuning,371,379,116,128,20,39,20,35,0,4,True,0.41573374693954257
2025-01-08 13:27:41,persegiKuning,368,383,115,130,30,48,32,47,2,1,True,0.27753849013723936
2025-01-08 13:27:41,Kuning,368,383,tensor(115.5449),tensor(130.7801),93,34,89,33,4,1,True,0.0
2025-01-08 13:27:41,Fail to pick,368,383,0,0,0,0,0,0,0,0,False,0
2025-01-08 13:27:41,persegiKuning,370,379,112,130,94,49,97,49,3,0,True,0.16520674767872512
2025-01-08 13:27:41,Fail to pick,370,379,0,0,0,0,0,0,0,0,False,0
2025-01-08 13:27:42,persegiKuning,370,381,112,129,53,54,55,54,2,0,True,0.2330970441146707
2025-01-08 13:27:42,Fail to pick,370,381,0,0,0,0,0,0,0,0,False,0
2025-01-08 13:27:42,persegiKuning,378,374,114,129,165,84,168,82,3,2,True,0.19080008366207402
2025-01-08 13:27:42,Fail to pick,378,374,0,0,0,0,0,0,0,0,False,0
2025-01-08 13:27:42,persegiKuning,370,371,114,131,33,30,29,26,4,4,True,0.3038010827260339
2025-01-08 13:27:42,Kuning,370,371,tensor(114.3570),tensor(131.9437),96,34,99,37,3,3,True,0.0
2025-01-08 13:27:42,Fail to pick,370,371,0,0,0,0,0,0,0,0,False,0
2025-01-08 13:27:44,persegiKuning,366,375,121,127,62,95,61,95,1,0,True,0.46413449818900354
2025-01-08 13:27:44,Kuning,366,375,tensor(121.5292),tensor(127.8389),95,33,95,32,0,1,True,0.0
2025-01-08 13:27:44,Fail to pick,366,375,0,0,0,0,0,0,0,0,False,0
2025-01-08 13:27:44,persegiMerah,353,383,120,128,103,45,107,47,4,2,True,0.47257468351183696
2025-01-08 13:27:44,persegiKuning,375,374,120,130,130,27,126,31,4,4,True,0.3536239784491674
2025-01-08 13:27:45,persegiKuning,398,368,111,129,29,82,31,78,2,4,True,0.4206747621234965
2025-01-08 13:27:45,Kuning,398,368,tensor(111.2305),tensor(129.8896),97,36,92,35,5,1,True,0.0
2025-01-08 13:27:45,persegiKuning,367,370,117,130,6,12,5,11,1,1,True,0.4876895065776362
2025-01-08 13:27:46,persegiKuning,371,373,110,130,130,33,133,36,3,3,True,0.12045919326394908
2025-01-08 13:27:46,Fail to pick,371,373,0,0,0,0,0,0,0,0,False,0
2025-01-08 13:27:46,persegiKuning,377,374,112,131,66,27,64,31,2,4,True,0.3361846713834593
2025-01-08 13:27:46,Fail to pick,377,374,0,0,0,0,0,0,0,0,False,0
2025-01-08 13:27:48,persegiMerah,908,484,136,139,183,0,185,-1,2,1,True,0.10789388145338395
2025-01-08 13:27:48,Merah,908,484,tensor(136.2850),tensor(139.8489),65,84,69,79,4,5,True,0.0004992485046386719
2025-01-08 13:27:48,persegiMerah,950,481,147,136,181,18,178,22,3,4,True,0.2599844763261508
2025-01-08 13:27:49,persegiMerah,911,473,142,140,178,94,181,92,3,2,True,0.2663129588018883
2025-01-08 13:27:49,persegiMerah,924,445,146,140,90,40,94,39,4,1,True,0.37010753716010836
2025-01-08 13:27:49,persegiMerah,910,464,136,142,177,47,181,45,4,2,True,0.2202078327913166
2025-01-08 13:27:49,Merah,910,464,tensor(136.0903),tensor(142.5244),71,84,70,83,1,1,True,0.0
2025-01-08 13:27:49,persegiMerah,909,458,142,148,189,6,186,10,3,4,True,0.49375819667787424
2025-01-08 13:27:49,Fail to pick,909,458,0,0,0,0,0,0,0,0,False,0
2025-01-08 13:27:49,persegiMerah,907,457,145,149,191,61,194,65,3,4,True,0.20204143401257016
2025-01-08 13:27:49,Fail to pick,907,457,0,0,0,0,0,0,0,0,False,0
2025-01-08 13:27:50,persegiMerah,914,480,135,139,123,69,122,72,1,3,True,0.3437871143421304
2025-01-08 13:27:50,persegiMerah,913,465,138,139,68,17,65,19,3,2,True,0.27908985163567424
2025-01-08 13:27:50,persegiMerah,900,483,137,143,3,15,1,14,2,1,True,0.11878252470045472
2025-01-08 13:27:50,persegiMerah,917,466,143,139,62,39,59,41,3,2,True,0.29858532994585996
2025-01-08 13:27:50,persegiMerah,914,461,135,138,159,7,157,3,2,4,True,0.45594214036902847
2025-01-08 13:27:50,Fail to pick,914,461,0,0,0,0,0,0,0,0,False,0
2025-01-08 13:27:50,persegiMerah,920,459,141,138,118,44,117,40,1,4,True,0.4557617344205901
2025-01-08 13:27:50,Fail to pick,920,459,0,0,0,0,0,0,0,0,False,0
2025-01-08 13:27:50,persegiMerah,917,460,140,140,90,87,94,83,4,4,True,0.1298469084385273
2025-01-08 13:27:50,Merah,917,460,tensor(140.7279),tensor(140.7889),72,84,76,80,4,4,True,0.0004994869232177734
2025-01-08 13:27:50,Fail to pick,917,460,0,0,0,0,0,0,0,0,False,0
2025-01-08 13:27:51,persegiMerah,910,454,146,142,99,59,96,60,3,1,True,0.4635755001415962
2025-01-08 13:27:51,Fail to pick,910,454,0,0,0,0,0,0,0,0,False,0
2025-01-08 13:27:51,persegiMerah,904,478,143,139,164,32,164,27,0,5,True,0.18983280683935555
2025-01-08 13:27:51,persegiMerah,915,461,142,140,197,54,192,58,5,4,True,0.22872454645431387
2025-01-08 13:27:51,persegiMerah,910,471,129,134,15,60,16,61,1,1,True,0.2795121582111364
2025-01-08 13:27:51,persegiMerah,919,461,142,144,42,33,42,37,0,4,True,0.3532101686427781
2025-01-08 13:27:51,persegiMerah,906,473,141,139,18,1,13,0,5,1,True,0.29388572180300265
2025-01-08 13:27:51,persegiMerah,910,476,137,139,152,20,148,18,4,2,True,0.4621197572785529
2025-01-08 13:27:51,Fail to pick,910,476,0,0,0,0,0,0,0,0,False,0
2025-01-08 13:27:52,persegiMerah,907,469,141,138,1,63,-2,58,3,5,True,0.42156089825345155
2025-01-08 13:27:52,Fail to pick,907,469,0,0,0,0,0,0,0,0,False,0
2025-01-08 13:27:52,persegiMerah,909,477,138,140,23,58,27,61,4,3,True,0.3742472933231725
2025-01-08 13:27:52,Merah,909,477,tensor(138.5286),tensor(140.8586),67,84,66,87,1,3,True,0.0
2025-01-08 13:27:52,Fail to pick,909,477,0,0,0,0,0,0,0,0,False,0
2025-01-08 13:27:52,persegiMerah,911,470,138,141,160,74,162,71,2,3,True,0.18415762233149247
2025-01-08 13:27:52,Fail to pick,911,470,0,0,0,0,0,0,0,0,False,0
2025-01-08 13:27:52,persegiMerah,907,470,131,138,60,90,57,92,3,2,True,0.454030478635729
2025-01-08 13:27:52,Fail to pick,907,470,0,0,0,0,0,0,0,0,False,0
2025-01-08 13:27:52,persegiMerah,912,468,130,136,64,78,59,77,5,1,True,0.211468346630924
2025-01-08 13:27:52,Fail to pick,912,468,0,0,0,0,0,0,0,0,False,0
2025-01-08 13:27:52,persegiMerah,910,456,145,148,22,54,19,56,3,2,True,0.12335686761572134
2025-01-08 13:27:52,persegiMerah,907,470,135,135,107,26,105,22,2,4,True,0.17927073251296022
2025-01-08 13:27:52,persegiMerah,911,468,137,137,154,71,150,70,4,1,True,0.4245073073828859
2025-01-08 13:27:52,Fail to pick,911,468,0,0,0,0,0,0,0,0,False,0
2025-01-08 13:27:53,persegiMerah,919,468,135,134,184,74,188,74,4,0,True,0.15259671606497036
2025-01-08 13:27:53,Merah,919,468,tensor(135.7405),tensor(134.3410),70,85,69,85,1,0,True,0.0006108283996582031
2025-01-08 13:27:53,Fail to pick,919,468,0,0,0,0,0,0,0,0,False,0
2025-01-08 13:27:53,persegiMerah,913,464,128,134,166,92,162,92,4,0,False,0.3951180753933631
2025-01-08 13:27:53,Fail to pick,913,464,0,0,0,0,0,0,0,0,False,0
2025-01-08 13:27:53,persegiMerah,910,462,140,145,172,74,175,77,3,3,True,0.41087941686160157
2025-01-08 13:27:53,Fail to pick,910,462,0,0,0,0,0,0,0,0,False,0
2025-01-08 13:27:53,persegiMerah,906,473,137,140,171,70,174,73,3,3,True,0.26179758435392203
2025-01-08 13:27:53,persegiMerah,908,462,141,145,122,33,119,32,3,1,True,0.32533771075002105
2025-01-08 13:27:53,persegiMerah,919,459,136,138,122,76,122,79,0,3,True,0.2868712036050717
2025-01-08 13:27:54,persegiMerah,912,457,146,150,106,49,109,48,3,1,True,0.27884286979325656
2025-01-08 13:27:54,Fail to pick,912,457,0,0,0,0,0,0,0,0,False,0
2025-01-08 13:27:54,persegiMerah,916,468,137,140,165,98,165,95,0,3,True,0.37062519791791293
2025-01-08 13:27:54,Merah,916,468,tensor(137.7854),tensor(140.9108),70,84,68,80,2,4,True,0.0004999637603759766
2025-01-08 13:27:54,persegiMerah,913,475,134,139,124,53,124,49,0,4,True,0.10748100361759563
2025-01-08 13:27:54,Fail to pick,913,475,0,0,0,0,0,0,0,0,False,0
2025-01-08 13:27:54,persegiMerah,919,456,142,138,65,79,65,82,0,3,True,0.21598611279557287
2025-01-08 13:27:54,persegiMerah,914,466,133,134,5,45,7,44,2,1,True,0.4895048341794439
2025-01-08 13:27:55,persegiMerah,907,479,138,136,82,88,81,87,1,1,True,0.17213111480016363
2025-01-08 13:27:55,persegiMerah,918,459,139,137,89,65,88,65,1,0,True,0.11417559454554929
2025-01-08 13:27:55,persegiMerah,917,461,142,140,163,25,162,25,1,0,True,0.17083737617082034
2025-01-08 13:27:55,Fail to pick,917,461,0,0,0,0,0,0,0,0,False,0
2025-01-08 13:27:55,persegiMerah,907,473,136,139,195,93,191,94,4,1,True,0.3604064500072407
2025-01-08 13:27:55,Merah,907,473,tensor(136.6028),tensor(139.7133),68,83,70,79,2,4,True,0.0005018711090087891
2025-01-08 13:27:55,persegiMerah,907,472,138,140,113,14,116,10,3,4,True,0.42360481682839035
2025-01-08 13:27:55,Fail to pick,907,472,0,0,0,0,0,0,0,0,False,0
2025-01-08 13:27:56,persegiMerah,919,466,137,139,7,0,7,3,0,3,True,0.3184042080937258
2025-01-08 13:27:56,persegiMerah,909,473,139,141,88,14,89,11,1,3,True,0.3671536015088568
2025-01-08 13:27:56,persegiMerah,912,476,136,140,180,16,179,17,1,1,True,0.2773917677309764
2025-01-08 13:27:56,Fail to pick,912,476,0,0,0,0,0,0,0,0,False,0
2025-01-08 13:27:57,persegiMerah,922,463,145,142,37,29,41,29,4,0,True,0.1780413453090593
2025-01-08 13:27:57,Merah,922,463,tensor(145.8961),tensor(142.9387),71,85,67,86,4,1,True,0.0004987716674804688
2025-01-08 13:27:57,persegiMerah,918,462,140,140,70,44,66,39,4,5,True,0.4240728864389046
2025-01-08 13:27:57,Fail to pick,918,462,0,0,0,0,0,0,0,0,False,0
2025-01-08 13:27:58,persegiMerah,930,460,133,140,62,6,62,1,0,5,True,0.22549545718168568
2025-01-08 13:27:58,persegiMerah,910,484,134,137,52,34,47,31,5,3,True,0.4602560321050152
2025-01-08 13:27:58,persegiMerah,932,462,129,135,138,61,140,60,2,1,True,0.1435024225039729
2025-01-08 13:27:58,Merah,932,462,tensor(129.6361),tensor(135.1783),71,86,74,87,3,1,True,0.0005056858062744141
2025-01-08 13:27:58,persegiMerah,920,459,150,140,124,66,119,65,5,1,True,0.23919464149113567
2025-01-08 13:28:01,persegiMerah,85,464,127,128,179,48,175,52,4,4,True,0.10162323378128933
2025-01-08 13:28:01,Merah,85,464,tensor(127.5351),tensor(128.0280),71,7,73,5,2,2,True,0.0004999637603759766
2025-01-08 13:28:01,persegiMerah,92,462,124,130,40,89,43,88,3,1,False,0.2168650892603847
2025-01-08 13:28:01,Fail to pick,92,462,0,0,0,0,0,0,0,0,False,0
2025-01-08 13:28:01,persegiMerah,96,462,128,129,23,68,25,64,2,4,True,0.4775697829161978
2025-01-08 13:28:01,Fail to pick,96,462,0,0,0,0,0,0,0,0,False,0
2025-01-08 13:28:01,persegiMerah,97,460,132,128,191,42,190,42,1,0,True,0.4708645057180042
2025-01-08 13:28:01,Fail to pick,97,460,0,0,0,0,0,0,0,0,False,0
2025-01-08 13:28:01,persegiMerah,102,462,126,126,6,42,4,44,2,2,True,0.407921314115815
2025-01-08 13:28:01,Fail to pick,102,462,0,0,0,0,0,0,0,0,False,0
2025-01-08 13:28:01,persegiMerah,124,444,126,128,18,1,13,1,5,0,True,0.260519275294822
2025-01-08 13:28:01,persegiMerah,86,466,124,127,195,76,191,72,4,4,True,0.23741137401962537
2025-01-08 13:28:01,persegiMerah,81,469,134,125,116,19,111,15,5,4,True,0.4178204632307906
2025-01-08 13:28:01,Fail to pick,81,469,0,0,0,0,0,0,0,0,False,0
2025-01-08 13:28:02,persegiMerah,82,470,126,124,86,80,83,84,3,4,True,0.304488010579113
2025-01-08 13:28:02,Merah,82,470,tensor(126.9017),tensor(124.4233),69,7,72,2,3,5,True,0.0
2025-01-08 13:28:02,Fail to pick,82,470,0,0,0,0,0,0,0,0,False,0
2025-01-08 13:28:02,persegiMerah,119,444,121,129,158,18,158,15,0,3,False,0.44729831909325857
2025-01-08 13:28:02,persegiMerah,78,468,137,124,94,16,89,16,5,0,True,0.4099168478518701
2025-01-08 13:28:02,persegiMerah,96,464,126,127,111,72,114,74,3,2,True,0.4818409694408785
2025-01-08 13:28:02,persegiMerah,92,463,123,127,96,5,93,4,3,1,True,0.10292991190455814
2025-01-08 13:28:02,Fail to pick,92,463,0,0,0,0,0,0,0,0,False,0
2025-01-08 13:28:02,persegiMerah,81,466,122,126,197,30,201,30,4,0,True,0.1475528841324374
2025-01-08 13:28:02,persegiMerah,123,450,125,129,155,9,152,7,3,2,True,0.34353643393706335
2025-01-08 13:28:03,persegiMerah,127,442,125,127,170,73,171,76,1,3,False,0.2732370452834664
2025-01-08 13:28:03,Fail to pick,127,442,0,0,0,0,0,0,0,0,False,0
2025-01-08 13:28:03,persegiMerah,87,465,125,128,177,37,177,40,0,3,True,0.2611708131309372
2025-01-08 13:28:03,Merah,87,465,tensor(125.7645),tensor(128.7857),70,8,74,6,4,2,True,0.0
2025-01-08 13:28:03,persegiMerah,97,463,127,127,54,71,55,67,1,4,True,0.2771610550164896
2025-01-08 13:28:04,persegiMerah,92,462,130,128,195,17,195,14,0,3,True,0.10105523245461012
2025-01-08 13:28:04,Fail to pick,92,462,0,0,0,0,0,0,0,0,False,0
2025-01-08 13:28:04,persegiMerah,103,462,126,128,4,6,4,8,0,2,True,0.4694089255925984
2025-01-08 13:28:04,persegiMerah,125,448,127,127,191,67,191,62,0,5,True,0.4050132584747955
2025-01-08 13:28:04,persegiMerah,88,466,130,129,177,28,177,27,0,1,True,0.35419164097825495
2025-01-08 13:28:04,Merah,88,466,tensor(130.4680),tensor(129.0729),70,8,67,11,3,3,True,0.0004999637603759766
2025-01-08 13:28:05,persegiMerah,104,461,119,127,32,23,27,19,5,4,False,0.3305030525359449
2025-01-08 13:28:05,persegiMerah,126,445,124,128,192,61,187,59,5,2,True,0.26031468416199793
2025-01-08 13:28:05,persegiMerah,101,460,126,128,29,12,28,8,1,4,True,0.144059879881099
2025-01-08 13:28:05,persegiMerah,88,463,121,128,192,9,192,11,0,2,False,0.3033188909886816
2025-01-08 13:32:36,persegiMerah,885,474,123,139,116,29,111,30,5,1,True,0.37638146256609173
2025-01-08 13:32:36,Merah,885,474,tensor(123.6066),tensor(139.1019),68,81,68,82,0,1,True,0.0004992485046386719
2025-01-08 13:32:36,persegiMerah,898,462,123,144,176,97,179,100,3,3,True,0.4896764116186585
2025-01-08 13:32:37,persegiMerah,863,497,128,140,42,17,45,18,3,1,True,0.3933377564774917
2025-01-08 13:32:37,persegiMerah,860,525,136,138,142,10,144,7,2,3,True,0.3973721890839721
2025-01-08 13:32:37,Merah,860,525,tensor(136.1320),tensor(138.7997),54,79,58,83,4,4,True,0.0005049705505371094
2025-01-08 13:32:37,persegiMerah,852,507,137,146,32,54,32,58,0,4,True,0.1821917424036165
2025-01-08 13:32:37,persegiMerah,868,513,127,141,72,94,68,96,4,2,True,0.17859751862886253
2025-01-08 13:32:37,persegiMerah,871,516,123,136,25,13,21,16,4,3,True,0.1254002406765248
2025-01-08 13:32:37,Fail to pick,871,516,0,0,0,0,0,0,0,0,False,0
2025-01-08 13:32:37,persegiMerah,894,469,129,134,165,92,165,91,0,1,True,0.25014110295300207
2025-01-08 13:32:37,persegiMerah,904,472,123,132,34,0,37,-3,3,3,True,0.4633407729407726
2025-01-08 13:32:38,persegiMerah,903,471,116,129,175,1,177,-2,2,3,True,0.35659805719965887
2025-01-08 13:32:38,Fail to pick,903,471,0,0,0,0,0,0,0,0,False,0
2025-01-08 13:32:38,persegiMerah,904,463,120,132,4,50,4,52,0,2,True,0.16630668846345742
2025-01-08 13:32:38,Fail to pick,904,463,0,0,0,0,0,0,0,0,False,0
2025-01-08 13:33:05,persegiMerah,237,350,113,137,125,40,122,40,3,0,False,0.4721668363682373
2025-01-08 13:33:05,Merah,237,350,tensor(113.7768),tensor(137.8300),102,21,103,24,1,3,True,0.0005013942718505859
2025-01-08 13:33:05,persegiMerah,261,353,114,134,42,95,45,99,3,4,True,0.12604567133778982
2025-01-08 13:33:06,persegiMerah,271,370,122,136,175,57,178,55,3,2,True,0.15703447606183027
2025-01-08 13:33:06,Merah,271,370,tensor(122.2840),tensor(136.0800),97,25,96,22,1,3,True,0.0004990100860595703
2025-01-08 13:33:06,persegiMerah,232,364,129,139,114,17,115,13,1,4,True,0.4254080316060387
2025-01-08 13:33:06,persegiMerah,260,354,121,133,49,38,47,40,2,2,True,0.35874919595443744
2025-01-08 13:33:06,persegiMerah,254,349,116,134,181,81,182,77,1,4,True,0.3186893515766791
2025-01-08 13:33:06,Fail to pick,254,349,0,0,0,0,0,0,0,0,False,0
2025-01-08 13:33:07,persegiMerah,281,340,117,139,148,19,150,18,2,1,False,0.26493773624060013
2025-01-08 13:33:07,persegiMerah,247,377,129,137,89,82,91,79,2,3,True,0.1320168330031411
2025-01-08 13:33:07,Merah,247,377,tensor(129.3973),tensor(137.1487),95,22,99,26,4,4,True,0.0
2025-01-08 13:33:08,persegiMerah,244,364,125,136,32,58,35,57,3,1,False,0.41479427124221246
2025-01-08 13:33:08,persegiMerah,248,375,131,137,147,30,146,30,1,0,False,0.25901740921482413
2025-01-08 13:33:09,persegiMerah,253,359,123,133,116,70,120,70,4,0,True,0.25098710628891974
2025-01-08 13:33:09,Merah,253,359,tensor(123.4380),tensor(133.2992),100,23,99,21,1,2,True,0.0005002021789550781
2025-01-08 13:33:10,persegiMerah,247,375,128,138,54,7,54,8,0,1,True,0.3988767969717356
2025-01-08 13:33:10,persegiMerah,250,353,122,139,57,53,60,48,3,5,True,0.18077883472789844
2025-01-08 13:33:10,Merah,250,353,tensor(122.1492),tensor(139.7042),101,23,98,18,3,5,True,0.0
2025-01-08 13:33:10,persegiMerah,256,354,128,137,116,94,111,92,5,2,True,0.4013896379632037
2025-01-08 13:33:10,Fail to pick,256,354,0,0,0,0,0,0,0,0,False,0
2025-01-08 13:33:10,persegiMerah,256,354,128,137,151,21,149,25,2,4,True,0.42151295025002167
2025-01-08 13:33:10,Fail to pick,256,354,0,0,0,0,0,0,0,0,False,0
2025-01-08 13:33:11,persegiMerah,257,353,123,135,39,87,43,83,4,4,True,0.22823001011636498
2025-01-08 13:33:11,Merah,257,353,tensor(123.6509),tensor(135.4774),101,23,99,20,2,3,True,0.0
2025-01-08 13:33:11,Fail to pick,257,353,0,0,0,0,0,0,0,0,False,0
2025-01-08 13:33:11,persegiMerah,260,367,125,139,140,71,139,69,1,2,True,0.343485630357494
2025-01-08 13:33:11,persegiMerah,245,355,119,138,169,67,170,66,1,1,True,0.4895028086169768
2025-01-08 13:33:12,persegiMerah,242,361,120,134,81,93,79,88,2,5,True,0.3980111625523105
2025-01-08 13:33:12,Fail to pick,242,361,0,0,0,0,0,0,0,0,False,0
2025-01-08 13:33:12,persegiMerah,249,354,122,134,37,85,37,80,0,5,True,0.22836365997458852
2025-01-08 13:33:12,Fail to pick,249,354,0,0,0,0,0,0,0,0,False,0
2025-01-08 13:33:12,persegiMerah,236,353,118,137,25,48,24,44,1,4,True,0.2585150219548207
2025-01-08 13:33:12,Merah,236,353,tensor(118.8139),tensor(137.5776),101,21,98,25,3,4,True,0.0005035400390625
2025-01-08 13:33:13,persegiMerah,278,346,121,134,29,54,29,57,0,3,True,0.25306113061000196
2025-01-08 13:33:13,Merah,278,346,tensor(121.6170),tensor(134.3998),103,25,104,28,1,3,True,0.0004990100860595703
2025-01-08 13:33:14,persegiMerah,283,341,121,135,0,67,-4,68,4,1,True,0.4729368651948467
2025-01-08 13:33:14,Fail to pick,283,341,0,0,0,0,0,0,0,0,False,0
2025-01-08 13:33:14,persegiMerah,243,354,124,137,18,51,17,53,1,2,True,0.4378519830725295
2025-01-08 13:33:16,persegiMerah,245,356,126,133,14,72,12,68,2,4,True,0.10125310419465752
2025-01-08 13:33:16,Merah,245,356,tensor(126.7331),tensor(133.8104),101,22,98,26,3,4,True,0.0004994869232177734
2025-01-08 13:33:16,Fail to pick,245,356,0,0,0,0,0,0,0,0,False,0
2025-01-08 13:33:16,persegiMerah,242,358,124,137,143,45,146,45,3,0,True,0.4334571438609168
2025-01-08 13:33:16,Fail to pick,242,358,0,0,0,0,0,0,0,0,False,0
2025-01-08 13:33:17,persegiMerah,251,360,128,137,55,5,55,8,0,3,True,0.3504645594826411
2025-01-08 13:33:17,Fail to pick,251,360,0,0,0,0,0,0,0,0,False,0
2025-01-08 13:33:17,persegiMerah,224,351,123,140,177,95,179,93,2,2,True,0.3644914433601155
2025-01-08 13:33:17,Merah,224,351,tensor(123.9201),tensor(140.3879),102,20,103,21,1,1,True,0.0004987716674804688
2025-01-08 13:33:19,persegiMerah,227,606,126,127,154,65,157,67,3,2,True,0.25534871609926985
2025-01-08 13:33:19,Merah,227,606,tensor(126.1036),tensor(127.0032),31,21,35,25,4,4,True,0.0
2025-01-08 13:33:26,persegiMerah,249,603,133,124,67,46,69,50,2,4,False,0.38888393410306477
2025-01-08 13:33:29,persegiMerah,248,602,135,127,191,32,191,33,0,1,True,0.30217216235289485
2025-01-08 13:33:29,Fail to pick,248,602,0,0,0,0,0,0,0,0,False,0
2025-01-08 13:33:30,persegiMerah,250,603,136,123,63,25,64,27,1,2,False,0.41642211431212317
2025-01-08 13:33:30,Merah,250,603,tensor(136.6702),tensor(123.7825),32,23,29,20,3,3,True,0.0004966259002685547
2025-01-08 13:33:30,Fail to pick,250,603,0,0,0,0,0,0,0,0,False,0
2025-01-08 13:38:25,persegiMerah,759,121,108,133,20,2,19,-2,1,4,True,0.4215295619660032
2025-01-08 13:38:25,Merah,759,121,tensor(108.0433),tensor(133.4854),166,70,164,66,2,4,True,0.0004987716674804688
2025-01-08 13:38:25,persegiMerah,757,130,123,140,118,23,118,22,0,1,True,0.3157401620269245
2025-01-08 13:38:25,Fail to pick,757,130,0,0,0,0,0,0,0,0,False,0
2025-01-08 13:38:26,persegiMerah,751,119,123,142,70,89,70,92,0,3,True,0.48083889810482205
2025-01-08 13:38:26,persegiMerah,742,130,121,147,197,68,195,64,2,4,True,0.4445647436980287
2025-01-08 13:38:26,persegiMerah,771,126,122,143,20,25,16,26,4,1,True,0.2086247327724593
2025-01-08 13:38:26,Merah,771,126,tensor(122.0446),tensor(143.7682),165,71,169,67,4,4,True,0.0
2025-01-08 13:38:26,persegiMerah,758,76,137,149,12,11,12,14,0,3,True,0.14883003635050704
2025-01-08 13:38:26,persegiMerah,760,91,129,145,193,59,192,54,1,5,True,0.4787205695130625
2025-01-08 13:38:27,persegiMerah,741,123,127,148,87,73,89,71,2,2,True,0.36503178170388006
2025-01-08 13:38:27,persegiMerah,767,112,118,143,85,6,80,2,5,4,True,0.3218474539369476
2025-01-08 13:38:27,Merah,767,112,tensor(118.1944),tensor(143.7120),168,71,169,69,1,2,True,0.0005016326904296875
2025-01-08 13:38:27,persegiMerah,762,101,132,148,142,56,140,59,2,3,True,0.21373762579979433
2025-01-08 13:38:27,persegiMerah,756,117,133,148,135,42,131,46,4,4,True,0.12080639434786429
2025-01-08 13:38:27,persegiMerah,766,126,124,145,80,22,76,21,4,1,True,0.4049640493557116
2025-01-08 13:38:28,persegiMerah,811,114,140,150,71,42,74,40,3,2,True,0.3122945101624031
2025-01-08 13:38:28,Merah,811,114,tensor(140.1989),tensor(150.8913),168,75,172,75,4,0,True,0.0
2025-01-08 13:38:28,persegiMerah,796,117,140,151,52,31,49,34,3,3,True,0.2933417259721067
2025-01-08 13:38:28,persegiMerah,767,130,120,142,183,80,186,81,3,1,True,0.2548872721753877
2025-01-08 13:38:28,persegiMerah,751,123,122,145,33,78,28,76,5,2,True,0.3725507409948666
2025-01-08 13:38:29,persegiMerah,758,108,128,151,24,91,20,95,4,4,True,0.4317497950415543
2025-01-08 13:38:29,persegiMerah,758,129,121,146,110,11,112,12,2,1,True,0.2900435476901067
2025-01-08 13:38:29,persegiMerah,750,136,118,142,154,35,154,32,0,3,True,0.2017954998681921
2025-01-08 13:38:29,Fail to pick,750,136,0,0,0,0,0,0,0,0,False,0
2025-01-08 13:38:29,persegiMerah,766,137,113,138,155,99,152,100,3,1,True,0.20854716584842692
2025-01-08 13:38:29,persegiMerah,751,139,119,136,77,78,76,78,1,0,True,0.12235983342590716
2025-01-08 13:38:29,Merah,751,139,tensor(119.3840),tensor(136.5194),161,69,163,67,2,2,True,0.0
2025-01-08 13:38:30,persegiMerah,756,121,134,146,72,76,73,73,1,3,True,0.1809968781899905
2025-01-08 13:38:30,persegiMerah,781,104,141,152,1,87,-4,84,5,3,False,0.31865288771162525
2025-01-08 13:38:30,persegiMerah,751,134,115,140,85,5,84,9,1,4,True,0.3961558953620523
2025-01-08 13:38:31,persegiMerah,773,122,119,139,177,75,178,78,1,3,True,0.40617538906450645
2025-01-08 13:38:31,Merah,773,122,tensor(119.0989),tensor(139.9391),166,71,170,74,4,3,True,0.0
2025-01-08 13:38:31,persegiMerah,773,122,119,139,93,56,90,59,3,3,False,0.10935716368651152
2025-01-08 13:38:31,Fail to pick,773,122,0,0,0,0,0,0,0,0,False,0
2025-01-08 13:38:31,persegiMerah,760,118,133,148,165,95,161,90,4,5,True,0.12734919128184863
2025-01-08 13:38:31,persegiMerah,774,90,132,146,31,11,30,12,1,1,True,0.25325731196402623
2025-01-08 13:38:31,persegiMerah,748,128,126,146,129,82,124,84,5,2,False,0.11234453798720417
2025-01-08 13:38:31,persegiMerah,760,126,127,143,186,84,183,79,3,5,True,0.31480579116785123
2025-01-08 13:38:31,persegiMerah,766,127,119,140,15,90,12,86,3,4,True,0.25789014443356584
2025-01-08 13:38:31,Fail to pick,766,127,0,0,0,0,0,0,0,0,False,0
2025-01-08 13:38:32,persegiMerah,768,101,134,149,118,16,115,15,3,1,True,0.16591156361027776
2025-01-08 13:38:32,Merah,768,101,tensor(134.0571),tensor(149.5656),171,71,173,70,2,1,True,0.0004987716674804688
2025-01-08 13:38:32,persegiMerah,751,137,125,145,87,65,91,69,4,4,True,0.4011264290730009
2025-01-08 13:38:32,persegiMerah,755,119,129,147,154,89,153,89,1,0,True,0.13812139358154696
2025-01-08 13:38:32,persegiMerah,755,119,125,145,3,23,7,24,4,1,True,0.3242150055508587
2025-01-08 13:38:32,Fail to pick,755,119,0,0,0,0,0,0,0,0,False,0
2025-01-08 13:38:33,persegiMerah,753,102,131,151,132,20,127,21,5,1,True,0.1428169505263529
2025-01-08 13:38:33,Merah,753,102,tensor(131.5648),tensor(151.2105),171,69,175,67,4,2,True,0.0
2025-01-08 13:38:33,persegiMerah,762,127,128,145,191,13,194,16,3,3,True,0.12086211802436138
2025-01-08 13:38:33,persegiMerah,773,94,128,144,112,42,111,44,1,2,True,0.10541397742505612
2025-01-08 13:38:33,persegiMerah,757,94,136,151,147,74,147,73,0,1,False,0.1463539531936404
2025-01-08 13:38:33,persegiMerah,768,101,120,143,22,2,17,0,5,2,True,0.24998902828480185
2025-01-08 13:38:34,persegiMerah,751,134,118,143,196,38,198,36,2,2,True,0.2861348298549063
2025-01-08 13:38:34,persegiMerah,756,114,130,149,187,67,186,64,1,3,True,0.26686069544224594
2025-01-08 13:39:24,persegiMerah,760,119,124,146,199,21,203,25,4,4,True,0.44815904868049616
2025-01-08 13:39:24,Merah,760,119,tensor(124.0578),tensor(146.7694),166,70,166,73,0,3,True,0.0005002021789550781
2025-01-08 13:39:25,persegiMerah,758,132,123,147,45,74,41,78,4,4,False,0.23960079031172904
2025-01-08 13:39:26,persegiMerah,781,104,127,147,95,54,94,57,1,3,True,0.4665694462574953
2025-01-08 13:39:26,Merah,781,104,tensor(127.6304),tensor(147.4856),171,72,166,73,5,1,True,0.0004990100860595703
2025-01-08 13:39:27,persegiMerah,810,124,135,144,119,96,116,93,3,3,False,0.4985371479647872
2025-01-08 13:39:28,persegiMerah,782,128,123,144,89,69,85,67,4,2,True,0.49265662317227255
2025-01-08 13:39:28,Merah,782,128,tensor(123.3868),tensor(144.4923),164,72,166,67,2,5,True,0.0
2025-01-08 13:39:55,persegiMerah,854,568,117,118,28,33,23,32,5,1,True,0.17226573309353954
2025-01-08 13:39:55,Merah,854,568,tensor(117.3644),tensor(118.2169),42,79,42,82,0,3,True,0.0
2025-01-08 13:39:56,persegiMerah,834,581,128,127,23,77,21,79,2,2,True,0.48732997563539804
2025-01-08 13:39:56,persegiMerah,855,558,126,126,175,19,173,20,2,1,True,0.28003076882964273
2025-01-08 13:39:56,Merah,855,558,tensor(126.3731),tensor(126.2271),45,79,46,79,1,0,True,0.0
2025-01-08 13:39:57,persegiMerah,838,577,131,123,130,38,131,36,1,2,False,0.4499102102130913
2025-01-08 13:39:57,persegiKuning,836,579,128,124,179,68,176,71,3,3,True,0.20996098476031633
2025-01-08 13:39:57,Fail to pick,836,579,0,0,0,0,0,0,0,0,False,0
2025-01-08 13:39:57,persegiMerah,837,586,130,128,15,48,16,45,1,3,True,0.1493968933634988
2025-01-08 13:39:57,Fail to pick,837,586,0,0,0,0,0,0,0,0,False,0
2025-01-08 13:39:57,persegiMerah,838,571,133,129,133,9,130,10,3,1,True,0.3561567309733541
2025-01-08 13:39:57,persegiMerah,840,591,130,125,188,91,183,86,5,5,True,0.49811397909720423
2025-01-08 13:39:57,persegiMerah,846,574,125,127,33,43,29,44,4,1,True,0.1155498703049394
2025-01-08 13:39:58,persegiMerah,842,586,126,128,80,25,77,26,3,1,True,0.22949552650467808
2025-01-08 13:39:58,Merah,842,586,tensor(126.1074),tensor(128.7236),37,77,32,76,5,1,True,0.0004985332489013672
2025-01-08 13:39:58,persegiMerah,843,578,126,126,148,69,143,65,5,4,True,0.11691554841555561
2025-01-08 13:39:58,Fail to pick,843,578,0,0,0,0,0,0,0,0,False,0
2025-01-08 13:40:05,persegiMerah,838,583,130,130,99,55,99,50,0,5,True,0.22960881051963816
2025-01-08 13:40:05,Merah,838,583,tensor(130.4493),tensor(130.2741),38,77,37,74,1,3,True,0.0
2025-01-08 13:40:05,Fail to pick,838,583,0,0,0,0,0,0,0,0,False,0
2025-01-08 13:40:05,persegiMerah,836,570,129,123,73,79,74,80,1,1,True,0.2218580559091338
2025-01-08 13:40:05,persegiMerah,847,584,132,125,22,83,22,79,0,4,True,0.45584994435051096
2025-01-08 13:40:05,persegiMerah,847,584,132,125,136,60,139,58,3,2,True,0.10841794277093136
2025-01-08 13:40:05,Fail to pick,847,584,0,0,0,0,0,0,0,0,False,0
2025-01-08 13:40:05,persegiMerah,860,575,142,125,76,99,76,95,0,4,False,0.3490172791513826
2025-01-08 13:40:05,persegiMerah,833,577,129,125,2,56,0,53,2,3,True,0.4718003709049169
2025-01-08 13:40:06,persegiMerah,840,583,131,122,32,64,33,61,1,3,True,0.1406500625257263
2025-01-08 13:40:06,Fail to pick,840,583,0,0,0,0,0,0,0,0,False,0
2025-01-08 13:40:06,persegiMerah,838,581,128,122,64,75,65,75,1,0,True,0.14183286090644304
2025-01-08 13:40:06,Merah,838,581,tensor(128.0222),tensor(122.7213),38,77,38,81,0,4,True,0.0004949569702148438
2025-01-08 13:40:06,Fail to pick,838,581,0,0,0,0,0,0,0,0,False,0
2025-01-08 13:40:06,persegiMerah,845,589,128,122,10,50,14,45,4,5,True,0.1847984223487781
2025-01-08 13:40:06,Fail to pick,845,589,0,0,0,0,0,0,0,0,False,0
2025-01-08 13:40:07,persegiMerah,845,588,126,126,37,61,39,62,2,1,True,0.21647695360769068
2025-01-08 13:40:07,Fail to pick,845,588,0,0,0,0,0,0,0,0,False,0
2025-01-08 13:40:07,persegiMerah,845,572,136,127,199,72,200,73,1,1,True,0.33861271617016964
2025-01-08 13:40:07,persegiMerah,855,591,124,124,35,70,31,73,4,3,True,0.2499757541249316
2025-01-08 13:46:34,persegiMerah,859,521,117,128,18,5,15,2,3,3,True,0.3963142950275578
2025-01-08 13:46:34,Merah,859,521,tensor(117.6687),tensor(128.5141),55,79,52,77,3,2,True,0.0004973411560058594
2025-01-08 13:46:35,persegiMerah,828,527,141,129,151,14,150,17,1,3,True,0.14090314075569854
2025-01-08 13:46:35,persegiMerah,835,531,137,127,164,70,166,69,2,1,True,0.12489881160291852
2025-01-08 13:46:35,Fail to pick,835,531,0,0,0,0,0,0,0,0,False,0
2025-01-08 13:46:35,persegiMerah,821,531,142,127,134,14,131,11,3,3,True,0.47026667456705495
2025-01-08 13:46:35,Merah,821,531,tensor(142.5538),tensor(127.6621),52,76,56,78,4,2,True,0.0004999637603759766
2025-01-08 13:46:35,persegiMerah,843,541,139,120,29,48,32,44,3,4,True,0.14276920531305326
2025-01-08 13:46:36,persegiMerah,842,543,138,119,131,69,131,72,0,3,True,0.24699477323894597
2025-01-08 13:46:36,Fail to pick,842,543,0,0,0,0,0,0,0,0,False,0
2025-01-08 13:46:36,persegiMerah,818,540,136,126,196,36,198,40,2,4,True,0.3686873629170039
2025-01-08 13:46:36,persegiMerah,822,531,135,126,179,62,177,59,2,3,True,0.4654233551929573
2025-01-08 13:46:36,Fail to pick,822,531,0,0,0,0,0,0,0,0,False,0
2025-01-08 13:46:45,persegiMerah,965,671,148,88,64,99,63,103,1,4,True,0.15937782230364844
2025-01-08 13:46:45,Merah,965,671,tensor(148.4777),tensor(88.4959),13,89,12,86,1,3,True,0.0
2025-01-08 13:46:46,persegiMerah,963,671,150,85,69,92,69,88,0,4,False,0.17784291727833812
2025-01-08 13:46:46,Fail to pick,963,671,0,0,0,0,0,0,0,0,False,0
2025-01-08 13:46:46,persegiMerah,975,664,148,105,109,44,105,39,4,5,True,0.4314615335781794
2025-01-08 13:46:46,persegiMerah,975,664,148,105,191,69,195,71,4,2,True,0.42027238587488125
2025-01-08 13:46:46,Fail to pick,975,664,0,0,0,0,0,0,0,0,False,0
2025-01-08 13:46:47,persegiMerah,958,649,138,116,11,98,12,102,1,4,False,0.36584446904538326
2025-01-08 13:46:47,Merah,958,649,tensor(138.1826),tensor(116.5168),19,88,17,90,2,2,True,0.0
2025-01-08 13:46:48,persegiMerah,954,656,134,111,188,52,186,47,2,5,True,0.1905643410285018
2025-01-08 13:46:48,Fail to pick,954,656,0,0,0,0,0,0,0,0,False,0
2025-01-08 13:46:48,persegiMerah,962,640,135,115,194,77,196,75,2,2,True,0.24976076708482636
2025-01-08 13:46:49,persegiMerah,962,661,137,105,31,41,30,44,1,3,True,0.3381958519388242
2025-01-08 13:46:49,Merah,962,661,tensor(137.6589),tensor(105.6036),16,89,17,93,1,4,True,0.0005004405975341797
2025-01-08 13:46:49,persegiMerah,961,663,131,98,28,45,25,41,3,4,True,0.18296378362727192
2025-01-08 13:46:49,Fail to pick,961,663,0,0,0,0,0,0,0,0,False,0
2025-01-08 13:46:49,persegiMerah,968,659,142,110,97,2,100,-1,3,3,True,0.3499303752260904
2025-01-08 13:46:49,Fail to pick,968,659,0,0,0,0,0,0,0,0,False,0
2025-01-08 13:46:50,persegiMerah,959,651,137,112,97,14,96,11,1,3,False,0.4130564988551422
2025-01-08 13:46:50,Merah,959,651,tensor(137.2573),tensor(112.3771),19,88,20,87,1,1,True,0.0004999637603759766
2025-01-08 13:46:50,Fail to pick,959,651,0,0,0,0,0,0,0,0,False,0
2025-01-08 13:46:50,persegiMerah,959,651,137,112,108,94,108,95,0,1,True,0.3291295418939244
2025-01-08 13:46:50,Fail to pick,959,651,0,0,0,0,0,0,0,0,False,0
2025-01-08 13:46:50,persegiMerah,944,660,139,109,42,18,45,15,3,3,True,0.26254154406265084
2025-01-08 13:46:50,persegiMerah,957,660,134,105,148,23,145,23,3,0,True,0.4285212928057208
2025-01-08 13:46:56,persegiMerah,960,664,143,104,173,62,175,65,2,3,True,0.4160456066857048
2025-01-08 13:46:56,Merah,960,664,tensor(143.5266),tensor(104.0063),15,88,11,85,4,3,True,0.0004982948303222656
2025-01-08 13:46:56,Fail to pick,960,664,0,0,0,0,0,0,0,0,False,0
2025-01-08 13:46:57,persegiMerah,936,676,139,80,171,30,172,28,1,2,True,0.2649824261206837
2025-01-08 13:47:02,persegiMerah,1026,607,106,128,1,68,2,72,1,4,True,0.22691228414486164
2025-01-08 13:47:02,Merah,1026,607,tensor(106.4525),tensor(128.0945),31,95,34,90,3,5,True,0.0004925727844238281
2025-01-08 13:47:02,persegiMerah,1037,575,85,122,155,5,150,2,5,3,True,0.2270638761365978
2025-01-08 13:47:02,persegiMerah,1037,580,84,122,176,24,171,28,5,4,False,0.35728757298627967
2025-01-08 13:47:02,Fail to pick,1037,580,0,0,0,0,0,0,0,0,False,0
2025-01-08 13:47:03,persegiMerah,1035,582,87,121,46,70,44,74,2,4,True,0.4481077381902311
2025-01-08 13:47:03,Fail to pick,1035,582,0,0,0,0,0,0,0,0,False,0
2025-01-08 13:47:03,persegiMerah,1017,554,124,141,181,20,181,19,0,1,True,0.34758083586981187
2025-01-08 13:47:03,Merah,1017,554,tensor(124.0443),tensor(141.0677),46,94,46,97,0,3,True,0.0
2025-01-08 13:47:03,persegiMerah,1034,592,91,125,64,37,61,40,3,3,True,0.15589600023947425
2025-01-08 13:47:05,persegiMerah,1040,579,79,121,107,82,109,86,2,4,True,0.23985270611699627
2025-01-08 13:47:05,Merah,1040,579,tensor(79.3510),tensor(121.9095),39,96,43,100,4,4,True,0.0
2025-01-08 13:47:06,persegiMerah,1028,561,102,129,182,40,186,41,4,1,True,0.30008962516943505
2025-01-08 13:47:06,persegiMerah,1023,574,112,128,182,53,178,48,4,5,True,0.1887176734337758
2025-01-08 13:54:36,persegiMerah,923,49,120,99,177,18,175,15,2,3,True,0.13347111199114875
2025-01-08 13:54:36,Merah,923,49,tensor(120.0032),tensor(99.2553),186,85,185,84,1,1,True,0.0005109310150146484
2025-01-08 13:54:36,persegiMerah,914,45,127,90,52,34,50,38,2,4,True,0.1205754925274865
2025-01-08 13:54:36,Fail to pick,914,45,0,0,0,0,0,0,0,0,False,0
2025-01-08 13:54:37,persegiMerah,1009,58,139,117,133,55,128,50,5,5,True,0.3575259780329838
2025-01-08 13:54:37,persegiMerah,923,33,118,66,136,79,140,74,4,5,True,0.11675435190681821
2025-01-08 13:54:37,persegiMerah,1018,63,123,126,149,50,145,50,4,0,True,0.217914518984973
2025-01-08 13:54:38,persegiMerah,926,43,123,87,57,94,58,96,1,2,True,0.4748021583856573
2025-01-08 13:54:40,persegiMerah,947,63,121,126,76,69,78,70,2,1,True,0.3779923177018697
2025-01-08 13:54:40,persegiMerah,928,66,111,132,181,74,184,72,3,2,True,0.43304364232622694
2025-01-08 13:54:40,Merah,928,66,tensor(111.8072),tensor(132.8360),181,85,177,85,4,0,True,0.0
2025-01-08 13:54:40,persegiMerah,931,53,127,107,109,42,105,46,4,4,True,0.13932388590168615
2025-01-08 13:54:41,persegiMerah,1005,66,146,132,82,70,83,71,1,1,True,0.14361079747025932
2025-01-08 13:54:41,persegiMerah,924,66,120,132,45,16,49,19,4,3,True,0.10979463385757403
2025-01-08 13:54:41,persegiMerah,1015,65,128,130,119,89,118,88,1,1,True,0.10324480989990051
2025-01-08 13:54:42,persegiMerah,916,54,134,109,77,69,78,72,1,3,True,0.39236446229584887
2025-01-08 13:54:42,Merah,916,54,tensor(134.4598),tensor(109.8224),185,84,187,82,2,2,True,0.0004999637603759766
2025-01-08 13:54:42,persegiMerah,933,48,131,96,198,12,201,10,3,2,True,0.12612676789573338
2025-01-08 13:54:54,persegiMerah,924,45,123,90,156,53,159,54,3,1,True,0.22014523784812098
2025-01-08 13:54:54,Merah,924,45,tensor(123.4395),tensor(90.8895),187,85,189,84,2,1,True,0.0
2025-01-08 13:54:54,Fail to pick,924,45,0,0,0,0,0,0,0,0,False,0
2025-01-08 13:54:54,persegiMerah,1013,62,133,125,155,32,150,35,5,3,True,0.3852339426596141
2025-01-08 13:54:54,persegiMerah,1007,63,145,126,47,29,51,29,4,0,True,0.4853779768026486
2025-01-08 13:54:54,Fail to pick,1007,63,0,0,0,0,0,0,0,0,False,0
2025-01-08 13:54:55,persegiMerah,928,39,128,79,104,15,107,11,3,4,True,0.34117657674991075
2025-01-08 13:54:55,Merah,928,39,tensor(128.5652),tensor(79.2635),189,85,184,89,5,4,True,0.0005021095275878906
2025-01-08 13:54:56,persegiMerah,927,56,124,113,26,63,23,65,3,2,True,0.334413544220197
2025-01-08 13:54:56,Merah,927,56,tensor(124.2212),tensor(113.2470),184,85,184,88,0,3,True,0.0005295276641845703
2025-01-08 13:54:57,persegiMerah,927,48,125,97,155,1,155,-4,0,5,True,0.12046805047813192
2025-01-08 13:54:57,Fail to pick,927,48,0,0,0,0,0,0,0,0,False,0
2025-01-08 13:54:57,persegiMerah,930,50,122,101,66,25,69,21,3,4,True,0.3068447889069561
2025-01-08 13:54:57,Fail to pick,930,50,0,0,0,0,0,0,0,0,False,0
2025-01-08 13:54:57,persegiMerah,916,50,129,100,135,72,137,72,2,0,True,0.40120026056155267
2025-01-08 13:54:57,Merah,916,50,tensor(129.5674),tensor(100.4147),186,84,185,80,1,4,True,0.0005056858062744141
2025-01-08 13:55:19,persegiMerah,970,580,151,124,65,13,64,15,1,2,True,0.21761844021779903
2025-01-08 13:55:19,Merah,970,580,tensor(151.4301),tensor(124.8218),38,89,42,92,4,3,True,0.0
2025-01-08 13:55:19,persegiMerah,970,582,150,127,172,73,174,77,2,4,True,0.31801737530131635
2025-01-08 13:55:19,Fail to pick,970,582,0,0,0,0,0,0,0,0,False,0
2025-01-08 13:55:19,persegiMerah,962,597,148,119,60,40,57,37,3,3,True,0.3757242624323578
2025-01-08 13:55:22,segienamMerah,1042,600,74,111,104,80,101,83,3,3,True,0.49827895416121326
2025-01-08 13:55:22,Merah,1042,600,tensor(74.5237),tensor(111.2343),33,96,30,92,3,4,True,0.0004992485046386719
2025-01-08 13:55:35,persegiMerah,1034,572,90,126,83,12,86,14,3,2,True,0.2720086738631392
2025-01-08 13:55:35,Merah,1034,572,tensor(90.9376),tensor(126.0424),41,95,36,95,5,0,True,0.0004980564117431641
2025-01-08 13:55:36,persegiMerah,1031,571,96,126,196,56,191,60,5,4,True,0.34440549936224374
2025-01-08 13:55:36,Fail to pick,1031,571,0,0,0,0,0,0,0,0,False,0
2025-01-08 13:55:36,persegiMerah,1032,574,95,126,8,19,6,22,2,3,True,0.4928202085651934
2025-01-08 13:55:36,Fail to pick,1032,574,0,0,0,0,0,0,0,0,False,0
2025-01-08 13:55:36,persegiMerah,1029,576,101,124,113,35,111,36,2,1,False,0.32967223407306734
2025-01-08 13:55:36,Fail to pick,1029,576,0,0,0,0,0,0,0,0,False,0
2025-01-08 13:55:37,persegiMerah,1021,581,117,125,93,28,92,29,1,1,True,0.13045871369844464
2025-01-08 13:55:37,Fail to pick,1021,581,0,0,0,0,0,0,0,0,False,0
2025-01-08 13:55:37,persegiMerah,1021,581,117,125,3,47,0,46,3,1,True,0.3121568577697116
2025-01-08 13:55:37,Merah,1021,581,tensor(117.3863),tensor(125.8873),38,94,41,95,3,1,True,0.0
2025-01-08 13:55:37,Fail to pick,1021,581,0,0,0,0,0,0,0,0,False,0
2025-01-08 13:55:37,persegiMerah,907,642,140,119,81,69,78,67,3,2,True,0.4968138945716144
2025-01-08 13:55:37,persegiMerah,943,652,131,103,75,33,73,28,2,5,True,0.27037537575806436
2025-01-08 13:55:38,persegiMerah,937,611,132,115,96,80,99,75,3,5,True,0.2732464781108782
2025-01-08 13:55:38,persegiMerah,935,608,130,116,45,16,45,18,0,2,False,0.36996912278269
2025-01-08 13:55:38,Fail to pick,935,608,0,0,0,0,0,0,0,0,False,0
2025-01-08 13:55:38,persegiMerah,939,609,128,115,73,50,68,52,5,2,True,0.34997121410518506
2025-01-08 13:55:38,Fail to pick,939,609,0,0,0,0,0,0,0,0,False,0
2025-01-08 13:55:38,persegiMerah,921,642,130,112,46,37,47,36,1,1,True,0.49341863112268214
2025-01-08 13:55:38,persegiMerah,937,621,125,116,65,20,68,18,3,2,True,0.3464013152440415
2025-01-08 13:55:38,persegiMerah,951,606,124,114,131,59,128,56,3,3,True,0.4971335406681404
2025-01-08 13:55:38,persegiMerah,919,644,133,112,36,61,40,61,4,0,True,0.4488852977375426
2025-01-08 13:55:38,persegiMerah,935,653,131,102,40,87,40,85,0,2,False,0.2802065826222471
2025-01-08 13:55:38,Merah,935,653,tensor(131.1218),tensor(102.5224),18,86,18,90,0,4,True,0.0
2025-01-08 13:55:39,persegiMerah,920,646,129,109,161,32,164,31,3,1,True,0.2952982892317676
2025-01-08 13:55:39,persegiMerah,943,608,124,114,152,51,155,49,3,2,True,0.3984903912136438
2025-01-08 13:55:39,persegiMerah,931,618,129,116,111,0,111,-3,0,3,True,0.4594881199673291
2025-01-08 13:55:39,persegiMerah,970,632,129,105,158,63,160,61,2,2,True,0.3204358639007035
2025-01-08 13:55:39,persegiMerah,919,635,130,115,10,97,13,94,3,3,True,0.4289045068069637
2025-01-08 13:55:39,persegiMerah,915,642,128,113,57,24,55,25,2,1,True,0.14142818585438932
2025-01-08 13:55:39,Fail to pick,915,642,0,0,0,0,0,0,0,0,False,0
2025-01-08 13:55:39,persegiMerah,915,642,129,113,55,4,57,-1,2,5,False,0.3511368017841805
2025-01-08 13:55:39,Fail to pick,915,642,0,0,0,0,0,0,0,0,False,0
2025-01-08 13:55:39,persegiMerah,913,639,131,114,28,50,31,50,3,0,True,0.14375773940098277
2025-01-08 13:55:39,Fail to pick,913,639,0,0,0,0,0,0,0,0,False,0
2025-01-08 13:55:39,persegiMerah,915,636,129,114,87,6,86,8,1,2,True,0.3444088704728737
2025-01-08 13:55:39,Fail to pick,915,636,0,0,0,0,0,0,0,0,False,0
2025-01-08 13:55:40,persegiMerah,914,638,128,114,134,72,135,76,1,4,True,0.1676856428712057
2025-01-08 13:55:40,Merah,914,638,tensor(128.5085),tensor(114.4908),22,84,26,83,4,1,True,0.0
2025-01-08 13:55:40,Fail to pick,914,638,0,0,0,0,0,0,0,0,False,0
2025-01-08 13:55:40,persegiMerah,920,641,131,113,157,90,155,91,2,1,True,0.3723601015431477
2025-01-08 13:55:40,Fail to pick,920,641,0,0,0,0,0,0,0,0,False,0
2025-01-08 13:55:40,persegiMerah,916,639,133,116,13,0,15,-3,2,3,True,0.47497163971966627
2025-01-08 13:55:40,Fail to pick,916,639,0,0,0,0,0,0,0,0,False,0
2025-01-08 13:55:40,persegiMerah,928,614,132,119,181,70,179,67,2,3,True,0.2375917299280711
2025-01-08 13:55:40,persegiMerah,915,638,130,114,129,48,129,47,0,1,True,0.17854690241400495
2025-01-08 13:55:40,persegiMerah,946,606,125,111,173,23,176,25,3,2,True,0.252527932834957
2025-01-08 13:55:40,persegiMerah,934,652,131,104,78,81,80,77,2,4,True,0.1418298244872438
2025-01-08 13:55:40,persegiMerah,959,635,129,106,107,74,107,74,0,0,True,0.15291725612814644
2025-01-08 13:55:41,persegiMerah,960,638,130,103,127,97,130,92,3,5,True,0.2703140124854223
2025-01-08 13:55:41,Fail to pick,960,638,0,0,0,0,0,0,0,0,False,0
2025-01-08 13:55:41,persegiMerah,920,629,130,116,119,35,123,34,4,1,True,0.39366352463556786
2025-01-08 13:55:41,Merah,920,629,tensor(130.7755),tensor(116.2595),25,85,24,84,1,1,True,0.0
2025-01-08 13:55:41,persegiMerah,920,630,131,118,11,34,6,34,5,0,True,0.41714107252470756
2025-01-08 13:55:41,Fail to pick,920,630,0,0,0,0,0,0,0,0,False,0
2025-01-08 13:55:41,persegiMerah,969,633,129,105,54,69,50,70,4,1,True,0.47377260135257504
2025-01-08 13:55:41,persegiMerah,921,631,130,119,89,58,84,62,5,4,True,0.23108500872178706
2025-01-08 13:55:41,persegiMerah,924,630,126,118,48,10,49,13,1,3,True,0.1897213555168532
2025-01-08 13:55:41,Fail to pick,924,630,0,0,0,0,0,0,0,0,False,0
2025-01-08 13:55:42,persegiMerah,919,628,133,118,51,37,49,34,2,3,True,0.22475351055347692
2025-01-08 13:55:42,Fail to pick,919,628,0,0,0,0,0,0,0,0,False,0
2025-01-08 13:55:42,persegiMerah,920,632,132,116,34,89,34,91,0,2,True,0.35503718339946844
2025-01-08 13:55:42,Merah,920,632,tensor(132.6301),tensor(116.0231),24,85,19,85,5,0,True,0.0005021095275878906
2025-01-08 13:55:42,Fail to pick,920,632,0,0,0,0,0,0,0,0,False,0
2025-01-08 13:55:42,persegiMerah,956,632,133,108,4,54,1,57,3,3,True,0.1382500829283759
2025-01-08 13:55:42,persegiMerah,919,631,133,118,23,1,19,2,4,1,True,0.2644980094984096
2025-01-08 13:55:42,persegiMerah,910,650,133,115,12,42,12,38,0,4,True,0.4903778592966982
2025-01-08 13:55:42,persegiMerah,954,608,135,115,11,91,15,90,4,1,True,0.3064627820312625
2025-01-08 13:55:42,persegiMerah,948,616,136,110,41,8,44,9,3,1,True,0.1293449126087799
2025-01-08 13:55:42,Fail to pick,948,616,0,0,0,0,0,0,0,0,False,0
2025-01-08 13:55:43,persegiMerah,920,641,133,122,18,83,15,84,3,1,True,0.24821455825296843
2025-01-08 13:55:43,persegiMerah,919,634,132,117,117,90,112,90,5,0,True,0.4792683040413137
2025-01-08 13:55:43,Fail to pick,919,634,0,0,0,0,0,0,0,0,False,0
2025-01-08 13:55:43,persegiMerah,919,635,132,117,82,39,79,43,3,4,True,0.15571113220640054
2025-01-08 13:55:43,Merah,919,635,tensor(132.7042),tensor(117.6514),23,85,19,82,4,3,True,0.0005064010620117188
2025-01-08 13:55:43,Fail to pick,919,635,0,0,0,0,0,0,0,0,False,0
2025-01-08 13:55:43,persegiMerah,922,631,132,118,105,85,107,82,2,3,True,0.48050072502356134
2025-01-08 13:55:43,Fail to pick,922,631,0,0,0,0,0,0,0,0,False,0
2025-01-08 13:55:43,persegiMerah,949,608,126,113,55,26,56,24,1,2,True,0.17157159722290918
2025-01-08 13:55:43,persegiMerah,917,643,131,113,132,54,127,53,5,1,True,0.26773680004856076
2025-01-08 13:55:43,persegiMerah,960,629,129,108,104,71,105,70,1,1,True,0.1132184303274638
2025-01-08 13:55:43,persegiMerah,953,606,126,114,126,90,124,91,2,1,True,0.466539171436375
2025-01-08 13:55:43,persegiMerah,953,603,130,115,135,38,132,39,3,1,True,0.11480223933200229
2025-01-08 13:55:43,Fail to pick,953,603,0,0,0,0,0,0,0,0,False,0
2025-01-08 13:55:44,persegiMerah,918,638,129,114,96,52,93,50,3,2,True,0.3984570667748335
2025-01-08 13:55:44,persegiMerah,918,638,129,114,146,90,141,91,5,1,True,0.42055534219033375
2025-01-08 13:55:44,Fail to pick,918,638,0,0,0,0,0,0,0,0,False,0
2025-01-08 13:55:44,persegiMerah,912,645,132,112,2,53,1,50,1,3,True,0.2828934053585478
2025-01-08 13:55:44,Fail to pick,912,645,0,0,0,0,0,0,0,0,False,0
2025-01-08 13:55:44,persegiMerah,915,646,131,115,162,47,165,43,3,4,True,0.2555495455450197
2025-01-08 13:55:44,Merah,915,646,tensor(131.8330),tensor(115.0396),20,84,23,80,3,4,True,0.0
2025-01-08 13:55:44,Fail to pick,915,646,0,0,0,0,0,0,0,0,False,0
2025-01-08 13:55:44,persegiMerah,915,646,129,114,108,7,107,10,1,3,False,0.40996791751480244
2025-01-08 13:55:44,Fail to pick,915,646,0,0,0,0,0,0,0,0,False,0
2025-01-08 13:55:44,persegiMerah,957,601,129,114,113,59,108,59,5,0,True,0.23392584874151945
2025-01-08 13:55:44,persegiMerah,949,605,128,114,180,50,179,45,1,5,True,0.16790508393629106
2025-01-08 13:55:44,Fail to pick,949,605,0,0,0,0,0,0,0,0,False,0
2025-01-08 13:55:45,persegiMerah,915,639,128,113,104,28,104,32,0,4,True,0.241611379918308
2025-01-08 13:55:45,persegiMerah,952,603,129,113,14,46,11,50,3,4,True,0.46050076884880253
2025-01-08 13:55:45,persegiMerah,947,608,125,114,93,72,95,68,2,4,True,0.2865997648363321
2025-01-08 13:55:45,Fail to pick,947,608,0,0,0,0,0,0,0,0,False,0
2025-01-08 13:55:45,persegiMerah,935,654,128,101,39,18,34,17,5,1,True,0.33882877290607616
2025-01-08 13:55:45,persegiMerah,920,643,129,117,11,20,14,20,3,0,True,0.11661081350806737
2025-01-08 13:55:45,Merah,920,643,tensor(129.3302),tensor(117.6591),21,85,23,80,2,5,True,0.0
2025-01-08 13:55:45,persegiMerah,949,608,127,113,142,89,143,86,1,3,True,0.2581580388921759
2025-01-08 13:55:45,persegiMerah,911,644,134,114,129,56,133,57,4,1,True,0.1341268923231661
2025-01-08 13:55:45,persegiMerah,917,644,131,109,40,61,37,64,3,3,True,0.10920986935190778
2025-01-08 13:55:45,Fail to pick,917,644,0,0,0,0,0,0,0,0,False,0
2025-01-08 13:55:46,persegiMerah,934,652,131,105,125,49,129,50,4,1,True,0.3760675034390869
2025-01-08 13:55:46,persegiMerah,913,650,131,112,1,15,-2,12,3,3,True,0.1543636943216134
2025-01-08 13:55:46,persegiMerah,915,640,128,114,92,55,88,58,4,3,True,0.33464883943210744
2025-01-08 13:55:46,persegiMerah,916,647,132,112,161,26,161,27,0,1,True,0.49149879444653577
2025-01-08 13:55:46,Fail to pick,916,647,0,0,0,0,0,0,0,0,False,0
2025-01-08 13:55:46,persegiMerah,916,647,132,112,190,30,185,28,5,2,True,0.36314803039712085
2025-01-08 13:55:46,Merah,916,647,tensor(132.6463),tensor(112.5045),20,84,15,88,5,4,True,0.0004994869232177734
2025-01-08 13:55:46,Fail to pick,916,647,0,0,0,0,0,0,0,0,False,0
2025-01-08 13:55:46,persegiMerah,949,609,127,114,11,86,8,86,3,0,True,0.23361066834274968
2025-01-08 13:55:46,persegiMerah,954,604,128,113,59,76,63,73,4,3,True,0.20000616572194532
2025-01-08 13:55:46,Fail to pick,954,604,0,0,0,0,0,0,0,0,False,0
2025-01-08 13:55:49,persegiMerah,200,560,132,119,158,97,162,92,4,5,True,0.41571366143592303
2025-01-08 13:55:49,Merah,200,560,tensor(132.1546),tensor(119.4890),44,18,44,18,0,0,True,0.0
2025-01-08 13:55:49,persegiMerah,198,562,133,121,66,16,69,17,3,1,True,0.12006060920709438
2025-01-08 13:55:49,Fail to pick,198,562,0,0,0,0,0,0,0,0,False,0
2025-01-08 13:55:49,persegiMerah,201,560,134,121,64,17,68,17,4,0,True,0.15159018609579428
2025-01-08 13:55:49,Fail to pick,201,560,0,0,0,0,0,0,0,0,False,0
2025-01-08 13:55:49,persegiMerah,196,565,134,121,41,81,43,79,2,2,True,0.407708980500074
2025-01-08 13:55:49,Fail to pick,196,565,0,0,0,0,0,0,0,0,False,0
2025-01-08 13:55:50,persegiMerah,193,566,134,117,171,5,174,1,3,4,True,0.31887988262536315
2025-01-08 13:55:50,Fail to pick,193,566,0,0,0,0,0,0,0,0,False,0
2025-01-08 13:55:50,persegiMerah,192,567,132,118,105,7,104,10,1,3,True,0.32507576494153834
2025-01-08 13:55:50,Fail to pick,192,567,0,0,0,0,0,0,0,0,False,0
2025-01-08 13:55:50,persegiMerah,198,558,134,119,164,63,162,59,2,4,True,0.20759306610506015
2025-01-08 13:55:50,Fail to pick,198,558,0,0,0,0,0,0,0,0,False,0
2025-01-08 13:55:50,persegiMerah,165,601,132,110,149,96,145,93,4,3,True,0.10993386761105804
2025-01-08 13:55:50,persegiMerah,173,575,124,120,198,31,200,28,2,3,True,0.3978781509758237
2025-01-08 13:55:50,Merah,173,575,tensor(124.8317),tensor(120.1265),40,16,35,16,5,0,True,0.0004982948303222656
2025-01-08 13:55:50,persegiMerah,197,588,133,117,156,91,160,92,4,1,True,0.30716717780011243
2025-01-08 13:55:50,persegiMerah,195,592,131,113,155,28,150,27,5,1,True,0.274785373293282
2025-01-08 13:55:50,Fail to pick,195,592,0,0,0,0,0,0,0,0,False,0
2025-01-08 13:55:51,persegiMerah,161,584,128,116,22,57,17,52,5,5,False,0.18736472852787905
2025-01-08 13:55:51,persegiMerah,198,563,133,119,147,63,144,64,3,1,True,0.27407432081252237
2025-01-08 13:55:51,persegiMerah,173,579,126,118,198,15,201,17,3,2,True,0.4639663687970087
2025-01-08 13:55:51,persegiMerah,203,591,135,112,157,70,156,65,1,5,True,0.17502216548219793
2025-01-08 13:55:51,Merah,203,591,tensor(135.7384),tensor(112.9302),35,18,39,19,4,1,True,0.0
2025-01-08 13:55:51,persegiMerah,174,575,126,119,188,80,185,79,3,1,True,0.224890855810902
2025-01-08 13:55:51,persegiMerah,201,597,133,111,96,74,100,73,4,1,True,0.1936319360214081
2025-01-08 13:55:52,persegiMerah,180,572,130,118,153,28,153,23,0,5,True,0.23615715216654665
2025-01-08 13:55:52,persegiMerah,158,589,127,116,22,62,26,62,4,0,True,0.20236726229569157
2025-01-08 13:55:52,persegiMerah,156,590,128,113,111,99,115,98,4,1,True,0.251580420329372
2025-01-08 13:55:52,Fail to pick,156,590,0,0,0,0,0,0,0,0,False,0
2025-01-08 13:55:52,persegiMerah,194,564,132,118,188,88,191,92,3,4,False,0.4522745828418072
2025-01-08 13:55:52,persegiMerah,167,577,126,118,99,83,97,82,2,1,True,0.34230848586033247
2025-01-08 13:55:52,persegiMerah,151,589,127,117,23,24,26,25,3,1,True,0.2518704041324796
2025-01-08 13:55:52,persegiMerah,175,579,128,119,73,74,75,73,2,1,True,0.3578360967509432
2025-01-08 13:55:52,persegiMerah,192,566,131,118,166,85,161,85,5,0,True,0.2645818334622992
2025-01-08 13:55:52,Merah,192,566,tensor(131.1015),tensor(118.1349),42,17,39,18,3,1,True,0.0
2025-01-08 13:55:52,persegiMerah,196,591,134,113,117,93,121,89,4,4,False,0.21083203366644293
2025-01-08 13:55:53,persegiMerah,196,562,132,119,142,54,146,54,4,0,False,0.36019668864531107
2025-01-08 13:55:53,persegiMerah,169,575,125,117,53,9,52,8,1,1,True,0.15654247975705143
2025-01-08 13:55:53,persegiMerah,191,564,133,118,43,37,46,41,3,4,True,0.11093761537579763
2025-01-08 13:55:53,persegiMerah,178,575,128,119,28,60,32,59,4,1,True,0.29468559446431125
2025-01-08 13:55:53,persegiMerah,156,591,124,116,168,26,166,23,2,3,True,0.1637417409845178
2025-01-08 13:55:53,persegiMerah,149,594,132,114,113,86,111,83,2,3,True,0.13868565287098972
2025-01-08 13:55:53,Fail to pick,149,594,0,0,0,0,0,0,0,0,False,0
2025-01-08 13:55:53,persegiMerah,190,567,131,116,68,94,72,94,4,0,False,0.4856939297145184
2025-01-08 13:55:53,persegiMerah,168,598,132,113,29,4,24,7,5,3,True,0.18750147341749757
2025-01-08 13:55:53,Merah,168,598,tensor(132.1115),tensor(113.5645),33,15,31,10,2,5,True,0.0
2025-01-08 13:55:53,persegiMerah,192,565,132,118,36,22,33,17,3,5,True,0.21135322279422258
2025-01-08 13:55:54,persegiMerah,176,580,128,120,27,34,31,34,4,0,True,0.11128327264468543
2025-01-08 13:55:54,persegiMerah,155,587,129,114,69,44,68,41,1,3,True,0.4241096961530221
2025-01-08 13:55:54,persegiMerah,174,575,124,117,115,69,111,64,4,5,True,0.42341890452538344
2025-01-08 13:55:54,persegiMerah,177,576,126,122,41,10,41,10,0,0,False,0.1661445582826489
2025-01-08 13:55:54,Fail to pick,177,576,0,0,0,0,0,0,0,0,False,0
2025-01-08 13:55:54,persegiMerah,155,588,127,117,176,76,173,80,3,4,True,0.12978611920949215
2025-01-08 13:55:54,persegiMerah,191,563,135,119,134,83,134,78,0,5,True,0.3118227911705106
2025-01-08 13:55:54,persegiMerah,174,575,127,118,122,3,126,-1,4,4,True,0.21443322342729748
2025-01-08 13:55:54,Merah,174,575,tensor(127.7560),tensor(118.4336),40,16,35,12,5,4,True,0.0
2025-01-08 13:55:55,persegiMerah,192,565,133,119,130,6,128,8,2,2,True,0.3882486127925583
2025-01-08 13:55:55,persegiMerah,166,577,125,119,148,8,146,6,2,2,True,0.2737462701265826
2025-01-08 13:55:55,persegiMerah,144,593,131,116,80,79,84,83,4,4,True,0.29710929810411246
2025-01-08 13:55:55,persegiMerah,178,578,129,119,43,87,44,86,1,1,True,0.3288061231539907
2025-01-08 13:55:55,persegiMerah,167,577,126,120,196,99,195,95,1,4,True,0.21091541922721393
2025-01-08 13:55:55,persegiMerah,176,577,126,119,51,53,51,52,0,1,True,0.21502958755237211
2025-01-08 13:55:55,Fail to pick,176,577,0,0,0,0,0,0,0,0,False,0
2025-01-08 13:55:55,persegiMerah,174,577,124,119,144,21,142,22,2,1,True,0.2975173263990459
2025-01-08 13:55:55,Fail to pick,174,577,0,0,0,0,0,0,0,0,False,0
2025-01-08 13:55:55,persegiMerah,175,577,126,119,86,55,89,53,3,2,True,0.4080990570856088
2025-01-08 13:55:55,Fail to pick,175,577,0,0,0,0,0,0,0,0,False,0
2025-01-08 13:55:56,persegiMerah,171,575,126,119,165,39,164,41,1,2,True,0.47957151031678236
2025-01-08 13:55:56,Merah,171,575,tensor(126.1578),tensor(119.7765),40,15,41,11,1,4,True,0.0
2025-01-08 13:55:56,Fail to pick,171,575,0,0,0,0,0,0,0,0,False,0
2025-01-08 13:55:56,persegiMerah,177,576,129,118,59,69,59,66,0,3,True,0.4320060330049814
2025-01-08 13:55:56,Fail to pick,177,576,0,0,0,0,0,0,0,0,False,0
2025-01-08 13:55:56,persegiMerah,154,593,131,115,133,73,137,72,4,1,True,0.3321296044014875
2025-01-08 13:55:56,persegiMerah,192,567,130,117,17,58,19,62,2,4,True,0.15774895671369948
2025-01-08 13:55:56,persegiMerah,159,589,128,117,165,85,168,88,3,3,False,0.22030412136250987
2025-01-08 13:55:56,persegiMerah,155,590,127,116,118,61,116,58,2,3,True,0.39006485428464954
2025-01-08 13:55:56,Fail to pick,155,590,0,0,0,0,0,0,0,0,False,0
2025-01-08 13:55:56,persegiMerah,176,576,129,119,72,93,73,95,1,2,True,0.10396200003069422
2025-01-08 13:55:56,persegiMerah,198,585,132,112,64,53,59,53,5,0,True,0.11178452949240679
2025-01-08 13:55:56,persegiMerah,174,577,125,120,114,84,112,82,2,2,True,0.300856293333558
2025-01-08 13:55:56,persegiMerah,168,576,124,119,49,53,48,54,1,1,True,0.3399100547216466
2025-01-08 13:55:56,Fail to pick,168,576,0,0,0,0,0,0,0,0,False,0
2025-01-08 13:55:57,persegiMerah,175,577,125,118,93,39,90,36,3,3,False,0.11726461625049703
2025-01-08 13:55:57,Merah,175,577,tensor(125.4716),tensor(118.1048),39,16,41,20,2,4,True,0.0004944801330566406
2025-01-08 13:55:57,Fail to pick,175,577,0,0,0,0,0,0,0,0,False,0
2025-01-08 13:55:57,persegiMerah,174,576,124,117,84,36,84,35,0,1,True,0.377439536034618
2025-01-08 13:55:57,Fail to pick,174,576,0,0,0,0,0,0,0,0,False,0
2025-01-08 13:55:57,persegiMerah,192,584,131,116,77,77,76,72,1,5,True,0.4622395668746826
2025-01-08 13:55:57,persegiMerah,170,579,123,117,87,81,83,84,4,3,True,0.39726904280952613
2025-01-08 13:55:57,persegiMerah,165,598,129,112,153,46,156,42,3,4,True,0.34848334218371013
2025-01-08 13:55:57,persegiMerah,172,599,128,111,8,61,10,62,2,1,True,0.24582563714478503
2025-01-08 13:55:57,Fail to pick,172,599,0,0,0,0,0,0,0,0,False,0
2025-01-08 13:55:57,persegiMerah,153,585,124,115,114,63,112,60,2,3,True,0.45029274573256584
2025-01-08 13:55:57,persegiMerah,171,574,123,118,164,32,159,34,5,2,False,0.26143504189290456
2025-01-08 13:55:57,persegiMerah,168,575,123,117,174,67,173,68,1,1,False,0.46225829811694796
2025-01-08 13:55:57,Fail to pick,168,575,0,0,0,0,0,0,0,0,False,0
2025-01-08 13:55:58,persegiMerah,165,599,130,113,149,29,150,27,1,2,True,0.2595729764000043
2025-01-08 13:55:58,persegiMerah,165,577,125,118,178,39,173,38,5,1,True,0.25281193477727243
2025-01-08 13:55:58,Merah,165,577,tensor(125.8620),tensor(118.7666),39,15,43,18,4,3,True,0.0004982948303222656
2025-01-08 13:55:58,persegiMerah,170,574,123,118,46,90,45,87,1,3,True,0.39230762018387055
2025-01-08 13:55:58,Fail to pick,170,574,0,0,0,0,0,0,0,0,False,0
2025-01-08 13:55:58,persegiMerah,140,594,130,116,48,56,45,58,3,2,True,0.18537900421230039
2025-01-08 13:55:58,persegiMerah,190,562,130,117,71,19,72,14,1,5,True,0.26589584109563635
2025-01-08 13:55:58,persegiMerah,195,561,131,119,110,90,108,89,2,1,True,0.11907291973142438
2025-01-08 13:55:58,Fail to pick,195,561,0,0,0,0,0,0,0,0,False,0
2025-01-08 13:55:58,persegiMerah,204,585,132,113,175,75,174,74,1,1,True,0.3537856362948295
2025-01-08 13:55:58,persegiMerah,163,583,125,113,197,72,199,70,2,2,False,0.24471261652848908
2025-01-08 13:55:58,persegiMerah,153,584,122,114,79,50,75,48,4,2,True,0.3666012868182885
2025-01-08 13:55:59,persegiMerah,167,574,123,118,140,11,143,13,3,2,True,0.4693287452544276
2025-01-08 13:55:59,persegiMerah,194,561,130,116,57,18,55,19,2,1,True,0.11374676998984659
2025-01-08 13:55:59,Merah,194,561,tensor(130.7960),tensor(116.5800),44,17,41,19,3,2,True,0.0
2025-01-08 13:55:59,persegiMerah,154,585,121,112,63,61,64,65,1,4,True,0.13050023361543417
2025-01-08 13:55:59,persegiMerah,145,591,129,112,5,63,8,65,3,2,True,0.45991906953316375
2025-01-08 13:55:59,Fail to pick,145,591,0,0,0,0,0,0,0,0,False,0
2025-01-08 13:55:59,persegiMerah,158,587,123,114,101,96,104,91,3,5,True,0.11476891177715626
2025-01-08 13:55:59,persegiMerah,151,587,126,114,93,58,91,55,2,3,True,0.4610309435964336
2025-01-08 13:55:59,Fail to pick,151,587,0,0,0,0,0,0,0,0,False,0
2025-01-08 13:55:59,persegiMerah,160,585,125,114,186,37,185,33,1,4,True,0.2785010845447494
2025-01-08 13:55:59,Fail to pick,160,585,0,0,0,0,0,0,0,0,False,0
2025-01-08 13:55:59,segitigaMerah,149,595,128,112,182,45,177,44,5,1,True,0.31279558750087527
2025-01-08 13:56:00,persegiMerah,170,598,130,111,188,69,183,66,5,3,True,0.3444744766304204
2025-01-08 13:56:00,persegiMerah,172,570,124,119,101,58,101,62,0,4,False,0.31787337914292807
2025-01-08 13:56:00,Merah,172,570,tensor(124.5004),tensor(119.5895),41,15,40,13,1,2,True,0.0004990100860595703
2025-01-08 13:56:00,persegiMerah,140,594,128,114,16,38,17,37,1,1,True,0.20442861458084685
2025-01-08 13:56:00,persegiMerah,164,605,132,107,0,19,-1,14,1,5,True,0.43218683656277856
2025-01-08 13:56:00,persegiMerah,136,594,126,114,67,45,68,47,1,2,True,0.125131642205454
2025-01-08 13:56:00,persegiMerah,187,589,124,113,45,78,41,79,4,1,True,0.30966337850258574
2025-01-08 13:56:00,persegiMerah,143,591,128,113,132,56,134,55,2,1,True,0.15206600489470967
2025-01-08 13:56:00,persegiMerah,172,573,121,117,182,21,181,25,1,4,True,0.2832055843153549
2025-01-08 13:56:00,persegiMerah,176,570,123,121,132,96,128,91,4,5,True,0.45798201760134294
2025-01-08 13:56:00,Fail to pick,176,570,0,0,0,0,0,0,0,0,False,0
2025-01-08 13:56:01,persegiMerah,152,586,128,113,120,36,118,39,2,3,False,0.36595544669369107
2025-01-08 13:56:01,persegiMerah,192,586,126,117,59,95,56,91,3,4,True,0.21878798525089144
2025-01-08 13:56:01,Merah,192,586,tensor(126.2321),tensor(117.1099),37,17,33,15,4,2,True,0.0
2025-01-08 13:56:01,persegiMerah,155,583,120,114,196,57,191,52,5,5,True,0.39899617928008757
2025-01-08 13:56:01,persegiMerah,172,575,123,116,194,98,193,95,1,3,True,0.47168633734710286
2025-01-08 13:56:01,persegiMerah,191,588,129,117,126,51,124,54,2,3,True,0.17254281851340736
2025-01-08 13:56:01,persegiMerah,151,592,129,111,137,3,138,5,1,2,True,0.3402365272827168
2025-01-08 13:56:01,persegiMerah,201,583,131,113,175,92,170,87,5,5,True,0.17201914710562854
2025-01-08 13:56:01,persegiMerah,171,576,124,115,66,66,68,64,2,2,True,0.4098017283002714
2025-01-08 13:56:01,persegiMerah,149,586,126,111,73,3,74,-2,1,5,True,0.13219226549747584
2025-01-08 13:56:02,persegiMerah,152,589,124,116,17,38,17,41,0,3,True,0.33441962330608543
2025-01-08 13:56:02,Fail to pick,152,589,0,0,0,0,0,0,0,0,False,0
2025-01-08 13:56:02,persegiMerah,171,598,130,112,181,3,180,4,1,1,True,0.20295563285930265
2025-01-08 13:56:02,Merah,171,598,tensor(130.9879),tensor(112.3699),33,15,29,17,4,2,True,0.0
2025-01-08 13:56:02,persegiMerah,157,588,123,113,21,47,21,45,0,2,False,0.3241513574815642
2025-01-08 13:56:02,persegiMerah,155,586,124,111,54,77,55,80,1,3,True,0.3035712972972935
2025-01-08 13:56:02,Fail to pick,155,586,0,0,0,0,0,0,0,0,False,0
2025-01-08 13:56:02,persegiMerah,172,599,130,110,101,56,99,57,2,1,True,0.19002802330362908
2025-01-08 13:56:02,persegiMerah,172,600,131,110,123,10,122,11,1,1,True,0.275910790158293
2025-01-08 13:56:02,Fail to pick,172,600,0,0,0,0,0,0,0,0,False,0
2025-01-08 13:56:02,persegiMerah,149,591,125,112,190,25,194,21,4,4,True,0.12752705628619002
2025-01-08 13:56:02,persegiMerah,188,565,125,115,6,14,1,15,5,1,True,0.20621264833293443
2025-01-08 13:56:02,persegiMerah,166,603,132,106,1,50,4,50,3,0,True,0.2844168833065013
2025-01-08 13:56:03,persegiMerah,157,582,121,114,146,70,143,68,3,2,True,0.4221980395055067
2025-01-08 13:56:03,persegiMerah,153,586,127,112,18,1,20,1,2,0,True,0.3773075544890393
2025-01-08 13:56:03,Fail to pick,153,586,0,0,0,0,0,0,0,0,False,0
2025-01-08 13:56:03,persegiMerah,171,600,128,109,181,85,185,80,4,5,True,0.22628152175545502
2025-01-08 13:56:03,Merah,171,600,tensor(128.3156),tensor(109.4467),33,15,35,15,2,0,True,0.0
2025-01-08 13:56:03,persegiMerah,171,597,129,111,18,98,13,100,5,2,True,0.2242870846390118
2025-01-08 13:56:03,Fail to pick,171,597,0,0,0,0,0,0,0,0,False,0
2025-01-08 13:56:03,persegiMerah,177,597,128,112,152,73,156,75,4,2,True,0.3862997930284352
2025-01-08 13:56:03,Fail to pick,177,597,0,0,0,0,0,0,0,0,False,0
2025-01-08 13:56:05,persegiMerah,122,675,130,84,15,68,18,71,3,3,True,0.12310363675274344
2025-01-08 13:56:05,Merah,122,675,tensor(130.0764),tensor(84.2553),12,11,11,13,1,2,True,0.0004992485046386719
2025-01-08 13:56:05,persegiMerah,117,674,127,87,84,16,79,15,5,1,True,0.39987663277723495
2025-01-08 13:56:05,Fail to pick,117,674,0,0,0,0,0,0,0,0,False,0
2025-01-08 13:56:05,persegiMerah,112,678,127,82,140,20,136,18,4,2,True,0.27267923170613134
2025-01-08 13:56:05,Fail to pick,112,678,0,0,0,0,0,0,0,0,False,0
2025-01-08 13:56:05,persegiMerah,115,676,128,87,18,21,18,17,0,4,True,0.39863233160962686
2025-01-08 13:56:05,Fail to pick,115,676,0,0,0,0,0,0,0,0,False,0
2025-01-08 13:56:05,persegiMerah,116,675,130,85,195,39,194,37,1,2,True,0.4641169367072244
2025-01-08 13:56:05,Fail to pick,116,675,0,0,0,0,0,0,0,0,False,0
2025-01-08 13:56:06,persegiMerah,137,667,129,89,140,38,139,35,1,3,True,0.10545546201095593
2025-01-08 13:56:06,Merah,137,667,tensor(129.5501),tensor(89.9619),14,12,10,15,4,3,True,0.0004994869232177734
2025-01-08 13:56:06,persegiMerah,117,676,129,86,10,58,14,56,4,2,True,0.24158945182423916
2025-01-08 13:56:06,persegiMerah,121,675,129,86,2,9,3,5,1,4,False,0.4237756123901685
2025-01-08 13:56:06,Fail to pick,121,675,0,0,0,0,0,0,0,0,False,0
2025-01-08 13:56:06,persegiMerah,120,675,128,84,30,79,31,77,1,2,True,0.2528643676982152
2025-01-08 13:56:06,Fail to pick,120,675,0,0,0,0,0,0,0,0,False,0
2025-01-08 13:56:07,persegiMerah,128,654,128,102,158,47,153,42,5,5,True,0.2528733972517295
2025-01-08 13:56:07,Merah,128,654,tensor(128.4677),tensor(102.0416),18,11,22,9,4,2,True,0.0005071163177490234
2025-01-08 13:56:07,persegiMerah,127,655,128,103,11,8,11,3,0,5,True,0.26011877697358243
2025-01-08 13:56:07,Fail to pick,127,655,0,0,0,0,0,0,0,0,False,0
2025-01-08 13:56:07,persegiMerah,111,678,129,83,28,92,30,91,2,1,False,0.4848560691914716
2025-01-08 13:56:08,persegiMerah,137,653,130,102,131,57,135,56,4,1,True,0.20811776866994697
2025-01-08 13:56:08,persegiMerah,137,666,129,89,193,65,195,67,2,2,True,0.4273631523845095
2025-01-08 13:56:08,Merah,137,666,tensor(129.9927),tensor(89.4645),15,12,13,7,2,5,True,0.0
2025-01-08 13:56:08,persegiMerah,118,675,126,86,138,10,133,14,5,4,True,0.10482410928377095
2025-01-08 13:56:08,persegiMerah,110,679,128,81,123,40,124,44,1,4,True,0.3177356448550781
2025-01-08 13:56:08,Fail to pick,110,679,0,0,0,0,0,0,0,0,False,0
2025-01-08 13:56:08,persegiMerah,131,654,128,101,113,10,108,6,5,4,True,0.20803323799339482
2025-01-08 13:56:08,persegiMerah,117,675,129,84,64,92,62,96,2,4,True,0.27045759562320393
2025-01-08 13:56:09,persegiMerah,114,676,128,83,96,93,93,88,3,5,True,0.29425321297481055
2025-01-08 13:56:09,Merah,114,676,tensor(128.4341),tensor(83.6622),12,10,16,8,4,2,True,0.0005452632904052734
2025-01-08 13:56:09,Fail to pick,114,676,0,0,0,0,0,0,0,0,False,0
2025-01-08 13:56:10,persegiMerah,118,676,129,84,169,3,168,1,1,2,True,0.43519520918782406
2025-01-08 13:56:10,Fail to pick,118,676,0,0,0,0,0,0,0,0,False,0
2025-01-08 13:56:10,persegiMerah,136,653,131,102,62,90,58,89,4,1,True,0.13190404276589482
2025-01-08 13:56:10,Merah,136,653,tensor(131.6806),tensor(102.5540),18,12,21,11,3,1,True,0.0
2025-01-08 13:56:11,persegiMerah,129,655,128,103,161,9,159,8,2,1,True,0.27751197267663136
2025-01-08 13:56:11,Fail to pick,129,655,0,0,0,0,0,0,0,0,False,0
2025-01-08 13:56:11,persegiMerah,114,674,130,84,35,4,33,6,2,2,True,0.3948408940915312
2025-01-08 13:56:11,persegiMerah,130,654,127,103,113,6,116,10,3,4,True,0.2072575715589065
2025-01-08 13:56:11,persegiMerah,113,677,129,83,179,66,178,68,1,2,True,0.2937760920086947
2025-01-08 13:56:12,persegiMerah,142,665,133,91,66,79,67,74,1,5,True,0.45074151262066986
2025-01-08 13:56:12,Merah,142,665,tensor(133.9968),tensor(91.3345),15,13,13,12,2,1,True,0.0
2025-01-08 13:56:12,persegiMerah,115,677,126,82,46,37,48,32,2,5,True,0.4497029770849823
2025-01-08 13:56:13,persegiMerah,137,670,126,84,170,81,167,79,3,2,True,0.22311908010739656
2025-01-08 13:56:13,persegiMerah,135,666,125,89,63,38,63,36,0,2,True,0.3094313114382241
2025-01-08 13:56:13,Merah,135,666,tensor(125.5743),tensor(89.0115),15,12,18,14,3,2,True,0.0
2025-01-08 13:56:13,Fail to pick,135,666,0,0,0,0,0,0,0,0,False,0
2025-01-08 13:56:14,persegiMerah,135,669,126,86,176,5,173,1,3,4,True,0.1817552451577945
2025-01-08 13:56:14,Fail to pick,135,669,0,0,0,0,0,0,0,0,False,0
2025-01-08 13:56:14,persegiMerah,134,653,127,103,38,72,39,74,1,2,True,0.1411713746679859
2025-01-08 13:56:14,persegiMerah,138,652,138,111,18,38,16,33,2,5,True,0.418246957145052
2025-01-08 13:56:14,Fail to pick,138,652,0,0,0,0,0,0,0,0,False,0
2025-01-08 13:58:37,persegiBiru,705,474,122,115,193,33,192,30,1,3,True,0.13789391517356392
2025-01-08 13:58:37,Biru,705,474,tensor(122.2603),tensor(115.6185),68,65,65,62,3,3,True,0.0004994869232177734
2025-01-08 13:58:38,persegiBiru,732,456,124,114,15,16,12,12,3,4,True,0.38617049312893637
2025-01-08 13:58:38,Biru,732,456,tensor(124.9371),tensor(114.4666),73,67,75,62,2,5,True,0.0004990100860595703
2025-01-08 13:58:38,persegiBiru,727,462,119,110,107,17,106,12,1,5,True,0.288757747567037
2025-01-08 13:58:38,Fail to pick,727,462,0,0,0,0,0,0,0,0,False,0
2025-01-08 13:58:38,persegiBiru,733,463,123,112,98,73,93,77,5,4,False,0.30247586027539186
2025-01-08 13:58:38,Fail to pick,733,463,0,0,0,0,0,0,0,0,False,0
2025-01-08 13:58:38,persegiKuning,724,466,119,109,19,35,17,37,2,2,True,0.2553078082349819
2025-01-08 13:58:38,Fail to pick,724,466,0,0,0,0,0,0,0,0,False,0
2025-01-08 13:58:38,persegiKuning,716,470,116,110,4,70,5,65,1,5,True,0.20103099328484572
2025-01-08 13:58:38,Fail to pick,716,470,0,0,0,0,0,0,0,0,False,0
2025-01-08 13:58:38,persegiBiru,736,477,120,108,59,39,55,41,4,2,True,0.17752280294171335
2025-01-08 13:58:46,persegiKuning,729,462,114,107,90,40,92,44,2,4,True,0.338395487746312
2025-01-08 13:58:46,Kuning,729,462,tensor(114.5244),tensor(107.7511),71,67,66,65,5,2,True,0.0004990100860595703
2025-01-08 13:58:48,persegiBiru,782,269,119,115,122,26,119,24,3,2,True,0.49077027921564
2025-01-08 13:58:48,persegiBiru,770,269,111,112,27,9,26,4,1,5,True,0.23831175857793188
2025-01-08 13:58:48,Biru,770,269,tensor(111.6140),tensor(112.3327),125,71,120,75,5,4,True,0.0
2025-01-08 13:58:49,persegiBiru,780,267,118,116,150,96,145,93,5,3,True,0.40624415291004534
2025-01-08 13:58:49,persegiBiru,793,270,122,115,66,49,61,51,5,2,True,0.3597624620067311
2025-01-08 13:58:49,persegiBiru,831,302,124,110,183,14,184,10,1,4,True,0.30404547091869516
2025-01-08 13:58:49,persegiBiru,784,259,120,114,114,23,109,20,5,3,True,0.1324115067320816
2025-01-08 13:58:50,persegiBiru,838,301,123,110,74,74,76,74,2,0,True,0.36612722700028966
2025-01-08 13:58:50,persegiBiru,831,299,125,110,28,47,31,49,3,2,True,0.11016382651996284
2025-01-08 13:58:50,Biru,831,299,tensor(125.8106),tensor(110.8977),116,76,118,72,2,4,True,0.00049591064453125
2025-01-08 13:58:50,Fail to pick,831,299,0,0,0,0,0,0,0,0,False,0
2025-01-08 13:58:50,persegiBiru,799,270,121,115,162,41,158,45,4,4,True,0.48777800080878564
2025-01-08 13:58:50,persegiBiru,834,300,118,110,10,73,14,72,4,1,True,0.337907869356964
2025-01-08 13:58:50,persegiBiru,832,301,122,112,176,3,175,-1,1,4,False,0.16095303464957658
2025-01-08 13:58:50,Fail to pick,832,301,0,0,0,0,0,0,0,0,False,0
2025-01-08 13:58:50,persegiBiru,780,262,118,114,118,58,113,61,5,3,True,0.37670357221625317
2025-01-08 13:58:50,persegiBiru,824,299,121,110,54,27,52,25,2,2,True,0.1654400429831077
2025-01-08 13:58:51,persegiBiru,815,292,119,107,119,45,122,49,3,4,True,0.17723160491461454
2025-01-08 13:58:51,Biru,815,292,tensor(119.0538),tensor(107.2512),118,75,116,71,2,4,True,0.0004999637603759766
2025-01-08 13:58:51,Fail to pick,815,292,0,0,0,0,0,0,0,0,False,0
2025-01-08 13:58:52,persegiBiru,793,270,120,113,66,63,62,58,4,5,True,0.35693410374206735
2025-01-08 13:58:52,persegiBiru,816,297,123,111,88,17,89,21,1,4,True,0.453290836832857
2025-01-08 13:59:02,persegiBiru,723,410,121,110,105,49,109,50,4,1,False,0.49971860087665987
2025-01-08 13:59:02,Biru,723,410,tensor(121.8113),tensor(110.9000),86,66,90,70,4,4,True,0.0
2025-01-08 13:59:02,persegiBiru,717,409,120,112,62,49,64,52,2,3,True,0.262337675357324
2025-01-08 13:59:02,Fail to pick,717,409,0,0,0,0,0,0,0,0,False,0
2025-01-08 13:59:02,persegiBiru,748,422,122,110,76,41,75,36,1,5,True,0.3802305504416229
2025-01-08 13:59:02,persegiBiru,726,407,124,113,13,74,16,73,3,1,True,0.39108168082724504
2025-01-08 13:59:02,persegiBiru,723,408,118,110,24,13,28,12,4,1,True,0.1903538289168267
2025-01-08 13:59:02,Fail to pick,723,408,0,0,0,0,0,0,0,0,False,0
2025-01-08 13:59:03,persegiBiru,716,409,118,111,142,56,138,58,4,2,True,0.4619281333364247
2025-01-08 13:59:03,Biru,716,409,tensor(118.2040),tensor(111.3110),86,66,83,70,3,4,True,0.0006608963012695312
2025-01-08 13:59:03,Fail to pick,716,409,0,0,0,0,0,0,0,0,False,0
2025-01-08 13:59:03,persegiBiru,721,408,122,110,130,43,131,44,1,1,True,0.4818894215811257
2025-01-08 13:59:03,Fail to pick,721,408,0,0,0,0,0,0,0,0,False,0
2025-01-08 13:59:03,persegiBiru,719,410,122,111,49,69,50,72,1,3,True,0.3348388104666874
2025-01-08 13:59:03,Fail to pick,719,410,0,0,0,0,0,0,0,0,False,0
2025-01-08 13:59:03,persegiBiru,754,427,118,103,45,39,49,38,4,1,True,0.14641802013903793
2025-01-08 13:59:04,persegiBiru,723,405,119,111,143,40,147,37,4,3,True,0.12100480338678232
2025-01-08 13:59:04,Biru,723,405,tensor(119.5309),tensor(111.5051),87,66,84,63,3,3,True,0.0
2025-01-08 13:59:05,persegiBiru,727,410,117,109,105,20,109,21,4,1,True,0.275122450136453
2025-01-08 13:59:05,Fail to pick,727,410,0,0,0,0,0,0,0,0,False,0
2025-01-08 13:59:05,persegiBiru,733,416,119,111,182,5,185,6,3,1,True,0.3860349463850524
2025-01-08 13:59:05,Biru,733,416,tensor(119.6405),tensor(111.1454),84,67,81,68,3,1,True,0.0004994869232177734
2025-01-08 13:59:05,Fail to pick,733,416,0,0,0,0,0,0,0,0,False,0
2025-01-08 13:59:05,persegiBiru,736,412,123,106,5,73,2,75,3,2,False,0.2866297047623727
2025-01-08 13:59:05,Fail to pick,736,412,0,0,0,0,0,0,0,0,False,0
2025-01-08 13:59:13,persegiBiru,726,414,116,106,86,91,83,92,3,1,True,0.18866449426518633
2025-01-08 13:59:13,Biru,726,414,tensor(116.8478),tensor(106.5786),85,67,84,70,1,3,True,0.0
2025-01-08 13:59:13,persegiBiru,729,409,122,108,109,49,111,44,2,5,True,0.46862384851411076
2025-01-08 13:59:13,Fail to pick,729,409,0,0,0,0,0,0,0,0,False,0
2025-01-08 13:59:13,persegiBiru,727,414,122,110,137,5,135,1,2,4,True,0.21457222985745192
2025-01-08 13:59:13,Fail to pick,727,414,0,0,0,0,0,0,0,0,False,0
2025-01-08 13:59:14,persegiBiru,708,407,125,113,189,48,186,44,3,4,True,0.46161608626478545
2025-01-08 13:59:14,Biru,708,407,tensor(125.4003),tensor(113.1808),86,65,84,67,2,2,True,0.0
2025-01-08 13:59:14,persegiBiru,717,406,124,113,38,56,35,56,3,0,True,0.30310902765540015
2025-01-08 13:59:14,Fail to pick,717,406,0,0,0,0,0,0,0,0,False,0
2025-01-08 13:59:14,persegiBiru,710,407,123,111,78,31,78,33,0,2,True,0.11923335611022404
2025-01-08 13:59:14,Fail to pick,710,407,0,0,0,0,0,0,0,0,False,0
2025-01-08 13:59:15,persegiBiru,719,407,121,112,23,55,25,57,2,2,True,0.27092189164772923
2025-01-08 13:59:15,Fail to pick,719,407,0,0,0,0,0,0,0,0,False,0
2025-01-08 13:59:15,persegiBiru,717,402,117,110,57,78,59,80,2,2,True,0.36165151099276194
2025-01-08 13:59:15,Fail to pick,717,402,0,0,0,0,0,0,0,0,False,0
2025-01-08 13:59:15,persegiBiru,772,435,118,105,130,80,127,78,3,2,True,0.19453240026637608
2025-01-08 13:59:15,persegiBiru,713,409,121,111,44,65,46,68,2,3,True,0.469661175422039
2025-01-08 13:59:15,persegiBiru,721,405,121,113,171,36,169,40,2,4,True,0.4144398702764125
2025-01-08 13:59:15,Biru,721,405,tensor(121.6995),tensor(113.8459),87,66,85,64,2,2,True,0.0
2025-01-08 13:59:15,Fail to pick,721,405,0,0,0,0,0,0,0,0,False,0
2025-01-08 13:59:15,persegiBiru,720,405,123,113,146,64,145,63,1,1,True,0.4259445208795801
2025-01-08 13:59:15,Fail to pick,720,405,0,0,0,0,0,0,0,0,False,0
2025-01-08 13:59:15,persegiBiru,708,407,123,112,172,38,169,39,3,1,True,0.27311996692478735
2025-01-08 13:59:15,persegiBiru,763,446,123,104,138,94,138,93,0,1,True,0.32861754621116457
2025-01-08 13:59:16,persegiBiru,720,405,127,115,195,20,193,22,2,2,True,0.2350557150038117
2025-01-08 13:59:16,persegiBiru,722,410,119,110,1,68,-1,69,2,1,False,0.25547830694231355
2025-01-08 13:59:16,Fail to pick,722,410,0,0,0,0,0,0,0,0,False,0
2025-01-08 13:59:16,persegiBiru,723,407,124,113,0,48,-5,44,5,4,True,0.40056520109106986
2025-01-08 13:59:16,Biru,723,407,tensor(124.0787),tensor(113.3852),86,66,86,64,0,2,True,0.0005006790161132812
2025-01-08 13:59:16,Fail to pick,723,407,0,0,0,0,0,0,0,0,False,0
2025-01-08 13:59:16,persegiBiru,727,406,121,115,105,1,106,-2,1,3,True,0.4579523352754711
2025-01-08 13:59:16,Fail to pick,727,406,0,0,0,0,0,0,0,0,False,0
2025-01-08 13:59:16,persegiBiru,759,439,117,105,157,89,158,87,1,2,True,0.10948753389104988
2025-01-08 13:59:17,persegiBiru,724,410,119,111,39,74,39,75,0,1,True,0.21264734219421644
2025-01-08 13:59:18,persegiBiru,730,422,118,108,138,92,136,88,2,4,True,0.2350614881550102
2025-01-08 13:59:18,Biru,730,422,tensor(118.6729),tensor(108.2587),82,67,85,68,3,1,True,0.0
2025-01-08 13:59:18,persegiBiru,727,419,115,107,199,13,203,14,4,1,False,0.2523062859865457
2025-01-08 13:59:18,Fail to pick,727,419,0,0,0,0,0,0,0,0,False,0
2025-01-08 13:59:19,persegiBiru,726,404,121,109,19,33,16,35,3,2,True,0.3937793101375172
2025-01-08 13:59:26,persegiMerah,894,488,137,132,113,62,117,63,4,1,True,0.35461087365368227
2025-01-08 13:59:26,Merah,894,488,tensor(137.4326),tensor(132.7769),64,82,59,77,5,5,True,0.0
2025-01-08 13:59:26,persegiMerah,898,489,137,140,59,82,58,80,1,2,True,0.2314620260965059
2025-01-08 13:59:26,Fail to pick,898,489,0,0,0,0,0,0,0,0,False,0
2025-01-08 13:59:26,persegiMerah,920,495,146,125,60,61,58,64,2,3,True,0.31077791871842947
2025-01-08 13:59:26,persegiMerah,875,440,123,128,121,13,125,15,4,2,True,0.19527821435543988
2025-01-08 13:59:26,persegiMerah,920,496,145,124,106,65,108,65,2,0,True,0.25077075274182636
2025-01-08 13:59:26,persegiMerah,910,488,136,126,17,26,12,25,5,1,True,0.3897178096536855
2025-01-08 13:59:26,persegiMerah,891,485,131,127,77,14,77,18,0,4,True,0.42541399886719233
2025-01-08 13:59:26,persegiMerah,909,468,135,125,113,75,111,78,2,3,True,0.12006245392529964
2025-01-08 13:59:27,persegiMerah,917,469,139,127,62,24,66,19,4,5,True,0.38311018256804286
2025-01-08 13:59:27,Fail to pick,917,469,0,0,0,0,0,0,0,0,False,0
2025-01-08 13:59:27,persegiMerah,891,450,136,132,70,86,73,84,3,2,False,0.38770986878522673
2025-01-08 13:59:27,persegiMerah,880,443,121,128,82,17,86,19,4,2,True,0.1800962340709584
2025-01-08 13:59:27,Merah,880,443,tensor(121.9144),tensor(128.9467),76,81,78,79,2,2,True,0.0001533031463623047
2025-01-08 13:59:27,persegiMerah,879,449,139,131,103,90,98,87,5,3,True,0.25067470332792396
2025-01-08 13:59:27,Fail to pick,879,449,0,0,0,0,0,0,0,0,False,0
2025-01-08 13:59:27,persegiMerah,912,446,133,132,94,38,95,37,1,1,True,0.4507488646011272
2025-01-08 13:59:27,persegiMerah,893,447,132,128,154,61,150,63,4,2,True,0.2768096515589228
2025-01-08 13:59:30,persegiMerah,793,88,119,130,164,28,160,23,4,5,True,0.2117091185754644
2025-01-08 13:59:30,Merah,793,88,tensor(119.7386),tensor(130.2909),175,73,176,74,1,1,True,0.0004944801330566406
2025-01-08 13:59:30,persegiMerah,791,92,118,127,152,80,149,80,3,0,True,0.37358763803792516
2025-01-08 13:59:30,Fail to pick,791,92,0,0,0,0,0,0,0,0,False,0
2025-01-08 13:59:31,persegiMerah,802,85,124,133,182,55,179,58,3,3,True,0.39368960639927486
2025-01-08 13:59:31,Merah,802,85,tensor(124.7419),tensor(133.3487),176,74,176,76,0,2,True,0.0
2025-01-08 13:59:32,persegiMerah,794,145,128,136,186,27,183,31,3,4,True,0.37650635285960476
2025-01-08 13:59:32,persegiMerah,790,148,127,135,160,81,164,76,4,5,True,0.38075880721576305
2025-01-08 13:59:32,Fail to pick,790,148,0,0,0,0,0,0,0,0,False,0
2025-01-08 13:59:39,persegiMerah,813,137,130,135,22,36,21,40,1,4,True,0.31998340672641024
2025-01-08 13:59:39,Merah,813,137,tensor(130.7101),tensor(135.6605),161,75,162,72,1,3,True,0.0
2025-01-08 13:59:39,persegiMerah,812,101,125,129,159,65,159,62,0,3,True,0.10075170486898594
2025-01-08 13:59:40,persegiMerah,762,105,109,122,114,98,116,96,2,2,True,0.3422874355662969
2025-01-08 13:59:40,Merah,762,105,tensor(109.5184),tensor(122.3975),170,70,167,65,3,5,True,0.0004966259002685547
2025-01-08 13:59:42,persegiMerah,796,137,133,137,10,77,14,79,4,2,True,0.16154821347254367
2025-01-08 13:59:42,persegiMerah,794,148,138,138,98,75,102,75,4,0,True,0.14113678829054044
2025-01-08 13:59:42,Merah,794,148,tensor(138.1566),tensor(138.2494),158,73,162,71,4,2,True,0.0
2025-01-08 13:59:43,persegiMerah,779,86,119,132,48,42,43,42,5,0,True,0.4251821991593897
2025-01-08 13:59:43,Merah,779,86,tensor(119.5503),tensor(132.9710),176,72,171,68,5,4,True,0.0
2025-01-08 13:59:44,persegiMerah,786,85,121,128,81,64,83,68,2,4,True,0.2917969632028663
2025-01-08 13:59:44,Merah,786,85,tensor(121.5947),tensor(128.3770),176,72,171,75,5,3,True,0.0
2025-01-08 13:59:44,Fail to pick,786,85,0,0,0,0,0,0,0,0,False,0
2025-01-08 13:59:44,persegiMerah,768,89,121,138,137,15,137,19,0,4,True,0.22881561656945673
2025-01-08 13:59:45,persegiMerah,877,142,134,134,182,95,183,96,1,1,True,0.47356210649091723
2025-01-08 13:59:45,persegiMerah,843,128,124,130,173,55,172,54,1,1,True,0.489198958029575
2025-01-08 13:59:45,persegiMerah,782,89,122,137,41,94,41,95,0,1,True,0.3239421689206293
2025-01-08 13:59:45,Merah,782,89,tensor(122.4442),tensor(137.7677),175,72,179,69,4,3,True,0.0
2025-01-08 13:59:46,persegiMerah,780,150,142,136,11,59,15,59,4,0,True,0.300723202014297
2025-01-08 13:59:46,persegiMerah,792,104,129,136,62,64,59,68,3,4,True,0.4806777905795272
2025-01-08 13:59:46,persegiMerah,758,62,126,124,168,92,172,89,4,3,True,0.31397492947684913
2025-01-08 13:59:48,persegiMerah,852,137,133,132,35,5,39,3,4,2,True,0.44760475908450004
2025-01-08 13:59:48,Merah,852,137,tensor(133.8901),tensor(132.8665),161,78,159,73,2,5,True,0.0
2025-01-08 13:59:49,persegiMerah,826,245,120,121,40,70,43,68,3,2,True,0.1566856440253015
2025-01-08 13:59:49,Merah,826,245,tensor(120.9750),tensor(121.8807),131,76,129,75,2,1,True,0.0004973411560058594
2025-01-08 13:59:50,persegiMerah,893,278,134,121,63,62,66,66,3,4,False,0.48750317071317995
2025-01-08 13:59:50,persegiMerah,843,271,127,129,8,66,3,61,5,5,True,0.3715281728564851
2025-01-08 13:59:51,persegiMerah,898,292,139,128,94,47,94,48,0,1,True,0.489601806894568
2025-01-08 13:59:51,Merah,898,292,tensor(139.6061),tensor(128.4707),118,83,122,83,4,0,True,0.0
2025-01-08 13:59:51,persegiMerah,830,212,124,126,117,46,118,47,1,1,True,0.30111865540481075
2025-01-08 13:59:51,persegiMerah,836,210,121,121,19,42,18,38,1,4,True,0.20454937970548565
2025-01-08 13:59:51,Fail to pick,836,210,0,0,0,0,0,0,0,0,False,0
2025-01-08 13:59:52,persegiMerah,892,246,133,117,4,55,5,53,1,2,False,0.18657478003456515
2025-01-08 13:59:52,persegiMerah,829,212,121,117,45,11,48,9,3,2,True,0.17365702192414756
2025-01-08 13:59:52,Merah,829,212,tensor(121.3067),tensor(117.5316),141,76,136,77,5,1,True,0.0004994869232177734
2025-01-08 13:59:52,persegiMerah,830,212,124,116,96,84,95,79,1,5,True,0.2419731639567914
2025-01-08 13:59:52,Fail to pick,830,212,0,0,0,0,0,0,0,0,False,0
2025-01-08 13:59:52,persegiMerah,830,212,127,118,176,14,180,18,4,4,True,0.4949888038529979
2025-01-08 13:59:52,Fail to pick,830,212,0,0,0,0,0,0,0,0,False,0
2025-01-08 13:59:52,persegiMerah,888,248,124,117,81,15,79,10,2,5,True,0.3027124240160073
2025-01-08 13:59:52,persegiMerah,832,212,124,118,82,22,82,23,0,1,False,0.11532340318157558
2025-01-08 13:59:52,persegiMerah,830,205,129,119,137,89,132,92,5,3,True,0.36008379302696725
2025-01-08 13:59:52,Fail to pick,830,205,0,0,0,0,0,0,0,0,False,0
2025-01-08 13:59:53,persegiMerah,890,248,126,116,149,23,150,19,1,4,True,0.14690617291877897
2025-01-08 13:59:53,persegiMerah,888,248,127,115,45,46,47,48,2,2,True,0.29665450314282765
2025-01-08 13:59:53,Fail to pick,888,248,0,0,0,0,0,0,0,0,False,0
2025-01-08 13:59:53,persegiMerah,825,211,131,122,192,26,189,21,3,5,True,0.3192004288995004
2025-01-08 13:59:53,Merah,825,211,tensor(131.4597),tensor(122.7516),141,76,136,72,5,4,True,0.0004892349243164062
2025-01-08 13:59:53,persegiMerah,881,251,131,119,41,71,44,70,3,1,True,0.49299827413680675
2025-01-08 13:59:53,persegiMerah,887,248,127,115,37,22,36,18,1,4,True,0.4438067294639181
2025-01-08 13:59:53,Fail to pick,887,248,0,0,0,0,0,0,0,0,False,0
2025-01-08 13:59:53,persegiMerah,889,250,128,115,143,52,142,51,1,1,True,0.4227452246557547
2025-01-08 13:59:53,Fail to pick,889,250,0,0,0,0,0,0,0,0,False,0
2025-01-08 13:59:57,persegiMerah,895,636,136,116,20,55,23,55,3,0,True,0.452139050635711
2025-01-08 13:59:57,persegiMerah,894,636,136,115,89,95,93,95,4,0,True,0.39426531940769116
2025-01-08 13:59:57,Merah,894,636,tensor(136.2677),tensor(115.5663),23,82,23,79,0,3,True,0.0
2025-01-08 13:59:57,Fail to pick,894,636,0,0,0,0,0,0,0,0,False,0
2025-01-08 13:59:57,persegiMerah,892,638,134,116,106,39,107,37,1,2,True,0.41517398648453363
2025-01-08 13:59:57,Fail to pick,892,638,0,0,0,0,0,0,0,0,False,0
2025-01-08 13:59:57,persegiMerah,894,638,132,113,115,8,112,7,3,1,True,0.1583301266784392
2025-01-08 13:59:57,Fail to pick,894,638,0,0,0,0,0,0,0,0,False,0
2025-01-08 13:59:57,persegiMerah,893,639,134,113,175,74,175,77,0,3,False,0.44250055769287666
2025-01-08 13:59:57,Fail to pick,893,639,0,0,0,0,0,0,0,0,False,0
2025-01-08 13:59:57,persegiMerah,894,637,138,116,193,14,190,16,3,2,True,0.4695784392457597
2025-01-08 13:59:57,Fail to pick,894,637,0,0,0,0,0,0,0,0,False,0
2025-01-08 13:59:57,persegiMerah,899,637,137,115,67,37,69,33,2,4,True,0.3151829926005408
2025-01-08 13:59:57,Fail to pick,899,637,0,0,0,0,0,0,0,0,False,0
2025-01-08 13:59:59,persegiMerah,869,547,129,115,124,95,125,90,1,5,True,0.2803810486210738
2025-01-08 13:59:59,Merah,869,547,tensor(129.2457),tensor(115.9522),48,80,46,75,2,5,True,0.0
2025-01-08 13:59:59,persegiMerah,866,551,130,119,129,62,128,59,1,3,False,0.37476755490328184
2025-01-08 13:59:59,Fail to pick,866,551,0,0,0,0,0,0,0,0,False,0
2025-01-08 13:59:59,persegiMerah,866,553,126,116,31,0,34,-2,3,2,True,0.2801937799513239
2025-01-08 13:59:59,Fail to pick,866,553,0,0,0,0,0,0,0,0,False,0
2025-01-08 13:59:59,persegiMerah,864,551,130,118,190,89,188,88,2,1,True,0.17855607114022473
2025-01-08 13:59:59,Fail to pick,864,551,0,0,0,0,0,0,0,0,False,0
2025-01-08 13:59:59,persegiMerah,864,551,130,118,61,81,64,79,3,2,False,0.33973872559675633
2025-01-08 13:59:59,Fail to pick,864,551,0,0,0,0,0,0,0,0,False,0
2025-01-08 13:59:59,persegiMerah,865,551,131,120,133,32,130,33,3,1,True,0.10335780296911833
2025-01-08 13:59:59,Fail to pick,865,551,0,0,0,0,0,0,0,0,False,0
2025-01-08 14:00:00,persegiMerah,868,559,132,122,166,13,163,12,3,1,False,0.49668010902348236
2025-01-08 14:00:00,Merah,868,559,tensor(132.5281),tensor(122.2684),44,80,47,76,3,4,True,0.0
2025-01-08 14:00:00,Fail to pick,868,559,0,0,0,0,0,0,0,0,False,0
2025-01-08 14:00:01,persegiMerah,876,557,131,114,151,39,149,38,2,1,True,0.39131759499154484
2025-01-08 14:00:01,Fail to pick,876,557,0,0,0,0,0,0,0,0,False,0
2025-01-08 14:00:01,persegiMerah,870,556,132,115,65,49,68,51,3,2,True,0.4886334305317134
2025-01-08 14:00:01,Fail to pick,870,556,0,0,0,0,0,0,0,0,False,0
2025-01-08 14:00:01,persegiMerah,870,556,132,115,40,3,38,2,2,1,True,0.21397767501562118
2025-01-08 14:00:01,Fail to pick,870,556,0,0,0,0,0,0,0,0,False,0
2025-01-08 14:00:01,persegiMerah,881,561,133,113,72,60,72,58,0,2,True,0.3950996160090834
2025-01-08 14:00:01,persegiMerah,873,557,131,115,66,69,68,73,2,4,True,0.2876771717308247
2025-01-08 14:00:01,Fail to pick,873,557,0,0,0,0,0,0,0,0,False,0
2025-01-08 14:00:01,persegiMerah,869,558,136,116,98,36,100,36,2,0,True,0.40200577944284765
2025-01-08 14:00:01,Fail to pick,869,558,0,0,0,0,0,0,0,0,False,0
2025-01-08 14:00:03,persegiMerah,864,561,131,118,137,53,140,57,3,4,True,0.12568612497503687
2025-01-08 14:00:03,Merah,864,561,tensor(131.7043),tensor(118.2980),44,80,43,81,1,1,True,0.0
2025-01-08 14:00:03,Fail to pick,864,561,0,0,0,0,0,0,0,0,False,0
2025-01-08 14:00:03,persegiMerah,866,561,131,117,123,96,127,93,4,3,True,0.4962155719432456
2025-01-08 14:00:03,Fail to pick,866,561,0,0,0,0,0,0,0,0,False,0
2025-01-08 14:00:03,persegiMerah,868,563,134,117,48,69,44,72,4,3,True,0.23166563165967546
2025-01-08 14:00:03,Fail to pick,868,563,0,0,0,0,0,0,0,0,False,0
2025-01-08 14:00:04,persegiMerah,869,556,133,119,97,93,95,92,2,1,True,0.299399417880455
2025-01-08 14:00:04,Fail to pick,869,556,0,0,0,0,0,0,0,0,False,0
2025-01-08 14:00:04,persegiMerah,870,552,132,119,80,6,78,3,2,3,False,0.4371574743067448
2025-01-08 14:00:04,Fail to pick,870,552,0,0,0,0,0,0,0,0,False,0
2025-01-08 14:00:09,persegiMerah,858,562,138,118,53,34,49,32,4,2,True,0.44051351435453556
2025-01-08 14:00:09,Merah,858,562,tensor(138.1039),tensor(118.7447),43,79,38,75,5,4,True,0.0005002021789550781
2025-01-08 14:00:09,persegiMerah,882,580,127,113,79,61,79,61,0,0,False,0.12404594955338277
2025-01-08 14:00:09,persegiMerah,885,563,127,114,115,48,113,45,2,3,True,0.47994054611368997
2025-01-08 14:00:10,persegiMerah,868,548,130,118,30,65,27,66,3,1,True,0.21201661301599053
2025-01-08 14:00:10,Merah,868,548,tensor(130.3497),tensor(118.0087),47,80,43,81,4,1,True,0.0005044937133789062
2025-01-08 14:00:11,persegiMerah,860,556,127,118,58,7,60,10,2,3,True,0.17137580819371712
2025-01-08 14:00:11,Fail to pick,860,556,0,0,0,0,0,0,0,0,False,0
2025-01-08 14:00:11,persegiMerah,869,547,135,118,115,6,110,7,5,1,True,0.406095622869332
2025-01-08 14:00:11,Fail to pick,869,547,0,0,0,0,0,0,0,0,False,0
2025-01-08 14:00:11,persegiMerah,869,551,132,117,68,90,63,94,5,4,False,0.3546616943873744
2025-01-08 14:00:11,Fail to pick,869,551,0,0,0,0,0,0,0,0,False,0
2025-01-08 14:00:11,persegiMerah,868,550,130,116,133,61,128,60,5,1,True,0.3522698270256699
2025-01-08 14:00:11,Fail to pick,868,550,0,0,0,0,0,0,0,0,False,0
2025-01-08 14:00:11,persegiMerah,868,544,132,122,153,43,157,39,4,4,True,0.3913850124702838
2025-01-08 14:00:11,Fail to pick,868,544,0,0,0,0,0,0,0,0,False,0
2025-01-08 14:00:11,persegiMerah,870,556,130,117,126,96,127,99,1,3,True,0.24279061595375315
2025-01-08 14:00:11,persegiMerah,867,552,132,118,165,72,165,70,0,2,True,0.28216380156223286
2025-01-08 14:00:11,Fail to pick,867,552,0,0,0,0,0,0,0,0,False,0
2025-01-08 14:00:11,persegiMerah,869,547,137,120,14,77,13,80,1,3,True,0.40842207340436953
2025-01-08 14:00:11,Fail to pick,869,547,0,0,0,0,0,0,0,0,False,0
2025-01-08 14:00:11,persegiMerah,869,549,133,117,187,99,185,97,2,2,True,0.30262185688234183
2025-01-08 14:00:11,Merah,869,549,tensor(133.0950),tensor(117.8632),47,80,47,78,0,2,True,0.0
2025-01-08 14:00:12,Fail to pick,869,549,0,0,0,0,0,0,0,0,False,0
2025-01-08 14:00:12,persegiMerah,869,544,140,122,117,35,112,32,5,3,True,0.38900576426483846
2025-01-08 14:00:12,Fail to pick,869,544,0,0,0,0,0,0,0,0,False,0
2025-01-08 14:00:12,persegiMerah,853,560,130,119,56,69,55,68,1,1,True,0.2745255194142534
2025-01-08 14:00:13,persegiMerah,865,554,133,119,91,32,94,35,3,3,False,0.18907050296985128
2025-01-08 14:00:13,Merah,865,554,tensor(133.1406),tensor(119.2738),46,80,47,79,1,1,True,0.0005047321319580078
2025-01-08 14:00:13,persegiMerah,867,550,130,117,18,8,18,6,0,2,True,0.4471247745427419
2025-01-08 14:00:13,Fail to pick,867,550,0,0,0,0,0,0,0,0,False,0
2025-01-08 14:00:13,persegiMerah,865,550,133,118,72,88,74,91,2,3,True,0.31634284892390985
2025-01-08 14:00:13,Fail to pick,865,550,0,0,0,0,0,0,0,0,False,0
2025-01-08 14:00:13,persegiMerah,862,554,131,120,187,44,189,40,2,4,True,0.4292401940903635
2025-01-08 14:00:13,Fail to pick,862,554,0,0,0,0,0,0,0,0,False,0
2025-01-08 14:00:13,persegiMerah,864,551,137,120,115,3,117,3,2,0,True,0.18007897932417274
2025-01-08 14:00:13,Fail to pick,864,551,0,0,0,0,0,0,0,0,False,0
2025-01-08 14:00:13,persegiMerah,872,550,132,119,49,26,44,22,5,4,True,0.12549187840135856
2025-01-08 14:00:13,Fail to pick,872,550,0,0,0,0,0,0,0,0,False,0
2025-01-08 14:00:13,persegiMerah,867,553,129,119,185,57,181,52,4,5,True,0.34686250308873
2025-01-08 14:00:13,Fail to pick,867,553,0,0,0,0,0,0,0,0,False,0
2025-01-08 14:00:14,persegiMerah,866,554,130,116,122,34,124,35,2,1,True,0.1377297772453782
2025-01-08 14:00:14,Fail to pick,866,554,0,0,0,0,0,0,0,0,False,0
2025-01-08 14:00:14,persegiMerah,867,555,127,115,134,42,131,38,3,4,True,0.41309678727938426
2025-01-08 14:00:14,Fail to pick,867,555,0,0,0,0,0,0,0,0,False,0
2025-01-08 14:00:14,persegiMerah,870,553,130,117,11,92,7,89,4,3,True,0.3034537496682035
2025-01-08 14:00:14,Fail to pick,870,553,0,0,0,0,0,0,0,0,False,0
2025-01-08 14:00:14,persegiMerah,867,554,129,118,157,52,156,49,1,3,True,0.3316129918510627
2025-01-08 14:00:14,Merah,867,554,tensor(129.0779),tensor(118.2987),46,80,47,77,1,3,True,0.0
2025-01-08 14:00:14,Fail to pick,867,554,0,0,0,0,0,0,0,0,False,0
2025-01-08 14:00:14,persegiMerah,858,552,132,118,116,82,116,84,0,2,True,0.4745559260807154
2025-01-08 14:00:14,Fail to pick,858,552,0,0,0,0,0,0,0,0,False,0
2025-01-08 14:00:15,persegiMerah,871,563,133,115,189,61,191,56,2,5,False,0.1733282054398917
2025-01-08 14:00:15,persegiMerah,892,572,127,111,181,61,184,57,3,4,True,0.12150291925780828
2025-01-08 14:00:15,persegiMerah,876,561,134,119,8,10,12,13,4,3,True,0.2987614197682532
2025-01-08 14:00:15,Merah,876,561,tensor(134.3282),tensor(119.3610),44,81,42,83,2,2,True,0.0
2025-01-08 14:00:15,persegiMerah,872,561,132,118,113,74,112,76,1,2,True,0.20991225952258918
2025-01-08 14:00:15,Fail to pick,872,561,0,0,0,0,0,0,0,0,False,0
2025-01-08 14:00:16,persegiMerah,869,563,126,115,119,24,119,28,0,4,True,0.11055627047156738
2025-01-08 14:00:16,Fail to pick,869,563,0,0,0,0,0,0,0,0,False,0
2025-01-08 14:00:23,persegiMerah,892,567,131,118,2,17,-3,19,5,2,True,0.34837583055123994
2025-01-08 14:00:23,Merah,892,567,tensor(131.3976),tensor(118.5682),42,82,45,86,3,4,True,0.0
2025-01-08 14:00:23,persegiMerah,870,566,131,119,101,21,99,17,2,4,True,0.31454525349605245
2025-01-08 14:00:23,persegiMerah,873,566,130,119,35,54,36,53,1,1,False,0.37907754598217214
2025-01-08 14:00:23,Fail to pick,873,566,0,0,0,0,0,0,0,0,False,0
2025-01-08 14:00:23,persegiMerah,886,563,128,114,20,2,22,0,2,2,True,0.16742692864495634
2025-01-08 14:00:23,persegiMerah,869,566,132,120,174,37,170,41,4,4,True,0.11216924787682198
2025-01-08 14:00:24,persegiMerah,892,566,131,116,29,53,30,48,1,5,True,0.19829532973545924
2025-01-08 14:00:24,persegiMerah,894,566,134,115,112,85,116,83,4,2,True,0.16418812240281394
2025-01-08 14:00:24,Merah,894,566,tensor(134.7291),tensor(115.1822),42,82,37,85,5,3,True,0.0005054473876953125
2025-01-08 14:00:24,Fail to pick,894,566,0,0,0,0,0,0,0,0,False,0
2025-01-08 14:00:24,persegiMerah,892,563,132,115,35,27,37,30,2,3,True,0.3375553561976655
2025-01-08 14:00:24,Fail to pick,892,563,0,0,0,0,0,0,0,0,False,0
2025-01-08 14:00:25,persegiMerah,869,557,133,120,119,44,121,41,2,3,True,0.2644725973147262
2025-01-08 14:00:25,Merah,869,557,tensor(133.0468),tensor(120.3464),45,80,44,75,1,5,True,0.0
2025-01-08 14:00:25,persegiMerah,873,554,127,118,56,7,52,4,4,3,True,0.4627926807817081
2025-01-08 14:00:25,Fail to pick,873,554,0,0,0,0,0,0,0,0,False,0
2025-01-08 14:00:25,persegiMerah,867,555,131,120,33,51,36,52,3,1,True,0.2879987981718442
2025-01-08 14:00:25,Fail to pick,867,555,0,0,0,0,0,0,0,0,False,0
2025-01-08 14:00:25,persegiMerah,875,550,137,122,179,63,181,65,2,2,True,0.22647877287133175
2025-01-08 14:00:25,Fail to pick,875,550,0,0,0,0,0,0,0,0,False,0
2025-01-08 14:00:25,persegiMerah,863,558,132,120,161,8,158,6,3,2,True,0.3178471860468317
2025-01-08 14:00:26,persegiMerah,870,552,133,119,11,44,14,40,3,4,True,0.22155528801120097
2025-01-08 14:00:26,Fail to pick,870,552,0,0,0,0,0,0,0,0,False,0
2025-01-08 14:00:27,persegiMerah,866,554,131,117,144,33,146,36,2,3,True,0.3087213011877026
2025-01-08 14:00:27,Merah,866,554,tensor(131.4709),tensor(117.7713),46,80,49,75,3,5,True,0.0
2025-01-08 14:00:27,Fail to pick,866,554,0,0,0,0,0,0,0,0,False,0
2025-01-08 14:00:27,persegiMerah,862,548,137,122,195,88,198,91,3,3,True,0.48455617370329607
2025-01-08 14:00:27,Fail to pick,862,548,0,0,0,0,0,0,0,0,False,0
2025-01-08 14:00:27,persegiMerah,866,554,130,119,89,37,84,39,5,2,True,0.2513876693544903
2025-01-08 14:00:27,Fail to pick,866,554,0,0,0,0,0,0,0,0,False,0
2025-01-08 14:00:27,persegiMerah,869,552,131,119,38,92,42,93,4,1,True,0.45570946283451497
2025-01-08 14:00:27,Fail to pick,869,552,0,0,0,0,0,0,0,0,False,0
2025-01-08 14:00:27,persegiMerah,858,557,133,122,199,31,203,28,4,3,True,0.2965063034870621
2025-01-08 14:00:27,persegiMerah,872,559,131,117,181,54,184,56,3,2,True,0.373476261070947
2025-01-08 14:00:28,persegiMerah,868,556,132,118,150,14,153,13,3,1,True,0.4604985260074471
2025-01-08 14:00:28,Fail to pick,868,556,0,0,0,0,0,0,0,0,False,0
2025-01-08 14:00:28,persegiMerah,868,557,133,118,102,15,104,17,2,2,True,0.34963592730242266
2025-01-08 14:00:28,Merah,868,557,tensor(133.0353),tensor(118.5003),45,80,45,76,0,4,True,0.0004999637603759766
2025-01-08 14:00:28,Fail to pick,868,557,0,0,0,0,0,0,0,0,False,0
2025-01-08 14:00:28,persegiMerah,868,554,133,117,120,97,124,95,4,2,True,0.28689512149767493
2025-01-08 14:00:28,Fail to pick,868,554,0,0,0,0,0,0,0,0,False,0
2025-01-08 14:00:28,persegiMerah,870,556,131,118,32,79,36,82,4,3,True,0.3621992468540167
2025-01-08 14:00:28,Fail to pick,870,556,0,0,0,0,0,0,0,0,False,0
2025-01-08 14:00:29,persegiMerah,868,539,136,127,14,3,17,0,3,3,True,0.1206886249651749
2025-01-08 14:00:29,persegiMerah,867,566,131,118,37,57,34,61,3,4,True,0.22736580241901155
2025-01-08 14:00:29,Merah,867,566,tensor(131.4626),tensor(118.3648),42,80,46,83,4,3,True,0.0
2025-01-08 14:00:29,persegiMerah,867,564,130,116,48,50,46,49,2,1,True,0.2939148058429367
2025-01-08 14:00:29,Fail to pick,867,564,0,0,0,0,0,0,0,0,False,0
2025-01-08 14:00:29,persegiMerah,883,569,127,118,99,28,103,32,4,4,True,0.4865304402537457
2025-01-08 14:00:29,persegiMerah,889,567,128,120,77,33,80,28,3,5,True,0.4199270486646334
2025-01-08 14:00:29,Fail to pick,889,567,0,0,0,0,0,0,0,0,False,0
2025-01-08 14:00:30,persegiMerah,897,560,132,114,30,29,31,27,1,2,False,0.33571719969840075
2025-01-08 14:00:30,Fail to pick,897,560,0,0,0,0,0,0,0,0,False,0
2025-01-08 14:00:30,persegiMerah,867,565,130,119,51,10,46,14,5,4,False,0.24117141620147056
2025-01-08 14:00:30,Merah,867,565,tensor(130.9914),tensor(119.8220),43,80,42,79,1,1,True,0.0
2025-01-08 14:00:30,persegiMerah,882,556,129,117,84,28,82,27,2,1,False,0.22827664722396146
2025-01-08 14:00:37,persegiMerah,196,443,127,115,194,60,195,59,1,1,True,0.2548191264219249
2025-01-08 14:00:37,Merah,196,443,tensor(127.7051),tensor(115.8254),76,18,74,19,2,1,True,0.0
2025-01-08 14:00:37,persegiMerah,199,442,127,113,61,53,58,54,3,1,True,0.4462554707852736
2025-01-08 14:00:37,Fail to pick,199,442,0,0,0,0,0,0,0,0,False,0
2025-01-08 14:00:37,persegiMerah,192,458,126,116,36,55,32,54,4,1,True,0.29942584248412585
2025-01-08 14:00:37,persegiMerah,203,450,127,113,160,58,156,61,4,3,True,0.32546842396123227
2025-01-08 14:00:37,persegiMerah,191,446,121,116,175,9,173,5,2,4,True,0.25179688114248444
2025-01-08 14:00:37,persegiMerah,196,457,122,115,138,90,142,90,4,0,True,0.3905905668629279
2025-01-08 14:00:38,persegiMerah,201,449,125,113,38,96,41,92,3,4,True,0.33057510317869815
2025-01-08 14:00:38,Fail to pick,201,449,0,0,0,0,0,0,0,0,False,0
2025-01-08 14:00:38,persegiMerah,195,443,124,115,199,54,201,51,2,3,True,0.18504455840899525
2025-01-08 14:00:38,Fail to pick,195,443,0,0,0,0,0,0,0,0,False,0
2025-01-08 14:00:38,persegiMerah,204,450,125,112,7,58,2,62,5,4,True,0.3429788492583654
2025-01-08 14:00:38,Fail to pick,204,450,0,0,0,0,0,0,0,0,False,0
2025-01-08 14:00:38,persegiMerah,193,446,124,117,14,5,17,1,3,4,False,0.20137877966257978
2025-01-08 14:00:38,persegiMerah,192,446,126,117,132,0,130,-5,2,5,True,0.48507886568999115
2025-01-08 14:00:38,Merah,192,446,tensor(126.7274),tensor(117.0003),76,17,78,13,2,4,True,0.0
2025-01-08 14:00:38,Fail to pick,192,446,0,0,0,0,0,0,0,0,False,0
2025-01-08 14:00:38,persegiMerah,186,434,121,116,167,71,169,72,2,1,True,0.31321456270395565
2025-01-08 14:00:38,persegiMerah,207,422,125,124,66,97,62,99,4,2,True,0.16668172192335595
2025-01-08 14:00:39,persegiMerah,182,444,118,117,83,5,80,3,3,2,True,0.4972810860307605
2025-01-08 14:00:39,persegiMerah,180,446,118,116,187,29,191,24,4,5,True,0.17533784194265223
2025-01-08 14:00:39,Fail to pick,180,446,0,0,0,0,0,0,0,0,False,0
2025-01-08 14:00:39,persegiMerah,186,439,121,115,119,77,116,76,3,1,True,0.34443171918692095
2025-01-08 14:00:39,Fail to pick,186,439,0,0,0,0,0,0,0,0,False,0
2025-01-08 14:00:39,persegiMerah,182,440,119,115,123,30,121,26,2,4,True,0.42096301725461516
2025-01-08 14:00:39,Merah,182,440,tensor(119.7422),tensor(115.7005),77,16,74,11,3,5,True,0.0005016326904296875
2025-01-08 14:00:39,Fail to pick,182,440,0,0,0,0,0,0,0,0,False,0
2025-01-08 14:00:39,persegiMerah,183,450,118,115,41,26,41,30,0,4,True,0.32609926129926664
2025-01-08 14:00:39,persegiMerah,186,443,120,116,39,43,34,38,5,5,True,0.23377549045187204
2025-01-08 14:00:39,Fail to pick,186,443,0,0,0,0,0,0,0,0,False,0
2025-01-08 14:00:39,persegiMerah,186,441,120,117,167,64,168,68,1,4,True,0.1600054216027155
2025-01-08 14:00:39,Fail to pick,186,441,0,0,0,0,0,0,0,0,False,0
2025-01-08 14:00:40,persegiMerah,186,438,124,117,53,1,54,-4,1,5,True,0.10043865753136201
2025-01-08 14:00:40,Fail to pick,186,438,0,0,0,0,0,0,0,0,False,0
2025-01-08 14:00:40,persegiMerah,190,444,125,115,60,86,63,90,3,4,True,0.28349577229654105
2025-01-08 14:00:40,Fail to pick,190,444,0,0,0,0,0,0,0,0,False,0
2025-01-08 14:00:40,persegiMerah,193,434,127,117,28,30,25,31,3,1,True,0.21397374112081297
2025-01-08 14:00:40,persegiMerah,184,442,120,117,184,24,184,28,0,4,True,0.40228224900427534
2025-01-08 14:00:40,Fail to pick,184,442,0,0,0,0,0,0,0,0,False,0
2025-01-08 14:00:40,persegiMerah,193,442,127,116,18,8,18,3,0,5,True,0.24060777310877432
2025-01-08 14:00:40,Fail to pick,193,442,0,0,0,0,0,0,0,0,False,0
2025-01-08 14:00:40,persegiMerah,183,443,117,116,135,61,130,63,5,2,True,0.1631695387148801
2025-01-08 14:00:40,persegiMerah,192,438,126,116,30,68,29,65,1,3,True,0.23866052923589104
2025-01-08 14:00:40,Merah,192,438,tensor(126.0325),tensor(116.2478),78,17,77,14,1,3,True,0.0004937648773193359
2025-01-08 14:00:40,Fail to pick,192,438,0,0,0,0,0,0,0,0,False,0
2025-01-08 14:00:40,persegiMerah,188,440,122,118,163,99,158,97,5,2,True,0.46913960760135764
2025-01-08 14:00:40,Fail to pick,188,440,0,0,0,0,0,0,0,0,False,0
2025-01-08 14:00:40,persegiMerah,191,438,127,115,98,61,95,59,3,2,True,0.45193824208868416
2025-01-08 14:00:40,Fail to pick,191,438,0,0,0,0,0,0,0,0,False,0
2025-01-08 14:00:41,persegiMerah,192,441,128,116,99,37,101,40,2,3,True,0.32425390912992086
2025-01-08 14:00:41,Fail to pick,192,441,0,0,0,0,0,0,0,0,False,0
2025-01-08 14:00:41,persegiMerah,186,442,122,117,78,8,78,5,0,3,True,0.23936018230334946
2025-01-08 14:00:41,Fail to pick,186,442,0,0,0,0,0,0,0,0,False,0
2025-01-08 14:00:41,persegiMerah,180,443,125,116,148,6,148,8,0,2,True,0.1460851646375379
2025-01-08 14:00:41,Fail to pick,180,443,0,0,0,0,0,0,0,0,False,0
2025-01-08 14:00:41,persegiMerah,189,445,123,115,165,87,167,82,2,5,True,0.14808853355726914
2025-01-08 14:00:41,Fail to pick,189,445,0,0,0,0,0,0,0,0,False,0
2025-01-08 14:00:41,persegiMerah,187,441,124,116,163,10,160,11,3,1,True,0.1585331019725739
2025-01-08 14:00:41,Fail to pick,187,441,0,0,0,0,0,0,0,0,False,0
2025-01-08 14:00:41,persegiMerah,186,442,124,115,30,7,25,4,5,3,True,0.17501120959540903
2025-01-08 14:00:41,Fail to pick,186,442,0,0,0,0,0,0,0,0,False,0
2025-01-08 14:00:41,persegiMerah,191,443,128,116,13,30,15,25,2,5,True,0.3115397194863563
2025-01-08 14:00:41,Fail to pick,191,443,0,0,0,0,0,0,0,0,False,0
2025-01-08 14:00:41,persegiMerah,175,445,121,116,9,89,4,93,5,4,True,0.49108643060032453
2025-01-08 14:00:41,Merah,175,445,tensor(121.5469),tensor(116.3453),76,16,80,20,4,4,True,0.0004987716674804688
2025-01-08 14:00:41,persegiMerah,185,438,124,117,192,56,196,58,4,2,True,0.18266113553079455
2025-01-08 14:00:41,persegiMerah,180,444,124,117,69,15,66,15,3,0,True,0.1744348087621062
2025-01-08 14:00:41,Fail to pick,180,444,0,0,0,0,0,0,0,0,False,0
2025-01-08 14:00:42,persegiMerah,187,441,125,117,83,2,79,-3,4,5,True,0.39472854696395887
2025-01-08 14:00:42,Fail to pick,187,441,0,0,0,0,0,0,0,0,False,0
2025-01-08 14:00:42,persegiMerah,183,445,121,117,6,46,8,49,2,3,True,0.3449002881297375
2025-01-08 14:00:42,Fail to pick,183,445,0,0,0,0,0,0,0,0,False,0
2025-01-08 14:00:42,persegiMerah,189,445,123,116,124,96,126,93,2,3,True,0.47763022418323087
2025-01-08 14:00:42,Fail to pick,189,445,0,0,0,0,0,0,0,0,False,0
2025-01-08 14:00:42,persegiMerah,185,443,126,116,69,1,72,1,3,0,True,0.1640881346260552
2025-01-08 14:00:42,Fail to pick,185,443,0,0,0,0,0,0,0,0,False,0
2025-01-08 14:00:42,persegiMerah,181,444,119,117,38,49,42,48,4,1,True,0.13667377507349823
2025-01-08 14:00:42,Fail to pick,181,444,0,0,0,0,0,0,0,0,False,0
2025-01-08 14:00:42,persegiMerah,187,442,124,117,53,26,55,27,2,1,True,0.436928125931378
2025-01-08 14:00:42,Fail to pick,187,442,0,0,0,0,0,0,0,0,False,0
2025-01-08 14:00:42,persegiMerah,182,442,125,116,16,37,16,39,0,2,True,0.3810463588160454
2025-01-08 14:00:42,Fail to pick,182,442,0,0,0,0,0,0,0,0,False,0
2025-01-08 14:00:42,persegiMerah,188,441,124,115,37,3,40,4,3,1,True,0.2409833253019661
2025-01-08 14:00:42,Merah,188,441,tensor(124.6486),tensor(115.5149),77,17,72,20,5,3,True,0.0005471706390380859
2025-01-08 14:00:42,Fail to pick,188,441,0,0,0,0,0,0,0,0,False,0
2025-01-08 14:00:42,persegiMerah,190,441,128,115,96,51,98,47,2,4,True,0.11863902049763109
2025-01-08 14:00:42,Fail to pick,190,441,0,0,0,0,0,0,0,0,False,0
2025-01-08 14:00:43,persegiMerah,186,443,124,116,127,77,124,72,3,5,True,0.4162661451546624
2025-01-08 14:00:43,Fail to pick,186,443,0,0,0,0,0,0,0,0,False,0
2025-01-08 14:00:43,persegiMerah,184,442,122,116,109,92,111,90,2,2,True,0.24503351701824877
2025-01-08 14:00:43,Fail to pick,184,442,0,0,0,0,0,0,0,0,False,0
2025-01-08 14:00:43,persegiMerah,186,440,121,116,36,68,33,63,3,5,True,0.2722042288673897
2025-01-08 14:00:43,Fail to pick,186,440,0,0,0,0,0,0,0,0,False,0
2025-01-08 14:00:43,persegiMerah,186,440,122,117,191,80,187,79,4,1,True,0.16206202699216013
2025-01-08 14:00:43,Fail to pick,186,440,0,0,0,0,0,0,0,0,False,0
2025-01-08 14:00:43,persegiMerah,187,443,123,118,77,76,72,80,5,4,True,0.31805013781255065
2025-01-08 14:00:43,Fail to pick,187,443,0,0,0,0,0,0,0,0,False,0
2025-01-08 14:00:43,persegiMerah,185,442,121,117,159,52,162,48,3,4,True,0.24570492772426866
2025-01-08 14:00:43,Merah,185,442,tensor(121.8187),tensor(117.7488),77,17,76,13,1,4,True,0.0
2025-01-08 14:00:43,Fail to pick,185,442,0,0,0,0,0,0,0,0,False,0
2025-01-08 14:00:44,persegiMerah,191,445,128,117,180,70,180,71,0,1,False,0.12696861655060349
2025-01-08 14:00:44,Fail to pick,191,445,0,0,0,0,0,0,0,0,False,0
2025-01-08 14:00:44,persegiMerah,182,444,120,117,58,29,53,30,5,1,True,0.49502320247250375
2025-01-08 14:00:44,Fail to pick,182,444,0,0,0,0,0,0,0,0,False,0
2025-01-08 14:00:44,persegiMerah,185,442,123,120,199,47,200,45,1,2,True,0.16600653572150575
2025-01-08 14:00:44,Fail to pick,185,442,0,0,0,0,0,0,0,0,False,0
2025-01-08 14:00:44,persegiMerah,191,437,127,117,75,29,77,33,2,4,True,0.368571930449234
2025-01-08 14:00:44,Fail to pick,191,437,0,0,0,0,0,0,0,0,False,0
2025-01-08 14:00:44,persegiMerah,185,441,121,117,111,16,114,11,3,5,True,0.431122509026025
2025-01-08 14:00:44,Fail to pick,185,441,0,0,0,0,0,0,0,0,False,0
2025-01-08 14:00:44,persegiMerah,193,443,127,115,110,50,110,51,0,1,True,0.3356178211664681
2025-01-08 14:00:44,Fail to pick,193,443,0,0,0,0,0,0,0,0,False,0
2025-01-08 14:00:44,persegiMerah,193,434,127,118,44,78,44,81,0,3,True,0.11985449671015509
2025-01-08 14:00:44,Fail to pick,193,434,0,0,0,0,0,0,0,0,False,0
2025-01-08 14:00:44,persegiMerah,188,442,123,117,116,57,117,56,1,1,False,0.42860107586270757
2025-01-08 14:00:44,Fail to pick,188,442,0,0,0,0,0,0,0,0,False,0
2025-01-08 14:00:44,persegiMerah,188,443,126,115,27,30,31,31,4,1,True,0.2243777233463674
2025-01-08 14:00:44,Fail to pick,188,443,0,0,0,0,0,0,0,0,False,0
2025-01-08 14:00:45,persegiMerah,185,444,123,116,94,3,92,7,2,4,True,0.45116023268381755
2025-01-08 14:00:45,Merah,185,444,tensor(123.7227),tensor(116.7773),76,17,75,18,1,1,True,0.0
2025-01-08 14:00:45,Fail to pick,185,444,0,0,0,0,0,0,0,0,False,0
2025-01-08 14:00:45,persegiMerah,184,446,119,115,132,28,136,30,4,2,True,0.4172663095938737
2025-01-08 14:00:45,Fail to pick,184,446,0,0,0,0,0,0,0,0,False,0
2025-01-08 14:00:45,persegiMerah,186,441,122,117,87,62,91,57,4,5,True,0.21819257353333482
2025-01-08 14:00:45,Fail to pick,186,441,0,0,0,0,0,0,0,0,False,0
2025-01-08 14:00:45,persegiMerah,182,443,121,116,165,2,167,1,2,1,True,0.4697477513855436
2025-01-08 14:00:45,Fail to pick,182,443,0,0,0,0,0,0,0,0,False,0
2025-01-08 14:00:45,persegiMerah,194,440,125,116,168,60,166,63,2,3,True,0.44620178224800655
2025-01-08 14:00:45,persegiMerah,191,436,127,115,2,20,-1,22,3,2,True,0.41874753396591546
2025-01-08 14:00:45,Fail to pick,191,436,0,0,0,0,0,0,0,0,False,0
2025-01-08 14:00:45,persegiMerah,192,444,125,116,88,11,84,12,4,1,True,0.2069718814946402
2025-01-08 14:00:45,Fail to pick,192,444,0,0,0,0,0,0,0,0,False,0
2025-01-08 14:00:45,persegiMerah,184,443,118,118,143,90,147,91,4,1,True,0.1698171165471004
2025-01-08 14:00:45,Fail to pick,184,443,0,0,0,0,0,0,0,0,False,0
2025-01-08 14:09:59,persegiBiru,214,409,119,115,146,79,144,76,2,3,True,0.459177196789069
2025-01-08 14:09:59,Biru,214,409,tensor(119.6074),tensor(115.0057),86,19,81,22,5,3,True,0.0
2025-01-08 14:09:59,persegiMerah,222,448,122,111,20,78,15,82,5,4,True,0.44196360638151544
2025-01-08 14:10:00,persegiMerah,223,456,118,112,114,72,111,68,3,4,True,0.3389594276087653
2025-01-08 14:10:00,Fail to pick,223,456,0,0,0,0,0,0,0,0,False,0
2025-01-08 14:10:00,persegiBiru,214,463,115,110,60,77,64,77,4,0,True,0.241006876437313
2025-01-08 14:10:00,Fail to pick,214,463,0,0,0,0,0,0,0,0,False,0
2025-01-08 14:10:00,persegiBiru,194,464,126,113,152,54,151,52,1,2,True,0.26819173343230573
2025-01-08 14:10:00,persegiBiru,203,462,124,113,174,25,178,24,4,1,True,0.43279633950276886
2025-01-08 14:10:00,Fail to pick,203,462,0,0,0,0,0,0,0,0,False,0
2025-01-08 14:10:00,persegiMerah,213,455,117,112,143,84,144,80,1,4,True,0.43640101920944696
2025-01-08 14:10:01,persegiMerah,214,458,118,114,9,64,12,60,3,4,True,0.21332018201477793
2025-01-08 14:10:01,Fail to pick,214,458,0,0,0,0,0,0,0,0,False,0
2025-01-08 14:10:01,persegiBiru,212,457,120,111,112,30,109,30,3,0,True,0.44234310987943926
2025-01-08 14:10:01,Fail to pick,212,457,0,0,0,0,0,0,0,0,False,0
2025-01-08 14:10:02,persegiMerah,213,458,118,115,34,31,38,31,4,0,True,0.22993135501985976
2025-01-08 14:10:02,Fail to pick,213,458,0,0,0,0,0,0,0,0,False,0
2025-01-08 14:10:02,persegiMerah,214,457,114,112,90,63,87,59,3,4,True,0.3016261419581747
2025-01-08 14:10:02,Fail to pick,214,457,0,0,0,0,0,0,0,0,False,0
2025-01-08 14:10:02,persegiMerah,211,457,116,112,106,3,108,1,2,2,True,0.41322927937170373
2025-01-08 14:10:02,Fail to pick,211,457,0,0,0,0,0,0,0,0,False,0
2025-01-08 14:10:02,persegiMerah,217,455,118,110,53,83,50,82,3,1,True,0.4598385291312187
2025-01-08 14:10:02,Fail to pick,217,455,0,0,0,0,0,0,0,0,False,0
2025-01-08 14:10:02,persegiBiru,211,460,117,112,196,7,198,2,2,5,True,0.23139050647720383
2025-01-08 14:10:02,Fail to pick,211,460,0,0,0,0,0,0,0,0,False,0
2025-01-08 14:10:03,persegiMerah,214,455,113,113,187,15,188,17,1,2,True,0.20774349698450867
2025-01-08 14:10:03,Fail to pick,214,455,0,0,0,0,0,0,0,0,False,0
2025-01-08 14:10:03,persegiMerah,212,454,123,110,155,23,152,20,3,3,True,0.11783827106448302
2025-01-08 14:10:03,Fail to pick,212,454,0,0,0,0,0,0,0,0,False,0
2025-01-08 14:10:03,persegiMerah,212,455,112,111,123,57,125,54,2,3,True,0.3633605143828442
2025-01-08 14:10:03,Fail to pick,212,455,0,0,0,0,0,0,0,0,False,0
2025-01-08 14:10:05,persegiBiru,196,465,124,113,73,73,68,68,5,5,True,0.3235680829692097
2025-01-08 14:10:06,persegiMerah,195,426,114,113,112,28,114,26,2,2,True,0.38567157000294094
2025-01-08 14:10:06,Merah,195,426,tensor(114.8126),tensor(113.3915),81,18,80,13,1,5,True,0.0
2025-01-08 14:10:06,persegiBiru,227,454,118,115,20,19,17,20,3,1,True,0.49829337411478714
2025-01-08 14:10:07,persegiMerah,217,481,116,114,78,85,82,81,4,4,True,0.4990572106046146
2025-01-08 14:10:08,persegiMerah,194,485,127,116,160,83,163,84,3,1,True,0.17811575350925546
2025-01-08 14:10:08,persegiMerah,214,485,116,116,85,82,88,86,3,4,True,0.35056993702502637
2025-01-08 14:10:08,persegiBiru,189,458,110,123,91,62,95,66,4,4,True,0.2604433341508904
2025-01-08 14:10:10,persegiMerah,233,475,113,118,34,96,38,99,4,3,True,0.4265970323607927
2025-01-08 14:10:12,persegiBiru,177,463,116,113,133,97,129,92,4,5,True,0.29774049115575363
2025-01-08 14:10:13,persegiMerah,214,431,115,127,136,47,135,47,1,0,True,0.15946464882915623
2025-01-08 14:10:13,persegiMerah,209,420,118,116,29,4,26,8,3,4,True,0.2959510424405896
2025-01-08 14:10:13,persegiMerah,228,439,123,114,44,53,45,56,1,3,True,0.15333881258930707
2025-01-08 14:10:13,persegiMerah,213,422,116,118,4,54,7,49,3,5,True,0.1515897373495844
2025-01-08 14:10:13,persegiMerah,207,423,113,119,151,9,148,13,3,4,True,0.16453976337836754
2025-01-08 14:10:13,Fail to pick,207,423,0,0,0,0,0,0,0,0,False,0
2025-01-08 14:10:13,persegiMerah,215,419,121,117,25,74,26,77,1,3,True,0.30018494585376954
2025-01-08 14:10:13,Fail to pick,215,419,0,0,0,0,0,0,0,0,False,0
2025-01-08 14:10:14,persegiMerah,216,426,119,120,51,37,55,32,4,5,True,0.22107396127732737
2025-01-08 14:10:14,Fail to pick,216,426,0,0,0,0,0,0,0,0,False,0
2025-01-08 14:10:14,persegiMerah,217,426,120,120,5,10,9,12,4,2,True,0.14448408485173803
2025-01-08 14:10:14,Fail to pick,217,426,0,0,0,0,0,0,0,0,False,0
2025-01-08 14:10:14,persegiMerah,213,423,117,118,115,35,119,35,4,0,False,0.4950922118073864
2025-01-08 14:10:14,Fail to pick,213,423,0,0,0,0,0,0,0,0,False,0
2025-01-08 14:10:14,persegiMerah,216,417,123,116,78,34,78,29,0,5,True,0.32051883932431374
2025-01-08 14:10:14,Fail to pick,216,417,0,0,0,0,0,0,0,0,False,0
2025-01-08 14:10:14,persegiMerah,212,418,114,116,160,12,163,11,3,1,True,0.49608495481295
2025-01-08 14:10:14,Fail to pick,212,418,0,0,0,0,0,0,0,0,False,0
2025-01-08 14:10:14,persegiMerah,212,419,117,117,156,44,154,48,2,4,True,0.353942206729291
2025-01-08 14:10:14,Fail to pick,212,419,0,0,0,0,0,0,0,0,False,0
2025-01-08 14:10:14,persegiMerah,211,423,113,116,196,67,197,64,1,3,True,0.180146035594478
2025-01-08 14:10:14,Fail to pick,211,423,0,0,0,0,0,0,0,0,False,0
2025-01-08 14:10:14,persegiMerah,226,440,121,115,147,0,146,-3,1,3,True,0.3241042136761406
2025-01-08 14:10:15,persegiMerah,216,458,115,116,105,4,107,1,2,3,False,0.40325963769407436
2025-01-08 14:10:15,persegiMerah,201,425,114,114,3,92,2,90,1,2,True,0.25678939218799235
2025-01-08 14:10:15,persegiMerah,200,421,113,116,134,95,134,97,0,2,True,0.18808337561489286
2025-01-08 14:10:15,Fail to pick,200,421,0,0,0,0,0,0,0,0,False,0
2025-01-08 14:10:15,persegiMerah,218,454,115,114,178,84,178,85,0,1,False,0.3442700229332294
2025-01-08 14:10:15,persegiMerah,219,448,114,116,60,43,57,40,3,3,False,0.4937584131365701
2025-01-08 14:10:15,Fail to pick,219,448,0,0,0,0,0,0,0,0,False,0
2025-01-08 14:10:15,persegiMerah,203,418,115,116,41,64,38,62,3,2,True,0.4869208705846034
2025-01-08 14:10:15,persegiMerah,219,452,118,115,185,71,184,75,1,4,True,0.4048891938259811
2025-01-08 14:10:16,persegiMerah,217,455,117,114,85,74,80,77,5,3,True,0.3066231575134766
2025-01-08 14:10:16,Fail to pick,217,455,0,0,0,0,0,0,0,0,False,0
2025-01-08 14:10:17,persegiMerah,213,455,117,115,148,77,146,80,2,3,True,0.314301194145064
2025-01-08 14:10:17,Fail to pick,213,455,0,0,0,0,0,0,0,0,False,0
2025-01-08 14:10:17,persegiMerah,213,456,116,114,95,13,97,15,2,2,True,0.37612132634434126
2025-01-08 14:10:17,Fail to pick,213,456,0,0,0,0,0,0,0,0,False,0
2025-01-08 14:10:17,persegiMerah,206,415,113,114,183,52,187,49,4,3,True,0.31953918696374284
2025-01-08 14:10:17,Merah,206,415,tensor(113.9422),tensor(114.6130),84,19,87,19,3,0,True,0.0
2025-01-08 14:10:17,persegiMerah,198,423,117,114,134,85,134,82,0,3,True,0.22832837043369453
2025-01-08 14:10:17,Fail to pick,198,423,0,0,0,0,0,0,0,0,False,0
2025-01-08 14:10:18,persegiMerah,207,414,115,114,131,95,128,90,3,5,True,0.1688026219435655
2025-01-08 14:10:18,Fail to pick,207,414,0,0,0,0,0,0,0,0,False,0
2025-01-08 14:10:20,persegiMerah,225,449,127,112,54,81,57,77,3,4,True,0.13981750009528718
2025-01-08 14:10:20,persegiMerah,219,451,130,109,96,80,98,82,2,2,True,0.2724575492398822
2025-01-08 14:10:20,Fail to pick,219,451,0,0,0,0,0,0,0,0,False,0
2025-01-08 14:10:20,persegiMerah,219,451,130,109,63,35,63,38,0,3,True,0.474493790273932
2025-01-08 14:10:20,Fail to pick,219,451,0,0,0,0,0,0,0,0,False,0
2025-01-08 14:10:20,persegiMerah,204,414,111,118,41,59,43,63,2,4,True,0.2614259369555678
2025-01-08 14:10:21,persegiMerah,207,413,112,115,46,64,48,62,2,2,False,0.23196031436737163
2025-01-08 14:10:21,Fail to pick,207,413,0,0,0,0,0,0,0,0,False,0
2025-01-08 14:10:21,persegiMerah,206,424,115,114,89,13,93,12,4,1,True,0.19773561254311445
2025-01-08 14:10:21,persegiMerah,202,418,115,114,63,84,61,88,2,4,True,0.3722238261814327
2025-01-08 14:10:21,Fail to pick,202,418,0,0,0,0,0,0,0,0,False,0
2025-01-08 14:10:22,persegiMerah,210,418,115,119,183,27,186,25,3,2,True,0.24464650099201546
2025-01-08 14:10:22,Fail to pick,210,418,0,0,0,0,0,0,0,0,False,0
2025-01-08 14:10:22,persegiMerah,216,452,127,113,109,23,106,18,3,5,True,0.3956243566923686
2025-01-08 14:10:22,persegiMerah,185,434,116,119,164,30,165,30,1,0,True,0.16323795905377775
2025-01-08 14:10:22,persegiMerah,212,418,117,116,7,84,5,81,2,3,True,0.23334576444507485
2025-01-08 14:10:22,persegiMerah,203,419,119,118,135,14,133,17,2,3,True,0.42945765618609444
2025-01-08 14:10:22,Fail to pick,203,419,0,0,0,0,0,0,0,0,False,0
2025-01-08 14:10:22,persegiMerah,219,408,119,117,58,49,55,51,3,2,True,0.4593186906919293
2025-01-08 14:10:23,persegiMerah,213,409,115,117,49,17,49,13,0,4,True,0.3409876366625797
2025-01-08 14:10:23,Fail to pick,213,409,0,0,0,0,0,0,0,0,False,0
2025-01-08 14:10:23,persegiMerah,213,409,115,117,175,8,179,7,4,1,True,0.3791611184056757
2025-01-08 14:10:23,Fail to pick,213,409,0,0,0,0,0,0,0,0,False,0
2025-01-08 14:10:23,persegiMerah,223,401,121,119,53,19,56,14,3,5,True,0.29212516500045416
2025-01-08 14:10:23,persegiMerah,210,408,114,116,113,31,114,28,1,3,True,0.23109949843625377
2025-01-08 14:10:23,persegiMerah,215,402,111,118,84,43,80,47,4,4,True,0.25773946555320093
2025-01-08 14:10:23,Fail to pick,215,402,0,0,0,0,0,0,0,0,False,0
2025-01-08 14:10:24,persegiMerah,209,409,112,117,53,37,53,41,0,4,True,0.24429331657723147
2025-01-08 14:10:24,Fail to pick,209,409,0,0,0,0,0,0,0,0,False,0
2025-01-08 14:10:24,persegiMerah,216,403,116,117,70,19,66,17,4,2,True,0.1317661155146308
2025-01-08 14:10:24,Fail to pick,216,403,0,0,0,0,0,0,0,0,False,0
2025-01-08 14:10:24,persegiMerah,217,401,116,119,166,34,163,36,3,2,False,0.41965782041987454
2025-01-08 14:10:24,Fail to pick,217,401,0,0,0,0,0,0,0,0,False,0
2025-01-08 14:10:24,persegiMerah,217,401,116,119,180,64,175,63,5,1,True,0.11481139540744084
2025-01-08 14:10:24,Fail to pick,217,401,0,0,0,0,0,0,0,0,False,0
2025-01-08 14:10:24,persegiMerah,213,402,118,120,154,12,151,9,3,3,True,0.42220793487100705
2025-01-08 14:10:24,Fail to pick,213,402,0,0,0,0,0,0,0,0,False,0
2025-01-08 14:10:25,persegiMerah,213,403,117,117,53,74,56,75,3,1,True,0.4439785331195575
2025-01-08 14:10:25,Fail to pick,213,403,0,0,0,0,0,0,0,0,False,0
2025-01-08 14:10:25,persegiMerah,210,402,118,117,38,40,42,41,4,1,True,0.32047233436985156
2025-01-08 14:10:25,Fail to pick,210,402,0,0,0,0,0,0,0,0,False,0
2025-01-08 14:10:25,persegiMerah,214,404,118,118,107,1,111,-2,4,3,True,0.30000011919894554
2025-01-08 14:10:25,Fail to pick,214,404,0,0,0,0,0,0,0,0,False,0
2025-01-08 14:10:25,persegiMerah,212,401,115,120,45,96,40,100,5,4,True,0.37303989167106344
2025-01-08 14:10:25,Fail to pick,212,401,0,0,0,0,0,0,0,0,False,0
2025-01-08 14:10:25,persegiMerah,221,395,116,117,195,0,196,0,1,0,True,0.3447784551510911
2025-01-08 14:10:25,Fail to pick,221,395,0,0,0,0,0,0,0,0,False,0
2025-01-08 14:10:25,persegiMerah,216,395,116,117,58,28,57,24,1,4,True,0.12229601744810226
2025-01-08 14:10:25,Fail to pick,216,395,0,0,0,0,0,0,0,0,False,0
2025-01-08 14:10:26,persegiMerah,213,397,115,119,54,38,53,36,1,2,True,0.22649724229388038
2025-01-08 14:10:26,Fail to pick,213,397,0,0,0,0,0,0,0,0,False,0
2025-01-08 14:10:26,persegiMerah,215,399,115,117,146,23,143,27,3,4,True,0.420567305114945
2025-01-08 14:10:26,Fail to pick,215,399,0,0,0,0,0,0,0,0,False,0
2025-01-08 14:10:26,persegiMerah,216,397,117,117,87,72,83,75,4,3,True,0.4153634161264119
2025-01-08 14:10:26,Fail to pick,216,397,0,0,0,0,0,0,0,0,False,0
2025-01-08 14:10:26,persegiMerah,219,390,118,115,103,89,103,88,0,1,True,0.2978749620804382
2025-01-08 14:10:26,Fail to pick,219,390,0,0,0,0,0,0,0,0,False,0
2025-01-08 14:10:27,persegiMerah,221,386,120,119,11,97,12,95,1,2,True,0.4968218034763143
2025-01-08 14:10:27,Fail to pick,221,386,0,0,0,0,0,0,0,0,False,0
2025-01-08 14:10:27,persegiMerah,221,387,122,115,54,74,56,74,2,0,True,0.1540476986518193
2025-01-08 14:10:27,Fail to pick,221,387,0,0,0,0,0,0,0,0,False,0
2025-01-08 14:10:29,persegiMerah,194,389,120,118,155,54,152,58,3,4,True,0.31052321355329143
2025-01-08 14:10:29,persegiMerah,186,413,111,118,78,7,82,2,4,5,True,0.4722204099645847
2025-01-08 14:10:30,persegiMerah,153,441,105,114,145,26,146,26,1,0,True,0.472245496145269
2025-01-08 14:10:30,persegiKuning,152,443,109,111,37,86,34,85,3,1,False,0.4595680063988766
2025-01-08 14:10:30,Fail to pick,152,443,0,0,0,0,0,0,0,0,False,0
2025-01-08 14:10:30,persegiKuning,200,416,109,113,103,84,107,83,4,1,False,0.28576973258465915
2025-01-08 14:10:30,persegiKuning,178,412,103,115,95,1,97,5,2,4,True,0.24695183245933122
2025-01-08 14:10:31,persegiMerah,200,409,106,114,66,12,70,15,4,3,True,0.3170058247655062
2025-01-08 14:10:31,persegiMerah,193,409,106,119,58,89,56,88,2,1,True,0.2811733448744642
2025-01-08 14:10:31,Fail to pick,193,409,0,0,0,0,0,0,0,0,False,0
2025-01-08 14:10:31,persegiMerah,201,412,111,114,43,92,43,91,0,1,True,0.1316391661806666
2025-01-08 14:10:31,persegiKuning,201,412,110,114,56,27,55,31,1,4,True,0.49009668535799034
2025-01-08 14:10:31,Fail to pick,201,412,0,0,0,0,0,0,0,0,False,0
2025-01-08 14:10:31,Fail to pick,201,412,0,0,0,0,0,0,0,0,False,0
2025-01-08 14:10:32,persegiMerah,215,461,114,111,180,16,177,13,3,3,True,0.4169581658367324
2025-01-08 14:10:32,Merah,215,461,tensor(114.0343),tensor(111.9156),71,19,68,23,3,4,True,0.0
2025-01-08 14:10:32,persegiMerah,215,458,112,112,136,27,138,22,2,5,True,0.10401027691605012
2025-01-08 14:10:32,Fail to pick,215,458,0,0,0,0,0,0,0,0,False,0
2025-01-08 14:10:32,persegiMerah,219,455,111,111,74,23,70,26,4,3,True,0.4809129060661991
2025-01-08 14:10:32,Fail to pick,219,455,0,0,0,0,0,0,0,0,False,0
2025-01-08 14:10:32,persegiMerah,219,453,112,111,18,58,18,56,0,2,True,0.2972645428963677
2025-01-08 14:10:32,Fail to pick,219,453,0,0,0,0,0,0,0,0,False,0
2025-01-08 14:10:33,persegiMerah,218,455,113,111,42,7,41,9,1,2,True,0.42448007423738887
2025-01-08 14:10:33,Fail to pick,218,455,0,0,0,0,0,0,0,0,False,0
2025-01-08 14:10:33,persegiMerah,219,453,111,108,25,6,27,9,2,3,True,0.162086635614841
2025-01-08 14:10:33,Fail to pick,219,453,0,0,0,0,0,0,0,0,False,0
2025-01-08 14:10:33,persegiMerah,230,451,115,109,179,46,182,50,3,4,True,0.12252781726964318
2025-01-08 14:10:33,persegiMerah,204,418,109,113,115,40,113,36,2,4,True,0.21871513718862237
2025-01-08 14:10:34,persegiMerah,161,458,119,125,32,30,32,30,0,0,True,0.23406597471104662
2025-01-08 14:10:34,persegiMerah,235,443,114,108,163,81,164,79,1,2,True,0.15772390514088858
2025-01-08 14:10:35,persegiMerah,239,442,116,108,91,95,90,94,1,1,True,0.39955185953467376
2025-01-08 14:10:35,Fail to pick,239,442,0,0,0,0,0,0,0,0,False,0
2025-01-08 14:10:35,persegiBiru,202,409,109,111,139,58,143,61,4,3,True,0.25122482294399023
2025-01-08 14:10:35,persegiMerah,240,441,116,109,115,1,115,3,0,2,True,0.20065174586712142
2025-01-08 14:10:35,persegiMerah,231,442,114,107,55,32,52,29,3,3,True,0.19349700005112186
2025-01-08 14:10:35,Fail to pick,231,442,0,0,0,0,0,0,0,0,False,0
2025-01-08 14:10:36,persegiKuning,183,195,106,121,61,69,65,70,4,1,True,0.3748905743041804
2025-01-08 14:10:36,Kuning,183,195,tensor(106.0933),tensor(121.4506),145,16,144,19,1,3,True,0.0
2025-01-08 14:10:37,persegiMerah,229,231,111,116,90,65,86,64,4,1,True,0.13509011965347414
2025-01-08 14:10:37,persegiMerah,238,232,118,120,55,49,57,52,2,3,True,0.18989257226486855
2025-01-08 14:10:37,Fail to pick,238,232,0,0,0,0,0,0,0,0,False,0
2025-01-08 14:10:37,persegiMerah,237,227,114,120,195,81,196,83,1,2,True,0.15511038604922245
2025-01-08 14:10:37,Fail to pick,237,227,0,0,0,0,0,0,0,0,False,0
2025-01-08 14:10:38,persegiMerah,239,227,117,117,55,52,56,47,1,5,True,0.2468286905997808
2025-01-08 14:10:38,Fail to pick,239,227,0,0,0,0,0,0,0,0,False,0
2025-01-08 14:10:39,persegiMerah,215,239,117,127,83,98,83,102,0,4,True,0.3752124913932957
2025-01-08 14:10:39,persegiMerah,197,247,118,125,53,8,50,5,3,3,True,0.2756916860019064
2025-01-08 14:10:39,persegiMerah,218,238,115,128,27,41,29,40,2,1,False,0.4953942076063894
2025-01-08 14:10:39,persegiMerah,217,238,115,128,91,18,87,21,4,3,True,0.12389670588551437
2025-01-08 14:10:39,Fail to pick,217,238,0,0,0,0,0,0,0,0,False,0
2025-01-08 14:10:39,persegiKuning,176,206,103,117,157,83,159,87,2,4,True,0.1116865885742524
2025-01-08 14:10:39,persegiMerah,203,248,119,125,123,76,125,77,2,1,True,0.31159428512155346
2025-01-08 14:10:39,Merah,203,248,tensor(119.8515),tensor(125.7655),131,18,135,16,4,2,True,0.0
2025-01-08 14:10:40,persegiMerah,223,237,120,127,48,71,47,71,1,0,False,0.22543926052694238
2025-01-08 14:10:40,persegiMerah,209,245,116,126,161,10,164,7,3,3,True,0.2245510328268411
2025-01-08 14:10:40,persegiKuning,170,212,106,124,48,89,52,87,4,2,True,0.24053189503614159
2025-01-08 14:10:40,persegiMerah,194,250,124,128,171,14,170,16,1,2,True,0.3657028167996571
2025-01-08 14:10:40,persegiMerah,176,209,104,125,150,38,154,35,4,3,True,0.37081204477835017
2025-01-08 14:10:41,persegiMerah,218,238,113,125,70,39,72,42,2,3,True,0.271865808244969
2025-01-08 14:10:41,persegiKuning,171,212,104,121,76,14,79,11,3,3,True,0.1404696119739764
2025-01-08 14:10:41,persegiMerah,211,244,117,125,171,16,170,18,1,2,True,0.47117775080007473
2025-01-08 14:10:41,persegiMerah,217,241,114,127,155,84,155,86,0,2,True,0.47322959037770995
2025-01-08 14:10:41,Fail to pick,217,241,0,0,0,0,0,0,0,0,False,0
2025-01-08 14:10:41,persegiKuning,175,207,104,117,46,43,44,47,2,4,True,0.14479465474379039
2025-01-08 14:10:42,persegiMerah,218,236,117,124,141,92,145,92,4,0,True,0.17375837179954692
2025-01-08 14:10:42,persegiMerah,214,242,114,125,160,63,155,67,5,4,True,0.12564888178715075
2025-01-08 14:10:42,Fail to pick,214,242,0,0,0,0,0,0,0,0,False,0
2025-01-08 14:10:42,persegiMerah,189,199,109,121,182,45,183,49,1,4,True,0.15707134808449622
2025-01-08 14:10:42,Merah,189,199,tensor(109.4529),tensor(121.0343),144,17,142,18,2,1,True,0.0
2025-01-08 14:10:42,persegiMerah,185,251,118,127,154,26,153,30,1,4,True,0.23990123420599443
2025-01-08 14:10:42,persegiMerah,211,245,116,125,96,4,97,8,1,4,True,0.3568150701700613
2025-01-08 14:10:42,persegiMerah,227,230,116,122,71,72,72,76,1,4,True,0.2619875559450022
2025-01-08 14:10:42,persegiMerah,216,240,115,126,9,77,6,78,3,1,False,0.3472735052121033
2025-01-08 14:10:42,persegiMerah,167,210,105,125,84,96,81,96,3,0,False,0.4613604196892257
2025-01-08 14:10:43,persegiMerah,212,244,112,127,129,58,130,61,1,3,True,0.25565565259435397
2025-01-08 14:10:43,persegiMerah,182,257,119,126,111,28,113,23,2,5,True,0.12106896457430137
2025-01-08 14:10:43,persegiMerah,237,225,118,120,37,67,36,65,1,2,True,0.2620255120150349
2025-01-08 14:10:43,persegiMerah,199,247,116,126,10,31,14,27,4,4,False,0.1725055847046603
2025-01-08 14:10:44,persegiMerah,213,244,113,127,126,12,127,7,1,5,True,0.39277678297655205
2025-01-08 14:10:44,persegiMerah,189,194,108,118,156,58,156,53,0,5,True,0.11661543414749583
2025-01-08 14:10:44,Merah,189,194,tensor(108.3671),tensor(118.6720),146,17,142,16,4,1,True,0.0
2025-01-08 14:10:44,persegiMerah,164,208,105,124,52,88,53,91,1,3,False,0.33810669268039395
2025-01-08 14:10:46,persegiMerah,184,189,111,122,80,17,80,19,0,2,True,0.4175834397603845
2025-01-08 14:10:47,persegiMerah,207,199,112,119,197,13,196,17,1,4,True,0.19016653406588013
2025-01-08 14:10:47,persegiKuning,207,200,112,121,12,39,16,42,4,3,True,0.46937273165269433
2025-01-08 14:10:47,Fail to pick,207,200,0,0,0,0,0,0,0,0,False,0
2025-01-08 14:10:47,persegiMerah,187,188,110,123,16,16,12,14,4,2,False,0.21940787158848918
2025-01-08 14:10:47,persegiMerah,201,192,109,119,164,5,160,9,4,4,True,0.2811866456486459
2025-01-08 14:10:47,persegiMerah,192,191,112,120,69,64,70,64,1,0,True,0.46955390933530883
2025-01-08 14:10:47,Fail to pick,192,191,0,0,0,0,0,0,0,0,False,0
2025-01-08 14:10:48,persegiMerah,186,187,109,122,57,60,53,59,4,1,True,0.15222607811036615
2025-01-08 14:10:48,Fail to pick,186,187,0,0,0,0,0,0,0,0,False,0
2025-01-08 14:10:48,persegiMerah,187,186,109,124,138,52,134,53,4,1,True,0.38507561110383515
2025-01-08 14:10:48,Fail to pick,187,186,0,0,0,0,0,0,0,0,False,0
2025-01-08 14:10:48,persegiMerah,194,197,112,124,31,85,27,83,4,2,True,0.4679394770761002
2025-01-08 14:10:48,persegiKuning,208,201,110,123,10,38,13,37,3,1,True,0.17804393527125595
2025-01-08 14:10:49,persegiMerah,217,209,116,125,54,90,53,91,1,1,True,0.3399587462643119
2025-01-08 14:10:49,Fail to pick,217,209,0,0,0,0,0,0,0,0,False,0
2025-01-08 14:10:49,persegiMerah,232,216,121,124,167,39,170,34,3,5,True,0.1777334225100051
2025-01-08 14:10:49,persegiMerah,191,187,112,122,61,36,62,32,1,4,True,0.34352408440264626
2025-01-08 14:10:49,persegiMerah,204,184,114,117,30,74,31,72,1,2,True,0.39330921268402286
2025-01-08 14:11:27,persegiMerah,205,173,112,109,28,30,24,25,4,5,True,0.44935753158638725
2025-01-08 14:11:27,Merah,205,173,tensor(112.2851),tensor(109.3656),151,18,150,18,1,0,True,0.0004999637603759766
2025-01-08 14:11:27,persegiMerah,235,226,118,123,128,12,129,10,1,2,True,0.32338114278670027
2025-01-08 14:11:28,persegiMerah,227,234,117,124,116,80,114,75,2,5,True,0.49804669178812444
2025-01-08 14:11:28,Fail to pick,227,234,0,0,0,0,0,0,0,0,False,0
2025-01-08 14:11:28,persegiMerah,153,225,111,128,28,87,29,83,1,4,True,0.12270358797997326
2025-01-08 14:11:28,persegiKuning,153,225,111,128,55,85,53,86,2,1,True,0.4040311520526859
2025-01-08 14:11:28,Fail to pick,153,225,0,0,0,0,0,0,0,0,False,0
2025-01-08 14:11:28,persegiMerah,193,206,107,124,160,63,157,63,3,0,True,0.2940656239850639
2025-01-08 14:11:28,persegiMerah,157,223,116,125,198,8,198,10,0,2,False,0.22800511219060052
2025-01-08 14:11:28,persegiMerah,162,222,109,128,198,81,199,76,1,5,True,0.20197475679866927
2025-01-08 14:11:28,Fail to pick,162,222,0,0,0,0,0,0,0,0,False,0
2025-01-08 14:11:28,persegiMerah,190,202,109,127,178,31,179,33,1,2,True,0.19515395459332618
2025-01-08 14:11:29,persegiMerah,187,252,121,126,21,48,23,51,2,3,True,0.3802767120195215
2025-01-08 14:11:29,Merah,187,252,tensor(121.7084),tensor(126.9279),130,17,133,16,3,1,True,0.0
2025-01-08 14:11:29,persegiMerah,143,226,116,124,31,42,32,39,1,3,True,0.489490267550285
2025-01-08 14:11:29,persegiMerah,229,236,112,126,31,55,34,58,3,3,True,0.3448093800576387
2025-01-08 14:11:29,persegiMerah,195,249,122,130,54,64,58,68,4,4,True,0.32852884783167713
2025-01-08 14:11:29,persegiMerah,161,223,113,124,62,0,58,-3,4,3,True,0.19938952177112956
2025-01-08 14:11:29,persegiKuning,162,223,114,123,186,1,181,-3,5,4,True,0.2941556976173556
2025-01-08 14:11:29,Fail to pick,162,223,0,0,0,0,0,0,0,0,False,0
2025-01-08 14:11:30,persegiMerah,188,252,120,127,55,41,51,45,4,4,True,0.27499094313046246
2025-01-08 14:11:30,Merah,188,252,tensor(120.7744),tensor(127.1922),130,17,133,19,3,2,True,0.0004992485046386719
2025-01-08 14:11:30,persegiKuning,168,214,103,123,26,16,25,18,1,2,True,0.15492164020915627
2025-01-08 14:11:30,persegiMerah,222,221,111,125,106,93,107,96,1,3,True,0.43520019575905866
2025-01-08 14:11:30,persegiMerah,212,243,117,128,104,40,99,39,5,1,True,0.29625950282875246
2025-01-08 14:11:31,persegiKuning,145,224,111,124,12,92,9,93,3,1,True,0.3576298960313439
2025-01-08 14:11:31,persegiKuning,190,201,106,122,43,83,44,87,1,4,True,0.35120176628742483
2025-01-08 14:11:31,Kuning,190,201,tensor(106.0569),tensor(122.3384),144,17,143,21,1,4,True,0.0004990100860595703
2025-01-08 14:11:32,persegiMerah,193,206,107,121,91,2,95,3,4,1,False,0.39564114258960126
2025-01-08 14:11:32,Fail to pick,193,206,0,0,0,0,0,0,0,0,False,0
2025-01-08 14:11:32,persegiMerah,231,232,112,120,188,49,190,51,2,2,True,0.3305987929058749
2025-01-08 14:11:33,persegiKuning,193,204,108,120,96,24,96,28,0,4,True,0.15844262676232576
2025-01-08 14:11:33,persegiMerah,230,233,112,123,61,77,62,74,1,3,True,0.15646043873953178
2025-01-08 14:11:34,persegiKuning,179,205,104,120,176,3,172,6,4,3,True,0.2842223644034845
2025-01-08 14:11:34,persegiKuning,179,205,104,119,26,19,26,17,0,2,True,0.3417581186042522
2025-01-08 14:11:34,Fail to pick,179,205,0,0,0,0,0,0,0,0,False,0
2025-01-08 14:11:34,persegiMerah,229,232,111,120,101,21,96,18,5,3,True,0.24804001471673554
2025-01-08 14:11:35,persegiKuning,178,206,103,118,60,25,57,28,3,3,True,0.3423777126108887
2025-01-08 14:11:35,persegiMerah,228,235,115,124,141,49,137,51,4,2,True,0.498061968775498
2025-01-08 14:11:35,persegiKuning,190,197,103,119,29,91,25,91,4,0,True,0.4500561162714384
2025-01-08 14:11:35,persegiMerah,230,231,111,124,20,42,20,41,0,1,True,0.1692033574141473
2025-01-08 14:11:35,persegiKuning,190,205,104,117,130,63,130,62,0,1,True,0.3217333879987184
2025-01-08 14:11:37,persegiBiru,314,575,116,106,66,36,68,36,2,0,True,0.4044832695717583
2025-01-08 14:11:37,Biru,314,575,tensor(116.5833),tensor(106.5095),40,29,39,27,1,2,True,0.0005056858062744141
2025-01-08 14:11:37,persegiBiru,303,585,117,106,44,33,43,30,1,3,True,0.28617254102952594
2025-01-08 14:11:37,persegiBiru,300,586,114,105,81,69,80,65,1,4,True,0.3398983748330784
2025-01-08 14:11:37,Fail to pick,300,586,0,0,0,0,0,0,0,0,False,0
2025-01-08 14:11:37,persegiBiru,301,584,115,106,29,24,32,25,3,1,True,0.16417465267346942
2025-01-08 14:11:37,Fail to pick,301,584,0,0,0,0,0,0,0,0,False,0
2025-01-08 14:11:37,persegiBiru,302,586,117,106,152,93,148,92,4,1,True,0.2773149196778427
2025-01-08 14:11:37,Fail to pick,302,586,0,0,0,0,0,0,0,0,False,0
2025-01-08 14:11:38,persegiBiru,299,586,114,105,43,76,40,80,3,4,True,0.36927931813212833
2025-01-08 14:11:38,Fail to pick,299,586,0,0,0,0,0,0,0,0,False,0
2025-01-08 14:11:38,persegiKuning,260,564,111,113,20,33,17,28,3,5,True,0.18520928716971508
2025-01-08 14:11:38,persegiBiru,294,589,115,106,77,96,78,92,1,4,True,0.2754728133085579
2025-01-08 14:11:38,persegiBiru,301,589,115,105,60,25,61,27,1,2,True,0.24505341922202445
2025-01-08 14:11:38,Fail to pick,301,589,0,0,0,0,0,0,0,0,False,0
2025-01-08 14:11:38,persegiBiru,289,594,112,108,35,6,32,6,3,0,True,0.42718566897473853
2025-01-08 14:11:38,persegiBiru,300,586,114,107,141,42,137,44,4,2,True,0.21167846982507976
2025-01-08 14:11:39,persegiBiru,302,586,117,106,102,0,99,0,3,0,True,0.28747700836271073
2025-01-08 14:11:39,Fail to pick,302,586,0,0,0,0,0,0,0,0,False,0
2025-01-08 14:11:39,persegiBiru,300,586,113,107,197,98,192,95,5,3,True,0.35744155846939873
2025-01-08 14:11:39,Fail to pick,300,586,0,0,0,0,0,0,0,0,False,0
2025-01-08 14:11:39,persegiKuning,265,563,108,112,72,25,72,22,0,3,True,0.387744717722161
2025-01-08 14:11:40,persegiBiru,298,585,114,105,47,88,46,90,1,2,True,0.40725997682323767
2025-01-08 14:11:40,persegiBiru,296,585,112,104,75,59,77,54,2,5,True,0.2098017710317505
2025-01-08 14:11:40,Fail to pick,296,585,0,0,0,0,0,0,0,0,False,0
2025-01-08 14:11:40,persegiKuning,262,564,110,114,13,89,11,86,2,3,True,0.20637221028168426
2025-01-08 14:11:40,persegiBiru,304,581,113,104,62,32,63,31,1,1,True,0.14748320672271828
2025-01-08 14:11:41,persegiBiru,298,589,111,106,110,59,106,55,4,4,True,0.1996372469782923
2025-01-08 14:11:41,Fail to pick,298,589,0,0,0,0,0,0,0,0,False,0
2025-01-08 14:11:41,persegiBiru,298,584,114,104,178,29,178,24,0,5,True,0.47976605765019276
2025-01-08 14:11:41,Fail to pick,298,584,0,0,0,0,0,0,0,0,False,0
2025-01-08 14:11:41,persegiBiru,301,587,111,105,99,21,95,19,4,2,True,0.350575901332155
2025-01-08 14:11:41,Fail to pick,301,587,0,0,0,0,0,0,0,0,False,0
2025-01-08 14:11:41,persegiBiru,301,588,111,103,198,13,196,8,2,5,True,0.13862004685361087
2025-01-08 14:11:41,Fail to pick,301,588,0,0,0,0,0,0,0,0,False,0
2025-01-08 14:11:42,persegiBiru,303,587,112,102,159,32,159,34,0,2,True,0.49140307692203267
2025-01-08 14:11:42,Fail to pick,303,587,0,0,0,0,0,0,0,0,False,0
2025-01-08 14:11:42,persegiBiru,303,585,116,105,133,22,129,24,4,2,True,0.1696083931766565
2025-01-08 14:11:42,Fail to pick,303,585,0,0,0,0,0,0,0,0,False,0
2025-01-08 14:11:42,persegiKuning,263,563,106,111,68,12,64,13,4,1,False,0.4376395510049236
2025-01-08 14:11:42,persegiKuning,257,566,109,115,188,13,183,12,5,1,False,0.27129209815329247
2025-01-08 14:11:42,Fail to pick,257,566,0,0,0,0,0,0,0,0,False,0
2025-01-08 14:11:43,persegiBiru,297,588,114,106,88,40,90,44,2,4,True,0.40821302537776416
2025-01-08 14:11:43,persegiKuning,261,563,108,112,53,97,48,99,5,2,True,0.37527328837858975
2025-01-08 14:11:43,persegiKuning,264,561,105,112,136,27,131,25,5,2,True,0.21392793725938467
2025-01-08 14:11:43,Fail to pick,264,561,0,0,0,0,0,0,0,0,False,0
2025-01-08 14:11:44,persegiBiru,301,586,113,104,14,33,16,34,2,1,True,0.2729530892857975
2025-01-08 14:11:44,persegiBiru,297,585,111,105,138,90,134,94,4,4,True,0.4191447761060658
2025-01-08 14:11:44,Fail to pick,297,585,0,0,0,0,0,0,0,0,False,0
2025-01-08 14:11:44,persegiBiru,307,584,116,105,148,24,149,26,1,2,True,0.21884358238688018
2025-01-08 14:11:44,persegiBiru,300,585,116,106,87,26,86,30,1,4,True,0.4805135175851656
2025-01-08 14:11:44,Fail to pick,300,585,0,0,0,0,0,0,0,0,False,0
2025-01-08 14:11:45,persegiBiru,300,589,113,105,175,77,170,73,5,4,True,0.3939551815382816
2025-01-08 14:11:45,Fail to pick,300,589,0,0,0,0,0,0,0,0,False,0
2025-01-08 14:11:45,persegiBiru,300,588,112,104,53,91,52,89,1,2,True,0.31246896483762276
2025-01-08 14:11:45,Fail to pick,300,588,0,0,0,0,0,0,0,0,False,0
2025-01-08 14:11:45,persegiKuning,258,565,109,109,184,80,185,84,1,4,True,0.3058540246788878
2025-01-08 14:11:45,persegiBiru,295,587,114,103,167,21,164,25,3,4,True,0.36751249340444114
2025-01-08 14:11:45,persegiBiru,299,586,112,103,146,56,147,54,1,2,True,0.3843322048753972
2025-01-08 14:11:45,Fail to pick,299,586,0,0,0,0,0,0,0,0,False,0
2025-01-08 14:11:45,persegiBiru,296,587,112,103,190,94,186,92,4,2,False,0.32420897193239673
2025-01-08 14:11:45,Fail to pick,296,587,0,0,0,0,0,0,0,0,False,0
2025-01-08 14:11:45,persegiBiru,303,586,116,106,1,47,-1,47,2,0,True,0.1934467989610834
2025-01-08 14:11:45,Fail to pick,303,586,0,0,0,0,0,0,0,0,False,0
2025-01-08 14:11:46,persegiBiru,298,585,112,103,152,57,156,55,4,2,True,0.19103671483070533
2025-01-08 14:11:46,Fail to pick,298,585,0,0,0,0,0,0,0,0,False,0
2025-01-08 14:11:46,persegiBiru,296,585,111,105,178,10,180,14,2,4,True,0.22423872070778278
2025-01-08 14:11:46,Fail to pick,296,585,0,0,0,0,0,0,0,0,False,0
2025-01-08 14:11:46,persegiBiru,299,586,111,106,142,49,139,45,3,4,True,0.33939319532917045
2025-01-08 14:11:46,Fail to pick,299,586,0,0,0,0,0,0,0,0,False,0
2025-01-08 14:11:46,persegiBiru,296,587,112,104,22,37,21,34,1,3,True,0.24080549975309526
2025-01-08 14:11:46,Fail to pick,296,587,0,0,0,0,0,0,0,0,False,0
2025-01-08 14:11:46,persegiKuning,258,564,108,113,161,69,160,71,1,2,True,0.41283266753264214
2025-01-08 14:11:46,persegiKuning,289,596,109,105,66,23,63,24,3,1,True,0.26883998618679494
2025-01-08 14:11:46,persegiKuning,257,566,107,114,181,83,177,83,4,0,True,0.2799060319199338
2025-01-08 14:11:47,persegiBiru,320,574,117,101,97,75,96,76,1,1,True,0.14999611116606545
2025-01-08 14:11:47,persegiBiru,322,575,115,102,184,5,186,1,2,4,True,0.25972600134544993
2025-01-08 14:11:47,Fail to pick,322,575,0,0,0,0,0,0,0,0,False,0
2025-01-08 14:11:47,persegiBiru,326,571,120,106,169,84,169,84,0,0,True,0.1426484127757156
2025-01-08 14:11:47,Fail to pick,326,571,0,0,0,0,0,0,0,0,False,0
2025-01-08 14:11:47,persegiBiru,326,571,121,106,40,82,39,78,1,4,True,0.23586120245765324
2025-01-08 14:11:47,Fail to pick,326,571,0,0,0,0,0,0,0,0,False,0
2025-01-08 14:47:52,persegiMerah,237,276,133,126,35,13,32,12,3,1,True,0.16358997760526753
2025-01-08 14:47:52,Merah,237,276,tensor(133.8723),tensor(126.8231),123,21,126,21,3,0,True,0.0005004405975341797
2025-01-08 14:47:52,persegiMerah,221,269,134,129,34,90,32,86,2,4,True,0.33481521520773383
2025-01-08 14:47:52,persegiMerah,218,259,136,130,58,67,58,71,0,4,True,0.11745572848637105
2025-01-08 14:47:52,persegiMerah,221,257,137,126,166,49,165,47,1,2,True,0.22916657962733727
2025-01-08 14:47:52,Fail to pick,221,257,0,0,0,0,0,0,0,0,False,0
2025-01-08 14:47:52,persegiMerah,222,262,138,127,119,69,123,72,4,3,True,0.12392267311433486
2025-01-08 14:47:52,Fail to pick,222,262,0,0,0,0,0,0,0,0,False,0
2025-01-08 14:47:53,persegiMerah,222,258,137,123,50,55,46,50,4,5,True,0.4546176904132083
2025-01-08 14:47:53,Fail to pick,222,258,0,0,0,0,0,0,0,0,False,0
2025-01-08 14:47:53,persegiMerah,218,261,136,127,183,76,187,72,4,4,True,0.25741635780284855
2025-01-08 14:47:53,Fail to pick,218,261,0,0,0,0,0,0,0,0,False,0
2025-01-08 14:47:53,persegiMerah,218,254,128,119,28,78,23,75,5,3,False,0.3080177484615465
2025-01-08 14:47:53,Fail to pick,218,254,0,0,0,0,0,0,0,0,False,0
2025-01-08 14:47:53,persegiMerah,218,255,133,117,23,90,26,88,3,2,False,0.21836003838493592
2025-01-08 14:47:53,Fail to pick,218,255,0,0,0,0,0,0,0,0,False,0
2025-01-08 14:47:53,persegiMerah,218,266,131,122,105,72,103,67,2,5,False,0.3975830722425082
2025-01-08 14:47:53,persegiMerah,217,253,129,117,158,6,155,3,3,3,False,0.2682913385583249
2025-01-08 14:47:53,persegiMerah,218,261,129,122,143,90,140,85,3,5,True,0.2439837193680214
2025-01-08 14:47:53,Fail to pick,218,261,0,0,0,0,0,0,0,0,False,0
2025-01-08 14:47:54,persegiMerah,213,254,126,115,26,82,24,83,2,1,True,0.3962711847849427
2025-01-08 14:47:54,Fail to pick,213,254,0,0,0,0,0,0,0,0,False,0
2025-01-08 14:47:54,persegiMerah,212,254,128,118,43,31,47,28,4,3,True,0.33039288652830645
2025-01-08 14:47:54,Fail to pick,212,254,0,0,0,0,0,0,0,0,False,0
2025-01-08 14:47:54,persegiMerah,212,250,123,117,18,73,14,74,4,1,True,0.48059824935413065
2025-01-08 14:47:54,Fail to pick,212,250,0,0,0,0,0,0,0,0,False,0
2025-01-08 14:47:54,persegiMerah,207,255,125,116,3,18,3,19,0,1,True,0.24011702253743705
2025-01-08 14:47:54,Fail to pick,207,255,0,0,0,0,0,0,0,0,False,0
2025-01-08 14:47:54,persegiMerah,210,251,124,116,71,8,73,10,2,2,True,0.4275204637639718
2025-01-08 14:47:54,Fail to pick,210,251,0,0,0,0,0,0,0,0,False,0
2025-01-08 14:47:54,persegiMerah,214,254,124,116,89,94,87,89,2,5,True,0.3083528162014105
2025-01-08 14:47:54,Fail to pick,214,254,0,0,0,0,0,0,0,0,False,0
2025-01-08 14:47:54,persegiMerah,210,248,122,115,114,70,109,74,5,4,False,0.395194145527322
2025-01-08 14:47:54,Fail to pick,210,248,0,0,0,0,0,0,0,0,False,0
2025-01-08 14:48:09,persegiMerah,204,249,128,117,113,29,113,32,0,3,True,0.44347631661459286
2025-01-08 14:48:09,Fail to pick,204,249,0,0,0,0,0,0,0,0,False,0
2025-01-08 14:48:09,persegiMerah,201,250,120,114,165,3,168,5,3,2,True,0.4573016534015123
2025-01-08 14:48:10,Fail to pick,201,250,0,0,0,0,0,0,0,0,False,0
2025-01-08 14:48:10,persegiMerah,199,246,120,111,98,67,99,63,1,4,True,0.25349116293488605
2025-01-08 14:48:10,Fail to pick,199,246,0,0,0,0,0,0,0,0,False,0
2025-01-08 14:48:10,persegiMerah,197,255,124,114,110,10,106,9,4,1,True,0.2946064956477312
2025-01-08 14:48:10,Fail to pick,197,255,0,0,0,0,0,0,0,0,False,0
2025-01-08 14:48:10,persegiMerah,236,271,131,115,138,77,133,80,5,3,True,0.19748881193678605
2025-01-08 14:48:10,persegiMerah,199,252,126,112,15,50,14,53,1,3,False,0.4218633212799404
2025-01-08 14:49:26,persegiMerah,223,246,128,126,189,60,191,61,2,1,True,0.305967247241661
2025-01-08 14:49:26,Merah,223,246,tensor(128.1142),tensor(126.2565),131,20,129,19,2,1,True,0.0005004405975341797
2025-01-08 14:49:27,persegiMerah,221,244,126,122,95,82,94,77,1,5,True,0.4873913672367982
2025-01-08 14:49:27,Fail to pick,221,244,0,0,0,0,0,0,0,0,False,0
2025-01-08 14:49:27,persegiMerah,194,265,121,128,94,6,93,9,1,3,False,0.4956937778736107
2025-01-08 14:49:27,persegiMerah,215,248,125,121,160,58,155,61,5,3,True,0.2604369605655219
2025-01-08 14:49:27,persegiMerah,175,266,125,128,163,54,162,58,1,4,True,0.3762207781565413
2025-01-08 14:49:27,persegiMerah,222,243,126,125,88,98,91,94,3,4,True,0.20514751951552535
2025-01-08 14:49:27,persegiMerah,224,241,127,123,97,44,95,44,2,0,True,0.21128807666354726
2025-01-08 14:49:27,Fail to pick,224,241,0,0,0,0,0,0,0,0,False,0
2025-01-08 14:49:27,persegiMerah,219,244,128,123,198,62,202,58,4,4,True,0.31416875900412944
2025-01-08 14:49:27,Fail to pick,219,244,0,0,0,0,0,0,0,0,False,0
2025-01-08 14:49:27,persegiMerah,224,242,128,122,36,13,40,8,4,5,True,0.1234097679067041
2025-01-08 14:49:27,Fail to pick,224,242,0,0,0,0,0,0,0,0,False,0
2025-01-08 14:49:28,persegiMerah,219,244,128,122,90,95,92,97,2,2,True,0.23495411482111797
2025-01-08 14:49:28,Fail to pick,219,244,0,0,0,0,0,0,0,0,False,0
2025-01-08 14:49:28,persegiMerah,221,246,131,123,97,98,93,97,4,1,True,0.4949242632319294
2025-01-08 14:49:28,Fail to pick,221,246,0,0,0,0,0,0,0,0,False,0
2025-01-08 14:49:28,persegiMerah,216,244,125,125,27,73,24,68,3,5,True,0.33297181229908485
2025-01-08 14:49:28,Fail to pick,216,244,0,0,0,0,0,0,0,0,False,0
2025-01-08 14:49:28,persegiMerah,228,253,128,125,107,31,104,29,3,2,True,0.4280676564372029
2025-01-08 14:49:28,persegiMerah,216,248,124,120,103,74,102,72,1,2,True,0.24131289585406998
2025-01-08 14:49:28,persegiMerah,214,240,119,123,122,62,124,58,2,4,True,0.32713378448674746
2025-01-08 14:49:28,Fail to pick,214,240,0,0,0,0,0,0,0,0,False,0
2025-01-08 14:49:28,persegiMerah,221,243,124,120,98,12,101,16,3,4,True,0.10155302931501997
2025-01-08 14:49:28,Fail to pick,221,243,0,0,0,0,0,0,0,0,False,0
2025-01-08 14:49:28,persegiMerah,214,241,120,124,63,46,67,42,4,4,False,0.41524490916182566
2025-01-08 14:49:28,Fail to pick,214,241,0,0,0,0,0,0,0,0,False,0
2025-01-08 14:49:28,persegiMerah,243,248,128,131,164,4,160,0,4,4,True,0.49157228765006333
2025-01-08 14:49:29,persegiMerah,222,243,125,123,9,11,5,14,4,3,True,0.3026447765611746
2025-01-08 14:49:29,persegiMerah,223,246,128,122,149,40,148,44,1,4,True,0.4320875289198093
2025-01-08 14:49:29,Fail to pick,223,246,0,0,0,0,0,0,0,0,False,0
2025-01-08 14:49:29,persegiMerah,225,245,125,122,194,22,193,26,1,4,True,0.13180388207808214
2025-01-08 14:49:29,Fail to pick,225,245,0,0,0,0,0,0,0,0,False,0
2025-01-08 14:49:29,persegiMerah,221,245,127,122,168,47,169,43,1,4,True,0.301489859058258
2025-01-08 14:49:29,Fail to pick,221,245,0,0,0,0,0,0,0,0,False,0
2025-01-08 14:49:29,persegiMerah,219,245,129,123,116,84,118,86,2,2,True,0.25389623211244683
2025-01-08 14:49:29,Fail to pick,219,245,0,0,0,0,0,0,0,0,False,0
2025-01-08 14:49:35,persegiMerah,220,249,136,115,52,55,49,59,3,4,True,0.3637751381038782
2025-01-08 14:49:35,Fail to pick,220,249,0,0,0,0,0,0,0,0,False,0
2025-01-08 14:49:35,persegiMerah,199,236,131,111,54,10,50,8,4,2,True,0.28708074754888047
2025-01-08 14:49:35,persegiMerah,229,259,135,114,35,71,34,74,1,3,True,0.23147227707065277
2025-01-08 14:49:36,persegiMerah,241,255,143,117,19,88,23,91,4,3,True,0.392063248483586
2025-01-08 14:49:36,persegiMerah,202,245,127,128,77,72,72,68,5,4,True,0.28119700855515894
2025-01-08 14:49:49,persegiMerah,204,226,131,125,47,2,44,1,3,1,True,0.47363613687424466
2025-01-08 14:49:49,persegiMerah,231,245,138,123,123,3,120,1,3,2,True,0.18666483600734884
2025-01-08 14:49:49,persegiMerah,225,244,140,125,48,11,46,6,2,5,True,0.45203479436807925
2025-01-08 14:49:49,Fail to pick,225,244,0,0,0,0,0,0,0,0,False,0
2025-01-08 14:49:49,persegiMerah,239,244,144,122,58,28,55,23,3,5,True,0.22957610108578008
2025-01-08 14:49:50,persegiMerah,248,254,144,120,99,46,102,46,3,0,True,0.39834944238791037
2025-01-08 14:53:58,persegiMerah,191,221,138,110,189,2,192,-2,3,4,True,0.3045711681307155
2025-01-08 14:53:58,Merah,191,221,tensor(138.4166),tensor(110.8222),138,17,133,20,5,3,True,0.0004992485046386719
2025-01-08 14:53:59,persegiMerah,229,248,140,116,4,91,0,92,4,1,True,0.18305815328782626
2025-01-08 14:53:59,persegiMerah,222,240,134,114,176,86,179,83,3,3,False,0.1920062211517214
2025-01-08 14:53:59,Fail to pick,222,240,0,0,0,0,0,0,0,0,False,0
2025-01-08 14:53:59,persegiMerah,243,258,145,114,192,17,187,18,5,1,True,0.3700466608848485
2025-01-08 14:53:59,persegiMerah,225,248,136,114,23,56,22,51,1,5,True,0.370301079129006
2025-01-08 14:53:59,persegiMerah,222,241,137,118,140,13,137,11,3,2,False,0.14230897651544902
2025-01-08 14:53:59,Fail to pick,222,241,0,0,0,0,0,0,0,0,False,0
2025-01-08 14:53:59,persegiMerah,216,242,136,118,77,21,75,20,2,1,True,0.4491139982112363
2025-01-08 14:53:59,Fail to pick,216,242,0,0,0,0,0,0,0,0,False,0
2025-01-08 14:53:59,persegiMerah,225,251,137,112,91,0,91,4,0,4,True,0.26840836223523523
2025-01-08 14:53:59,Fail to pick,225,251,0,0,0,0,0,0,0,0,False,0
2025-01-08 14:54:00,persegiMerah,221,236,136,111,139,50,140,50,1,0,True,0.2666745814544256
2025-01-08 14:54:00,persegiMerah,218,242,134,117,56,42,57,46,1,4,True,0.4792725513560213
2025-01-08 14:54:00,Fail to pick,218,242,0,0,0,0,0,0,0,0,False,0
2025-01-08 14:54:00,persegiMerah,227,251,136,115,154,40,150,41,4,1,True,0.15590283753152492
2025-01-08 14:54:00,Fail to pick,227,251,0,0,0,0,0,0,0,0,False,0
2025-01-08 14:54:00,persegiMerah,207,229,134,112,67,86,69,83,2,3,True,0.38080781587514145
2025-01-08 14:54:00,persegiMerah,216,241,133,113,55,58,55,62,0,4,True,0.1919606252301049
2025-01-08 14:54:00,persegiMerah,220,241,136,114,92,91,90,90,2,1,False,0.47768385357133125
2025-01-08 14:54:00,Fail to pick,220,241,0,0,0,0,0,0,0,0,False,0
2025-01-08 14:54:00,persegiMerah,226,249,136,112,1,51,3,54,2,3,True,0.12328764905911327
2025-01-08 14:54:00,Fail to pick,226,249,0,0,0,0,0,0,0,0,False,0
2025-01-08 14:54:00,persegiMerah,224,250,135,111,126,42,125,43,1,1,True,0.23131020685516251
2025-01-08 14:54:00,Fail to pick,224,250,0,0,0,0,0,0,0,0,False,0
2025-01-08 14:54:00,persegiMerah,206,247,132,112,97,3,92,6,5,3,True,0.23989958156711078
2025-01-08 14:54:01,persegiMerah,212,242,130,113,182,99,186,96,4,3,True,0.3496042076935718
2025-01-08 14:54:01,Fail to pick,212,242,0,0,0,0,0,0,0,0,False,0
2025-01-08 14:54:01,persegiMerah,206,245,132,112,176,10,174,10,2,0,True,0.2776034864224822
2025-01-08 14:54:01,Fail to pick,206,245,0,0,0,0,0,0,0,0,False,0
2025-01-08 14:54:01,persegiMerah,201,247,127,112,144,30,148,34,4,4,False,0.4366473645806971
2025-01-08 14:54:01,Fail to pick,201,247,0,0,0,0,0,0,0,0,False,0
2025-01-08 14:54:05,persegiMerah,252,269,144,130,136,68,135,68,1,0,True,0.34677523262297605
2025-01-08 14:54:05,Merah,252,269,tensor(144.1277),tensor(130.8578),125,23,125,20,0,3,True,0.0
2025-01-08 14:54:09,persegiMerah,247,221,139,119,160,10,156,12,4,2,True,0.3443473682605219
2025-01-08 14:54:09,Merah,247,221,tensor(139.7367),tensor(119.9301),138,22,142,17,4,5,True,0.0004990100860595703
2025-01-08 14:54:09,persegiMerah,243,215,141,122,174,51,174,55,0,4,True,0.25117020693081216
2025-01-08 14:54:09,Fail to pick,243,215,0,0,0,0,0,0,0,0,False,0
2025-01-08 14:54:09,persegiMerah,261,231,142,120,144,76,145,72,1,4,True,0.28800759105115414
2025-01-08 14:54:09,persegiMerah,264,231,144,125,118,84,118,85,0,1,True,0.4032932342392479
2025-01-08 14:54:09,Fail to pick,264,231,0,0,0,0,0,0,0,0,False,0
2025-01-08 14:54:10,persegiMerah,252,225,141,118,80,92,75,93,5,1,True,0.20918696215370847
2025-01-08 14:54:10,persegiMerah,253,227,142,124,87,40,85,41,2,1,True,0.20503462261006306
2025-01-08 14:54:10,Fail to pick,253,227,0,0,0,0,0,0,0,0,False,0
2025-01-08 14:54:10,persegiMerah,243,221,138,120,33,90,30,86,3,4,True,0.4701684805328761
2025-01-08 14:54:10,persegiMerah,237,222,138,122,25,52,22,52,3,0,True,0.2567913771893975
2025-01-08 14:54:10,Fail to pick,237,222,0,0,0,0,0,0,0,0,False,0
2025-01-08 14:54:10,persegiMerah,245,226,145,122,18,32,21,29,3,3,True,0.17465581216833065
2025-01-08 14:54:10,Fail to pick,245,226,0,0,0,0,0,0,0,0,False,0
2025-01-08 14:54:10,persegiMerah,249,230,145,123,171,93,166,97,5,4,True,0.20144646097956267
2025-01-08 14:54:10,Fail to pick,249,230,0,0,0,0,0,0,0,0,False,0
2025-01-08 14:54:10,persegiMerah,243,227,142,123,76,82,71,79,5,3,True,0.4526556430459949
2025-01-08 14:54:10,Fail to pick,243,227,0,0,0,0,0,0,0,0,False,0
2025-01-08 14:54:10,persegiMerah,250,235,148,127,30,94,27,92,3,2,True,0.36361788808533635
2025-01-08 14:54:10,Fail to pick,250,235,0,0,0,0,0,0,0,0,False,0
2025-01-08 14:54:10,persegiMerah,246,237,143,126,17,12,12,14,5,2,True,0.3254751311955849
2025-01-08 14:54:10,Fail to pick,246,237,0,0,0,0,0,0,0,0,False,0
2025-01-08 14:54:11,persegiMerah,254,243,146,128,173,75,172,75,1,0,True,0.49765789212876343
2025-01-08 14:54:11,Fail to pick,254,243,0,0,0,0,0,0,0,0,False,0
2025-01-08 14:54:11,persegiMerah,206,214,137,118,36,30,39,26,3,4,True,0.486967992184534
2025-01-08 14:54:11,persegiMerah,201,212,138,124,96,90,99,94,3,4,False,0.12847358992984265
2025-01-08 14:54:11,Fail to pick,201,212,0,0,0,0,0,0,0,0,False,0
2025-01-08 14:54:11,persegiMerah,201,212,140,124,139,85,135,80,4,5,True,0.2594783937576731
2025-01-08 14:54:11,Fail to pick,201,212,0,0,0,0,0,0,0,0,False,0
2025-01-08 14:57:35,persegiMerah,809,491,141,145,192,56,190,59,2,3,True,0.27548761321234994
2025-01-08 14:57:35,Merah,809,491,tensor(141.5497),tensor(145.0142),63,74,63,75,0,1,True,0.0005061626434326172
2025-01-08 14:57:37,persegiMerah,775,458,128,129,179,39,179,39,0,0,True,0.3234900963361719
2025-01-08 14:57:37,Merah,775,458,tensor(128.0239),tensor(129.8205),72,71,68,74,4,3,True,0.00031113624572753906
2025-01-08 15:16:21,persegiBiru,790,465,123,105,194,40,195,40,1,0,True,0.30853021769292366
2025-01-08 15:16:21,Biru,790,465,tensor(123.1836),tensor(105.9671),70,73,67,77,3,4,True,0.0005218982696533203
2025-01-08 15:16:33,persegiMerah,220,297,131,115,134,40,129,35,5,5,True,0.2804421450309984
2025-01-08 15:16:33,Merah,220,297,tensor(131.7377),tensor(115.6591),117,20,117,18,0,2,True,0.0004980564117431641
2025-01-08 15:16:33,persegiMerah,254,326,133,113,49,97,51,101,2,4,False,0.4346195669811689
2025-01-08 15:16:33,persegiMerah,220,307,128,116,9,16,9,16,0,0,True,0.16674195870991848
2025-01-08 15:16:33,persegiMerah,253,326,133,118,129,5,131,7,2,2,True,0.47287559544812574
2025-01-08 15:16:33,persegiMerah,231,302,132,119,11,63,6,58,5,5,True,0.1854090640369698
2025-01-08 15:16:33,persegiMerah,259,325,133,118,33,33,29,32,4,1,True,0.44991066094885046
2025-01-08 15:16:33,persegiMerah,229,307,131,127,177,2,177,5,0,3,True,0.16583513526955146
2025-01-08 15:16:34,persegiMerah,234,301,131,132,168,37,164,37,4,0,True,0.3448322432799643
2025-01-08 15:16:34,Fail to pick,234,301,0,0,0,0,0,0,0,0,False,0
2025-01-08 15:16:34,persegiMerah,256,323,129,121,26,87,25,86,1,1,True,0.44359454388870045
2025-01-08 15:16:34,persegiMerah,232,303,129,120,159,45,159,44,0,1,True,0.17707854390403704
2025-01-08 15:16:34,persegiMerah,251,326,135,118,113,78,108,77,5,1,True,0.21399810801821217
2025-01-08 15:16:34,persegiMerah,230,307,128,120,32,20,34,16,2,4,True,0.43411756916574074
2025-01-08 15:16:34,persegiMerah,229,309,130,118,127,11,127,11,0,0,True,0.23020904454058636
2025-01-08 15:16:34,Fail to pick,229,309,0,0,0,0,0,0,0,0,False,0
2025-01-08 15:16:34,persegiMerah,262,325,139,116,21,44,16,41,5,3,True,0.270759863305373
2025-01-08 15:16:34,persegiMerah,260,325,140,120,51,40,51,36,0,4,True,0.45030052485024596
2025-01-08 15:16:34,Fail to pick,260,325,0,0,0,0,0,0,0,0,False,0
2025-01-08 15:16:34,persegiMerah,261,327,134,117,112,76,110,79,2,3,True,0.23794741920579737
2025-01-08 15:16:34,Fail to pick,261,327,0,0,0,0,0,0,0,0,False,0
2025-01-08 15:16:35,persegiMerah,253,326,135,119,33,23,31,22,2,1,True,0.15723117491188537
2025-01-08 15:16:35,Fail to pick,253,326,0,0,0,0,0,0,0,0,False,0
2025-01-08 15:16:35,persegiMerah,250,325,135,120,189,51,185,53,4,2,False,0.3203162037380495
2025-01-08 15:16:35,Fail to pick,250,325,0,0,0,0,0,0,0,0,False,0
2025-01-08 15:16:35,persegiMerah,254,323,139,120,141,64,140,60,1,4,True,0.2244900549981661
2025-01-08 15:16:35,Fail to pick,254,323,0,0,0,0,0,0,0,0,False,0
2025-01-08 15:16:35,persegiMerah,259,323,132,118,21,59,24,54,3,5,True,0.17926421099551704
2025-01-08 15:16:35,Fail to pick,259,323,0,0,0,0,0,0,0,0,False,0
2025-01-08 15:16:35,persegiMerah,249,326,135,117,86,40,90,40,4,0,True,0.33991315498546415
2025-01-08 15:16:35,lingkaranBiru,1054,36,50,72,36,99,35,101,1,2,True,0.2851888169022976
2025-01-08 15:16:35,persegiMerah,258,329,140,116,189,82,191,83,2,1,True,0.11223831323579475
2025-01-08 15:16:35,persegiMerah,255,323,139,118,130,84,128,79,2,5,True,0.4170489068336526
2025-01-08 15:16:35,Fail to pick,255,323,0,0,0,0,0,0,0,0,False,0
2025-01-08 15:16:35,persegiMerah,253,323,140,120,178,82,177,82,1,0,True,0.11723706562893024
2025-01-08 15:16:35,Fail to pick,253,323,0,0,0,0,0,0,0,0,False,0
2025-01-08 15:16:35,persegiMerah,230,306,132,121,153,80,156,80,3,0,False,0.4138077088635106
2025-01-08 15:16:35,persegiMerah,254,324,134,117,48,8,51,10,3,2,True,0.1363756579147537
2025-01-08 15:16:36,persegiMerah,252,324,138,117,127,41,131,36,4,5,True,0.46614534935468466
2025-01-08 15:16:36,Fail to pick,252,324,0,0,0,0,0,0,0,0,False,0
2025-01-08 15:16:36,persegiMerah,260,327,138,118,154,81,151,83,3,2,True,0.21616186120209369
2025-01-08 15:16:36,Fail to pick,260,327,0,0,0,0,0,0,0,0,False,0
2025-01-08 15:16:36,persegiMerah,230,307,129,118,66,33,67,29,1,4,False,0.10276435516109506
2025-01-08 15:16:36,persegiMerah,252,325,138,120,97,43,101,42,4,1,True,0.3297521365569852
2025-01-08 15:16:36,persegiMerah,253,323,135,118,144,0,144,2,0,2,True,0.3917204128540416
2025-01-08 15:16:36,Fail to pick,253,323,0,0,0,0,0,0,0,0,False,0
2025-01-08 15:16:36,persegiMerah,252,322,140,118,161,94,159,92,2,2,True,0.4058881244546788
2025-01-08 15:16:36,Fail to pick,252,322,0,0,0,0,0,0,0,0,False,0
2025-01-08 15:16:36,persegiMerah,256,322,139,116,56,85,54,83,2,2,True,0.34744092555891215
2025-01-08 15:16:36,Fail to pick,256,322,0,0,0,0,0,0,0,0,False,0
2025-01-08 15:16:36,persegiMerah,254,321,134,118,177,89,180,91,3,2,True,0.21733994431101256
2025-01-08 15:16:36,Fail to pick,254,321,0,0,0,0,0,0,0,0,False,0
2025-01-08 15:16:36,persegiMerah,257,324,136,120,131,44,132,47,1,3,False,0.29851017719312634
2025-01-08 15:16:36,Fail to pick,257,324,0,0,0,0,0,0,0,0,False,0
2025-01-08 15:16:36,persegiMerah,249,327,138,119,163,9,167,6,4,3,True,0.178756779508056
2025-01-08 15:16:36,Fail to pick,249,327,0,0,0,0,0,0,0,0,False,0
2025-01-08 15:16:37,persegiMerah,256,321,140,119,142,9,142,7,0,2,True,0.21564306593601038
2025-01-08 15:16:37,Fail to pick,256,321,0,0,0,0,0,0,0,0,False,0
2025-01-08 15:16:37,persegiMerah,255,320,133,118,85,16,88,14,3,2,True,0.154574120885412
2025-01-08 15:16:37,Fail to pick,255,320,0,0,0,0,0,0,0,0,False,0
2025-01-08 15:16:37,persegiMerah,230,306,128,118,173,31,177,30,4,1,True,0.20772019427656896
2025-01-08 15:16:37,persegiMerah,255,320,134,116,81,43,81,47,0,4,True,0.3817759486186135
2025-01-08 15:16:37,persegiMerah,256,324,132,116,112,3,113,1,1,2,True,0.15418650874184917
2025-01-08 15:16:37,Fail to pick,256,324,0,0,0,0,0,0,0,0,False,0
2025-01-08 15:16:37,persegiMerah,248,325,137,117,97,47,101,50,4,3,True,0.1693779375538107
2025-01-08 15:16:37,Fail to pick,248,325,0,0,0,0,0,0,0,0,False,0
2025-01-08 15:16:42,persegiMerah,254,325,136,113,171,70,172,67,1,3,True,0.3099056578481002
2025-01-08 15:16:42,Fail to pick,254,325,0,0,0,0,0,0,0,0,False,0
2025-01-08 15:16:42,persegiMerah,252,323,131,113,130,68,134,68,4,0,True,0.2915708988922052
2025-01-08 15:16:42,Fail to pick,252,323,0,0,0,0,0,0,0,0,False,0
2025-01-08 15:16:42,persegiMerah,255,325,133,110,138,91,135,89,3,2,True,0.4760833374474601
2025-01-08 15:16:42,Fail to pick,255,325,0,0,0,0,0,0,0,0,False,0
2025-01-08 15:16:42,persegiMerah,260,328,140,112,96,54,92,49,4,5,True,0.23487808066929802
2025-01-08 15:16:42,Fail to pick,260,328,0,0,0,0,0,0,0,0,False,0
2025-01-08 15:16:42,persegiMerah,253,326,134,111,90,26,91,21,1,5,True,0.23733181213361784
2025-01-08 15:16:42,Fail to pick,253,326,0,0,0,0,0,0,0,0,False,0
2025-01-08 15:16:42,persegiMerah,257,324,136,115,18,25,14,27,4,2,True,0.1510795307482714
2025-01-08 15:16:42,Fail to pick,257,324,0,0,0,0,0,0,0,0,False,0
2025-01-08 15:16:42,persegiMerah,251,328,136,115,46,51,41,54,5,3,True,0.213418625932899
2025-01-08 15:16:42,Fail to pick,251,328,0,0,0,0,0,0,0,0,False,0
2025-01-08 15:16:42,persegiMerah,260,326,133,115,98,21,99,23,1,2,True,0.1876738207301971
2025-01-08 15:16:42,Fail to pick,260,326,0,0,0,0,0,0,0,0,False,0
2025-01-08 15:16:44,persegiMerah,216,193,120,107,65,73,61,70,4,3,True,0.21717876926014537
2025-01-08 15:16:44,Merah,216,193,tensor(120.3340),tensor(107.5613),146,20,144,18,2,2,True,0.0
2025-01-08 15:16:44,persegiMerah,199,193,102,103,143,1,138,-1,5,2,True,0.4425434573614544
2025-01-08 15:16:44,persegiMerah,211,160,136,117,152,57,152,52,0,5,False,0.10222031456337005
2025-01-08 15:16:44,persegiMerah,211,158,134,119,163,17,163,21,0,4,True,0.11215364287376778
2025-01-08 15:16:44,Fail to pick,211,158,0,0,0,0,0,0,0,0,False,0
2025-01-08 15:16:44,persegiMerah,207,160,133,118,79,91,80,95,1,4,True,0.273021043881446
2025-01-08 15:16:44,Fail to pick,207,160,0,0,0,0,0,0,0,0,False,0
2025-01-08 15:16:44,persegiMerah,208,161,136,117,108,83,106,82,2,1,True,0.29135893050501427
2025-01-08 15:16:44,Fail to pick,208,161,0,0,0,0,0,0,0,0,False,0
2025-01-08 15:16:44,persegiMerah,210,160,134,119,138,31,136,26,2,5,True,0.32940742877778867
2025-01-08 15:16:44,Fail to pick,210,160,0,0,0,0,0,0,0,0,False,0
2025-01-08 15:16:44,persegiMerah,206,162,132,118,68,22,63,17,5,5,True,0.15123551902433055
2025-01-08 15:16:44,Fail to pick,206,162,0,0,0,0,0,0,0,0,False,0
2025-01-08 15:16:44,persegiMerah,174,136,123,120,102,11,102,9,0,2,True,0.13083033850892642
2025-01-08 15:16:45,persegiMerah,211,164,134,117,150,5,152,8,2,3,True,0.18978787033802047
2025-01-08 15:16:45,persegiMerah,172,129,118,111,177,3,181,-1,4,4,True,0.3721825409298072
2025-01-08 15:16:45,persegiMerah,207,163,134,118,110,68,107,70,3,2,True,0.27219458287691567
2025-01-08 15:16:45,persegiMerah,172,137,120,117,178,95,179,90,1,5,False,0.1312433293574387
2025-01-08 15:16:45,persegiMerah,208,161,135,119,124,0,125,2,1,2,True,0.2572370414566415
2025-01-08 15:16:45,persegiMerah,204,161,133,119,147,22,151,18,4,4,True,0.34555035869896966
2025-01-08 15:16:45,Fail to pick,204,161,0,0,0,0,0,0,0,0,False,0
2025-01-08 15:16:46,persegiMerah,174,136,128,119,72,3,75,-2,3,5,True,0.32630876080018767
2025-01-08 15:16:46,persegiMerah,206,157,130,119,59,70,56,73,3,3,False,0.38659027667903023
2025-01-08 15:16:46,persegiMerah,204,158,135,120,186,22,185,20,1,2,True,0.25622542705219287
2025-01-08 15:16:46,Fail to pick,204,158,0,0,0,0,0,0,0,0,False,0
2025-01-08 15:16:46,persegiMerah,168,137,124,116,85,94,85,98,0,4,True,0.3446871723319168
2025-01-08 15:16:46,persegiMerah,204,161,132,118,3,18,7,17,4,1,True,0.15435594728008978
2025-01-08 15:16:46,persegiMerah,207,162,133,116,126,47,125,51,1,4,True,0.16324616850966062
2025-01-08 15:16:46,Fail to pick,207,162,0,0,0,0,0,0,0,0,False,0
2025-01-08 15:16:46,persegiMerah,203,159,135,119,179,73,175,71,4,2,True,0.23514189964870083
2025-01-08 15:16:46,Fail to pick,203,159,0,0,0,0,0,0,0,0,False,0
2025-01-08 15:16:47,persegiMerah,208,159,134,116,33,14,30,11,3,3,True,0.21665753452039216
2025-01-08 15:16:47,Fail to pick,208,159,0,0,0,0,0,0,0,0,False,0
2025-01-08 15:16:47,persegiMerah,205,160,132,116,90,93,90,97,0,4,True,0.4502344828242304
2025-01-08 15:16:47,Fail to pick,205,160,0,0,0,0,0,0,0,0,False,0
2025-01-08 15:16:47,persegiMerah,205,160,132,118,125,26,122,30,3,4,True,0.13623402213060107
2025-01-08 15:16:47,Fail to pick,205,160,0,0,0,0,0,0,0,0,False,0
2025-01-08 15:16:47,persegiMerah,172,139,122,115,79,89,79,88,0,1,True,0.447130161232416
2025-01-08 15:16:47,persegiMerah,209,162,137,117,121,0,122,1,1,1,True,0.3471092915017447
2025-01-08 15:16:47,persegiMerah,212,162,136,118,114,90,113,89,1,1,True,0.1070062497647887
2025-01-08 15:16:47,Fail to pick,212,162,0,0,0,0,0,0,0,0,False,0
2025-01-08 15:16:47,persegiMerah,207,161,133,116,15,34,17,31,2,3,True,0.32190837392877436
2025-01-08 15:16:47,Fail to pick,207,161,0,0,0,0,0,0,0,0,False,0
2025-01-08 15:16:48,persegiMerah,206,163,136,119,61,73,63,76,2,3,False,0.4624498748182959
2025-01-08 15:16:48,Fail to pick,206,163,0,0,0,0,0,0,0,0,False,0
2025-01-08 15:16:48,persegiMerah,169,138,121,114,140,41,143,39,3,2,True,0.3336419814135972
2025-01-08 15:16:48,persegiMerah,210,164,137,117,165,92,160,96,5,4,True,0.4333571547688041
2025-01-08 15:16:48,persegiMerah,175,135,125,119,171,34,173,32,2,2,True,0.10242703312086587
2025-01-08 15:16:48,persegiMerah,207,162,135,118,157,49,161,50,4,1,False,0.1384943053959456
2025-01-08 15:16:48,persegiMerah,211,162,134,117,59,71,54,74,5,3,False,0.19398837569410646
2025-01-08 15:16:48,Fail to pick,211,162,0,0,0,0,0,0,0,0,False,0
2025-01-08 15:16:48,persegiMerah,171,135,122,117,164,7,160,5,4,2,True,0.3451295603885567
2025-01-08 15:16:49,persegiMerah,174,134,123,117,101,43,99,38,2,5,True,0.31142106792362856
2025-01-08 15:16:49,Fail to pick,174,134,0,0,0,0,0,0,0,0,False,0
2025-01-08 15:16:49,persegiMerah,210,161,134,119,146,31,148,35,2,4,False,0.1496641430331319
2025-01-08 15:16:49,persegiMerah,217,159,138,118,50,95,48,96,2,1,True,0.12918623843286192
2025-01-08 15:16:49,Fail to pick,217,159,0,0,0,0,0,0,0,0,False,0
2025-01-08 15:16:49,persegiMerah,207,163,136,119,66,8,62,5,4,3,True,0.24122589183661455
2025-01-08 15:16:49,persegiMerah,174,138,124,117,81,36,78,35,3,1,False,0.49961957414582525
2025-01-08 15:16:49,persegiMerah,211,163,137,119,125,96,127,95,2,1,True,0.27216145656700685
2025-01-08 15:16:49,persegiMerah,172,140,123,118,29,1,29,4,0,3,True,0.14663564181864214
2025-01-08 15:16:50,persegiMerah,203,157,131,119,164,44,159,44,5,0,True,0.3723192573258006
2025-01-08 15:16:50,persegiMerah,203,157,131,119,138,56,135,58,3,2,True,0.21505670878458077
2025-01-08 15:16:50,Fail to pick,203,157,0,0,0,0,0,0,0,0,False,0
2025-01-08 15:16:50,persegiMerah,173,135,125,119,38,79,42,78,4,1,False,0.4627156546272986
2025-01-08 15:16:50,persegiMerah,205,158,134,120,172,98,168,95,4,3,True,0.489246842736071
2025-01-08 15:16:50,persegiMerah,171,131,123,114,30,87,33,89,3,2,True,0.16026510822391501
2025-01-08 15:16:50,persegiMerah,172,136,123,119,132,13,136,9,4,4,True,0.180097511942788
2025-01-08 15:16:50,Fail to pick,172,136,0,0,0,0,0,0,0,0,False,0
2025-01-08 15:16:50,persegiMerah,209,157,135,119,28,65,28,66,0,1,True,0.14259926320854222
2025-01-08 15:16:50,persegiMerah,201,154,133,116,110,34,114,32,4,2,True,0.38318173327716587
2025-01-08 15:16:50,Fail to pick,201,154,0,0,0,0,0,0,0,0,False,0
2025-01-08 15:16:50,persegiMerah,205,159,134,119,194,19,190,18,4,1,True,0.3888029978617358
2025-01-08 15:16:50,Fail to pick,205,159,0,0,0,0,0,0,0,0,False,0
2025-01-08 15:16:50,persegiMerah,168,134,121,115,117,10,119,10,2,0,True,0.16574658863678088
2025-01-08 15:16:51,persegiMerah,172,134,125,118,147,16,147,20,0,4,True,0.4580187259001558
2025-01-08 15:16:51,Fail to pick,172,134,0,0,0,0,0,0,0,0,False,0
2025-01-08 15:16:51,persegiMerah,172,134,125,118,47,72,45,76,2,4,True,0.13850784759783139
2025-01-08 15:16:51,Fail to pick,172,134,0,0,0,0,0,0,0,0,False,0
2025-01-08 15:19:02,persegiKuning,862,513,124,113,9,72,8,72,1,0,True,0.20176586028107404
2025-01-08 15:19:02,Kuning,862,513,tensor(124.8301),tensor(113.7560),57,79,54,83,3,4,True,0.0004980564117431641
2025-01-08 15:19:06,persegiBiru,880,478,121,104,31,18,32,20,1,2,True,0.4550191758566223
2025-01-08 15:19:06,Biru,880,478,tensor(121.3871),tensor(104.1402),67,81,67,78,0,3,True,0.0
2025-01-08 15:19:14,persegiMerah,224,294,119,118,46,22,47,20,1,2,True,0.27177699207103406
2025-01-08 15:19:14,Merah,224,294,tensor(119.5203),tensor(118.6635),118,20,115,22,3,2,True,0.0
2025-01-08 15:19:17,persegiMerah,251,310,128,109,37,41,40,38,3,3,True,0.2774159284699991
2025-01-08 15:19:17,Merah,251,310,tensor(128.3979),tensor(109.1543),113,23,113,19,0,4,True,0.0004992485046386719
2025-01-08 15:23:38,persegiBiru,897,517,124,99,132,96,128,99,4,3,False,0.17171124559095718
2025-01-08 15:23:38,Biru,897,517,tensor(124.4241),tensor(99.6840),56,83,59,78,3,5,True,0.0004992485046386719
2025-01-08 15:30:15,persegiKuning,878,458,132,136,161,3,160,7,1,4,True,0.1736310101922925
2025-01-08 15:30:15,Kuning,878,458,tensor(132.6677),tensor(136.7689),72,81,67,82,5,1,True,0.0004994869232177734
2025-01-08 15:30:19,segitigaMerah,878,441,118,106,1,35,-3,34,4,1,True,0.24656707121956112
2025-01-08 15:30:19,Merah,878,441,tensor(118.1109),tensor(106.6985),77,81,76,79,1,2,True,0.0004990100860595703
2025-01-08 15:30:27,persegiMerah,274,301,122,123,17,95,21,94,4,1,True,0.28681646083068624
2025-01-08 15:30:27,Merah,274,301,tensor(122.9101),tensor(123.8069),116,25,118,26,2,1,True,0.0005052089691162109
2025-01-08 15:30:29,persegiMerah,291,298,141,129,143,13,144,17,1,4,True,0.17087396446844477
2025-01-08 15:30:29,Merah,291,298,tensor(141.5985),tensor(129.5234),117,26,116,24,1,2,True,0.0004994869232177734
2025-01-08 15:30:31,persegiMerah,287,298,131,127,31,99,26,103,5,4,True,0.3325476877079273
2025-01-08 15:30:31,Merah,287,298,tensor(131.5982),tensor(127.0622),117,26,120,25,3,1,True,0.0004987716674804688
2025-01-08 15:30:31,Fail to pick,287,298,0,0,0,0,0,0,0,0,False,0
2025-01-08 15:30:34,persegiMerah,285,296,132,127,179,97,182,98,3,1,True,0.32516619791442564
2025-01-08 15:30:34,Merah,285,296,tensor(132.1050),tensor(127.1489),117,26,118,29,1,3,True,0.0005025863647460938
2025-01-08 15:30:34,Fail to pick,285,296,0,0,0,0,0,0,0,0,False,0
2025-01-08 15:30:36,persegiMerah,277,305,128,125,183,14,180,17,3,3,True,0.126353178654308
2025-01-08 15:30:36,Merah,277,305,tensor(128.0446),tensor(125.8331),115,25,119,29,4,4,True,0.0004978179931640625
2025-01-08 15:30:36,Fail to pick,277,305,0,0,0,0,0,0,0,0,False,0
2025-01-08 15:30:38,persegiMerah,296,303,130,117,170,13,169,16,1,3,True,0.3754614187087315
2025-01-08 15:30:38,Merah,296,303,tensor(130.2851),tensor(117.4987),115,27,114,30,1,3,True,0.0
2025-01-08 15:30:40,persegiMerah,290,298,131,121,99,75,99,70,0,5,True,0.13979629385111345
2025-01-08 15:30:40,Fail to pick,290,298,0,0,0,0,0,0,0,0,False,0
2025-01-08 15:30:42,persegiMerah,291,298,134,121,149,4,151,7,2,3,True,0.1988067942429822
2025-01-08 15:30:42,Merah,291,298,tensor(134.4832),tensor(121.5369),117,26,119,26,2,0,True,0.0004992485046386719
2025-01-08 15:30:42,Fail to pick,291,298,0,0,0,0,0,0,0,0,False,0
2025-01-08 15:30:44,persegiMerah,278,294,139,125,136,89,131,89,5,0,True,0.31872325631394305
2025-01-08 15:30:44,Merah,278,294,tensor(139.7719),tensor(125.8866),118,25,114,27,4,2,True,0.0005033016204833984
2025-01-08 15:30:49,persegiMerah,806,375,142,150,84,73,84,74,0,1,True,0.25551401450090366
2025-01-08 15:30:49,Merah,806,375,tensor(142.2808),tensor(150.2264),95,74,98,75,3,1,True,0.0004980564117431641
2025-01-08 15:30:51,persegiMerah,896,395,135,118,92,14,89,17,3,3,False,0.11814597707330582
2025-01-08 15:30:51,Merah,896,395,tensor(135.5826),tensor(118.9339),90,82,85,83,5,1,True,0.0
2025-01-08 15:35:23,persegiMerah,265,272,127,121,17,51,15,55,2,4,True,0.29649281477149764
2025-01-08 15:35:23,Merah,265,272,tensor(127.5643),tensor(121.1157),124,24,119,22,5,2,True,0.0004992485046386719
2025-01-08 15:35:23,persegiMerah,310,301,136,121,169,41,164,41,5,0,True,0.26356316901404886
2025-01-08 15:35:23,persegiMerah,274,261,127,124,132,18,132,21,0,3,True,0.2868511192477333
2025-01-08 15:35:23,persegiMerah,266,276,126,125,69,26,69,29,0,3,True,0.37541734196248155
2025-01-08 15:35:24,persegiMerah,272,272,126,120,54,52,57,49,3,3,True,0.42671092405839406
2025-01-08 15:35:24,Fail to pick,272,272,0,0,0,0,0,0,0,0,False,0
2025-01-08 15:35:24,persegiMerah,307,305,133,118,82,26,82,25,0,1,True,0.3132618461253274
2025-01-08 15:35:24,persegiMerah,309,304,131,117,50,94,46,94,4,0,True,0.3680978917035569
2025-01-08 15:35:24,Fail to pick,309,304,0,0,0,0,0,0,0,0,False,0
2025-01-08 15:35:24,persegiMerah,267,270,126,117,180,43,176,39,4,4,True,0.20229706321915622
2025-01-08 15:35:24,persegiMerah,306,298,129,119,57,10,56,6,1,4,True,0.12528392493547624
2025-01-08 15:35:24,persegiMerah,255,269,122,118,182,84,178,80,4,4,True,0.2612174118425955
2025-01-08 15:35:25,persegiMerah,266,266,122,117,2,16,0,15,2,1,True,0.20095358543301636
2025-01-08 15:35:25,persegiMerah,303,301,131,118,91,76,94,75,3,1,False,0.4053514650663015
2025-01-08 15:35:25,persegiMerah,310,297,132,118,131,4,131,3,0,1,True,0.4317284125138249
2025-01-08 15:35:25,Fail to pick,310,297,0,0,0,0,0,0,0,0,False,0
2025-01-08 15:35:25,persegiMerah,261,266,124,120,139,46,141,43,2,3,True,0.12539259436940442
2025-01-08 15:35:30,persegiKuning,309,300,129,114,61,1,63,3,2,2,True,0.37266248621177755
2025-01-08 15:35:30,persegiKuning,308,300,130,115,64,7,68,5,4,2,True,0.16586347072024457
2025-01-08 15:35:30,Fail to pick,308,300,0,0,0,0,0,0,0,0,False,0
2025-01-08 15:35:31,persegiMerah,307,306,129,117,190,69,193,68,3,1,True,0.3747503435060029
2025-01-08 15:35:31,Fail to pick,307,306,0,0,0,0,0,0,0,0,False,0
2025-01-08 15:35:31,persegiMerah,306,303,124,115,155,4,158,6,3,2,True,0.4320532214772409
2025-01-08 15:35:31,Fail to pick,306,303,0,0,0,0,0,0,0,0,False,0
2025-01-08 15:35:31,persegiMerah,303,301,128,115,122,71,125,69,3,2,True,0.13495183594678442
2025-01-08 15:35:31,Fail to pick,303,301,0,0,0,0,0,0,0,0,False,0
2025-01-08 15:35:31,persegiMerah,260,267,122,117,86,51,89,53,3,2,True,0.41963839936926395
2025-01-08 15:35:31,persegiMerah,258,263,121,115,64,26,67,28,3,2,True,0.46066187099775
2025-01-08 15:35:31,Fail to pick,258,263,0,0,0,0,0,0,0,0,False,0
2025-01-08 15:35:32,persegiMerah,312,299,131,120,66,92,67,89,1,3,True,0.40393057554863754
2025-01-08 15:35:32,persegiMerah,316,301,137,115,103,3,102,-2,1,5,True,0.16805586006267575
2025-01-08 15:35:32,Fail to pick,316,301,0,0,0,0,0,0,0,0,False,0
2025-01-08 15:35:33,persegiMerah,309,298,130,119,112,22,114,17,2,5,True,0.11150350059002397
2025-01-08 15:35:33,Fail to pick,309,298,0,0,0,0,0,0,0,0,False,0
2025-01-08 15:35:33,persegiMerah,304,301,132,118,173,47,170,49,3,2,True,0.3876571717077961
2025-01-08 15:35:33,Fail to pick,304,301,0,0,0,0,0,0,0,0,False,0
2025-01-08 15:35:33,persegiMerah,326,311,135,118,26,80,25,76,1,4,True,0.3307356144530048
2025-01-08 15:35:34,persegiMerah,325,313,136,117,161,24,160,23,1,1,True,0.320148113445975
2025-01-08 15:35:34,Fail to pick,325,313,0,0,0,0,0,0,0,0,False,0
2025-01-08 15:35:34,persegiMerah,262,268,122,115,101,90,103,89,2,1,False,0.1455198484391474
2025-01-08 15:35:34,persegiMerah,255,267,124,114,130,17,127,15,3,2,True,0.4228005502806991
2025-01-08 15:35:34,Fail to pick,255,267,0,0,0,0,0,0,0,0,False,0
2025-01-08 15:35:35,persegiMerah,304,304,130,115,59,53,58,56,1,3,True,0.27618018946135003
2025-01-08 15:35:36,persegiMerah,255,263,122,112,46,15,47,12,1,3,True,0.37492758979814444
2025-01-08 15:35:36,persegiKuning,312,300,132,112,74,49,76,52,2,3,True,0.4755911154808392
2025-01-08 15:35:41,persegiMerah,404,315,155,126,102,16,104,16,2,0,True,0.18689384209516957
2025-01-08 15:35:41,persegiMerah,406,318,152,129,32,61,33,65,1,4,True,0.427253636159835
2025-01-08 15:35:41,Fail to pick,406,318,0,0,0,0,0,0,0,0,False,0
2025-01-08 15:35:41,persegiMerah,334,277,138,127,155,47,153,42,2,5,True,0.3647351628880573
2025-01-08 15:35:41,Merah,334,277,tensor(138.9399),tensor(127.1361),123,30,119,33,4,3,True,0.0004987716674804688
2025-01-08 15:35:41,persegiMerah,400,319,149,128,144,54,139,51,5,3,True,0.3620296050370081
2025-01-08 15:35:41,persegiMerah,332,278,137,125,21,56,25,60,4,4,True,0.22975950902452996
2025-01-08 15:35:41,persegiMerah,404,314,151,130,73,45,74,45,1,0,True,0.20158130988991574
2025-01-08 15:35:41,persegiMerah,403,317,152,126,151,26,146,22,5,4,True,0.3036206603485563
2025-01-08 15:35:41,Fail to pick,403,317,0,0,0,0,0,0,0,0,False,0
2025-01-08 15:35:41,persegiMerah,401,318,151,126,134,34,133,34,1,0,True,0.3210389234363642
2025-01-08 15:35:41,Fail to pick,401,318,0,0,0,0,0,0,0,0,False,0
2025-01-08 15:35:42,persegiMerah,407,323,153,126,144,17,143,15,1,2,True,0.29922053694716394
2025-01-08 15:35:42,Fail to pick,407,323,0,0,0,0,0,0,0,0,False,0
2025-01-08 15:35:42,persegiMerah,406,328,154,128,52,83,47,81,5,2,True,0.1017980986708766
2025-01-08 15:35:42,Fail to pick,406,328,0,0,0,0,0,0,0,0,False,0
2025-01-08 15:35:42,persegiMerah,407,326,154,125,127,90,127,88,0,2,True,0.12934311818296115
2025-01-08 15:35:42,Fail to pick,407,326,0,0,0,0,0,0,0,0,False,0
2025-01-08 15:35:42,persegiMerah,406,321,155,126,132,86,127,83,5,3,True,0.4757402504758562
2025-01-08 15:35:42,Fail to pick,406,321,0,0,0,0,0,0,0,0,False,0
2025-01-08 15:35:42,persegiMerah,403,316,153,127,60,40,55,41,5,1,True,0.3186339200993956
2025-01-08 15:35:42,Fail to pick,403,316,0,0,0,0,0,0,0,0,False,0
2025-01-08 15:35:42,persegiMerah,400,318,153,129,134,71,136,74,2,3,True,0.1817902708621773
2025-01-08 15:35:42,Fail to pick,400,318,0,0,0,0,0,0,0,0,False,0
2025-01-08 15:35:42,persegiMerah,341,273,137,124,43,99,45,95,2,4,True,0.3453016650523484
2025-01-08 15:35:42,Merah,341,273,tensor(137.7364),tensor(124.9597),124,31,123,28,1,3,True,0.0
2025-01-08 15:35:42,persegiMerah,399,320,153,130,194,52,198,55,4,3,True,0.3411638188995063
2025-01-08 15:35:42,persegiMerah,405,313,151,125,77,8,77,7,0,1,True,0.30236057443446757
2025-01-08 15:35:42,Fail to pick,405,313,0,0,0,0,0,0,0,0,False,0
2025-01-08 15:35:43,persegiMerah,395,317,153,128,176,78,174,78,2,0,True,0.2681762139217697
2025-01-08 15:35:43,persegiMerah,399,318,149,128,36,88,35,83,1,5,True,0.2793182417465475
2025-01-08 15:35:43,Fail to pick,399,318,0,0,0,0,0,0,0,0,False,0
2025-01-08 15:35:43,persegiMerah,403,318,150,128,44,30,40,29,4,1,True,0.4070841255357953
2025-01-08 15:35:43,Fail to pick,403,318,0,0,0,0,0,0,0,0,False,0
2025-01-08 15:35:43,persegiMerah,405,314,153,129,195,7,191,8,4,1,True,0.32175104417321654
2025-01-08 15:35:43,Fail to pick,405,314,0,0,0,0,0,0,0,0,False,0
2025-01-08 15:35:43,persegiMerah,405,319,149,128,87,50,83,45,4,5,True,0.3097802892313047
2025-01-08 15:35:43,Fail to pick,405,319,0,0,0,0,0,0,0,0,False,0
2025-01-08 15:35:43,persegiMerah,402,315,148,126,48,7,48,6,0,1,True,0.4341346263763738
2025-01-08 15:35:43,Fail to pick,402,315,0,0,0,0,0,0,0,0,False,0
2025-01-08 15:35:44,persegiMerah,402,319,148,128,19,85,19,80,0,5,True,0.36805678498905914
2025-01-08 15:35:44,Fail to pick,402,319,0,0,0,0,0,0,0,0,False,0
2025-01-08 15:35:44,persegiMerah,410,315,151,129,128,81,124,82,4,1,True,0.20998454654209078
2025-01-08 15:35:44,Fail to pick,410,315,0,0,0,0,0,0,0,0,False,0
2025-01-08 15:35:44,persegiMerah,402,317,152,126,120,73,120,73,0,0,False,0.239957239712434
2025-01-08 15:35:44,Fail to pick,402,317,0,0,0,0,0,0,0,0,False,0
2025-01-08 15:35:44,persegiMerah,402,320,154,129,4,9,0,9,4,0,True,0.4022213685846425
2025-01-08 15:35:44,Fail to pick,402,320,0,0,0,0,0,0,0,0,False,0
2025-01-08 15:35:44,persegiMerah,406,316,153,125,23,80,20,82,3,2,True,0.22400316534269904
2025-01-08 15:35:44,Fail to pick,406,316,0,0,0,0,0,0,0,0,False,0
2025-01-08 15:35:44,persegiMerah,345,280,139,124,129,75,133,75,4,0,True,0.27249494255770623
2025-01-08 15:35:44,Merah,345,280,tensor(139.7927),tensor(124.7755),122,31,122,32,0,1,True,0.0
2025-01-08 15:35:44,persegiMerah,345,280,139,124,76,67,72,62,4,5,True,0.38918948299583234
2025-01-08 15:35:44,Fail to pick,345,280,0,0,0,0,0,0,0,0,False,0
2025-01-08 15:35:45,persegiMerah,402,317,156,128,143,87,141,84,2,3,True,0.49723463833264125
2025-01-08 15:35:45,persegiMerah,398,320,151,127,115,19,116,20,1,1,True,0.4994973512790455
2025-01-08 15:35:45,Fail to pick,398,320,0,0,0,0,0,0,0,0,False,0
2025-01-08 15:35:45,persegiMerah,338,278,139,128,153,27,152,26,1,1,True,0.43246222671606704
2025-01-08 15:35:45,persegiMerah,401,318,153,127,67,90,64,91,3,1,True,0.10823016268258182
2025-01-08 15:35:45,persegiMerah,399,319,151,129,157,24,159,24,2,0,True,0.41048468585245534
2025-01-08 15:35:45,Fail to pick,399,319,0,0,0,0,0,0,0,0,False,0
2025-01-08 15:35:45,persegiMerah,403,318,154,127,1,9,-1,9,2,0,True,0.4279073918336349
2025-01-08 15:35:45,Fail to pick,403,318,0,0,0,0,0,0,0,0,False,0
2025-01-08 15:35:45,persegiMerah,405,316,151,130,131,25,135,25,4,0,True,0.13697077104865843
2025-01-08 15:35:45,Fail to pick,405,316,0,0,0,0,0,0,0,0,False,0
2025-01-08 15:35:45,persegiMerah,401,316,154,127,125,7,123,8,2,1,True,0.4716971997891731
2025-01-08 15:35:45,Fail to pick,401,316,0,0,0,0,0,0,0,0,False,0
2025-01-08 15:35:45,persegiMerah,403,311,151,126,103,16,107,13,4,3,True,0.43520596474774154
2025-01-08 15:35:45,Fail to pick,403,311,0,0,0,0,0,0,0,0,False,0
2025-01-08 15:35:46,persegiMerah,406,318,153,125,67,80,62,84,5,4,False,0.4979620571835033
2025-01-08 15:35:46,Fail to pick,406,318,0,0,0,0,0,0,0,0,False,0
2025-01-08 15:35:46,persegiMerah,408,314,150,129,174,38,174,36,0,2,True,0.286094069944187
2025-01-08 15:35:46,Fail to pick,408,314,0,0,0,0,0,0,0,0,False,0
2025-01-08 15:35:46,persegiMerah,402,313,149,129,88,48,84,48,4,0,True,0.4463585695156361
2025-01-08 15:35:46,Fail to pick,402,313,0,0,0,0,0,0,0,0,False,0
2025-01-08 15:35:46,persegiMerah,400,312,151,127,61,6,63,1,2,5,True,0.30229311807593906
2025-01-08 15:35:46,Fail to pick,400,312,0,0,0,0,0,0,0,0,False,0
2025-01-08 15:35:46,persegiMerah,400,312,151,127,121,88,116,87,5,1,True,0.4995480764895954
2025-01-08 15:35:46,Fail to pick,400,312,0,0,0,0,0,0,0,0,False,0
2025-01-08 15:35:46,persegiMerah,408,312,151,126,102,10,97,7,5,3,True,0.351186783707901
2025-01-08 15:35:46,Fail to pick,408,312,0,0,0,0,0,0,0,0,False,0
2025-01-08 15:35:46,persegiMerah,404,318,150,127,96,31,93,34,3,3,False,0.12353349465515612
2025-01-08 15:35:46,Fail to pick,404,318,0,0,0,0,0,0,0,0,False,0
2025-01-08 15:39:53,persegiMerah,810,391,119,123,37,70,35,71,2,1,True,0.48729034850130715
2025-01-08 15:39:53,Merah,810,391,tensor(119.7241),tensor(123.8357),91,75,93,71,2,4,True,0.0005061626434326172
2025-01-08 15:39:54,persegiBiru,796,346,125,108,113,50,114,49,1,1,True,0.42322262143557365
2025-01-08 15:40:03,persegiMerah,186,400,125,109,183,89,183,91,0,2,True,0.15686878221967182
2025-01-08 15:40:03,Merah,186,400,tensor(125.6003),tensor(109.2520),88,17,87,21,1,4,True,0.0004990100860595703
2025-01-08 15:40:03,persegiMerah,180,407,127,111,124,9,125,9,1,0,True,0.424499503817953
2025-01-08 15:40:03,Fail to pick,180,407,0,0,0,0,0,0,0,0,False,0
2025-01-08 15:40:03,persegiMerah,160,384,120,109,29,20,31,23,2,3,True,0.4194587906434142
2025-01-08 15:40:04,persegiMerah,198,384,136,111,144,56,141,52,3,4,True,0.21040658481682992
2025-01-08 15:40:04,persegiMerah,165,380,128,112,166,89,169,91,3,2,True,0.4509813358449696
2025-01-08 15:40:04,persegiMerah,160,383,120,114,44,69,39,64,5,5,True,0.4681892294418383
2025-01-08 15:40:04,Fail to pick,160,383,0,0,0,0,0,0,0,0,False,0
2025-01-08 15:40:04,persegiMerah,155,383,121,112,145,54,144,49,1,5,True,0.27076826337367615
2025-01-08 15:40:04,Fail to pick,155,383,0,0,0,0,0,0,0,0,False,0
2025-01-08 15:40:04,persegiMerah,171,386,127,115,121,26,122,23,1,3,True,0.19102611785326384
2025-01-08 15:40:04,Merah,171,386,tensor(127.3773),tensor(115.5146),92,15,92,15,0,0,True,0.0
2025-01-08 15:40:04,persegiMerah,169,378,131,117,152,67,154,63,2,4,True,0.11034886262466755
2025-01-08 15:40:04,Fail to pick,169,378,0,0,0,0,0,0,0,0,False,0
2025-01-08 15:40:05,persegiMerah,167,384,127,116,110,53,111,57,1,4,True,0.16109482237663397
2025-01-08 15:40:05,Fail to pick,167,384,0,0,0,0,0,0,0,0,False,0
2025-01-08 15:40:05,persegiMerah,166,387,128,114,164,96,163,92,1,4,True,0.40929440332767975
2025-01-08 15:40:05,Fail to pick,166,387,0,0,0,0,0,0,0,0,False,0
2025-01-08 15:40:05,persegiMerah,168,385,131,115,111,40,112,36,1,4,True,0.4479951199218818
2025-01-08 15:40:05,Fail to pick,168,385,0,0,0,0,0,0,0,0,False,0
2025-01-08 15:40:05,persegiMerah,158,382,124,120,50,83,53,78,3,5,True,0.13992512076976232
2025-01-08 15:40:05,persegiMerah,165,384,130,117,72,79,74,78,2,1,True,0.2604543621054767
2025-01-08 15:40:05,Fail to pick,165,384,0,0,0,0,0,0,0,0,False,0
2025-01-08 15:40:10,persegiMerah,166,387,129,116,32,28,27,28,5,0,True,0.3052712248033038
2025-01-08 15:40:10,Merah,166,387,tensor(129.5616),tensor(116.8549),92,15,88,19,4,4,True,0.0004975795745849609
2025-01-08 15:40:10,Fail to pick,166,387,0,0,0,0,0,0,0,0,False,0
2025-01-08 15:40:10,persegiMerah,163,387,129,117,182,56,186,57,4,1,True,0.10605224055643325
2025-01-08 15:40:10,Fail to pick,163,387,0,0,0,0,0,0,0,0,False,0
2025-01-08 15:40:10,persegiMerah,165,384,129,113,109,46,111,43,2,3,False,0.44325619854096454
2025-01-08 15:40:10,Fail to pick,165,384,0,0,0,0,0,0,0,0,False,0
2025-01-08 15:40:10,persegiMerah,182,399,134,113,188,8,187,4,1,4,True,0.41145286446157836
2025-01-08 15:40:10,persegiMerah,170,383,134,115,178,81,180,85,2,4,True,0.4497794833057813
2025-01-08 15:40:11,persegiMerah,164,388,130,114,74,50,75,46,1,4,True,0.3611409254164123
2025-01-08 15:40:11,Fail to pick,164,388,0,0,0,0,0,0,0,0,False,0
2025-01-08 15:40:11,persegiMerah,178,405,131,115,162,73,164,74,2,1,True,0.3254093483348034
2025-01-08 15:40:11,persegiMerah,183,403,131,115,73,33,71,34,2,1,True,0.29829777613199726
2025-01-08 15:40:11,Fail to pick,183,403,0,0,0,0,0,0,0,0,False,0
2025-01-08 15:40:11,persegiMerah,181,400,131,113,97,32,92,29,5,3,True,0.48174160274296407
2025-01-08 15:40:11,Fail to pick,181,400,0,0,0,0,0,0,0,0,False,0
2025-01-08 15:40:11,persegiMerah,180,402,133,115,151,8,149,9,2,1,True,0.21944417562819407
2025-01-08 15:40:11,Merah,180,402,tensor(133.1013),tensor(115.5862),88,16,83,11,5,5,True,0.0005195140838623047
2025-01-08 15:40:11,Fail to pick,180,402,0,0,0,0,0,0,0,0,False,0
2025-01-08 15:40:11,persegiMerah,165,382,132,114,180,81,180,85,0,4,True,0.23517143123774453
2025-01-08 15:40:11,persegiMerah,163,386,127,114,0,33,4,32,4,1,True,0.2874625410612506
2025-01-08 15:40:11,Fail to pick,163,386,0,0,0,0,0,0,0,0,False,0
2025-01-08 15:40:11,persegiMerah,165,388,130,113,3,41,2,36,1,5,True,0.2067126028242422
2025-01-08 15:40:11,Fail to pick,165,388,0,0,0,0,0,0,0,0,False,0
2025-01-08 15:40:11,persegiMerah,166,386,133,115,18,12,14,8,4,4,True,0.12579117271185855
2025-01-08 15:40:11,Fail to pick,166,386,0,0,0,0,0,0,0,0,False,0
2025-01-08 15:40:12,persegiMerah,168,389,131,118,73,22,71,25,2,3,True,0.26582583320202546
2025-01-08 15:40:12,Fail to pick,168,389,0,0,0,0,0,0,0,0,False,0
2025-01-08 15:40:12,persegiMerah,170,383,132,116,65,97,69,97,4,0,True,0.18599529767932954
2025-01-08 15:40:12,Fail to pick,170,383,0,0,0,0,0,0,0,0,False,0
2025-01-08 15:40:12,persegiMerah,167,386,129,115,129,67,133,64,4,3,True,0.26388486129782873
2025-01-08 15:40:12,Fail to pick,167,386,0,0,0,0,0,0,0,0,False,0
2025-01-08 15:40:12,persegiMerah,168,385,131,115,88,72,85,68,3,4,True,0.10708266515092824
2025-01-08 15:40:12,Fail to pick,168,385,0,0,0,0,0,0,0,0,False,0
2025-01-08 15:40:12,persegiMerah,170,379,132,118,122,96,119,96,3,0,True,0.44756415205862676
2025-01-08 15:40:12,Merah,170,379,tensor(132.5917),tensor(118.2301),94,15,90,11,4,4,True,0.0004992485046386719
2025-01-08 15:40:12,Fail to pick,170,379,0,0,0,0,0,0,0,0,False,0
2025-01-08 15:40:12,persegiMerah,175,383,135,116,139,31,135,29,4,2,True,0.2904617185756939
2025-01-08 15:40:12,Fail to pick,175,383,0,0,0,0,0,0,0,0,False,0
2025-01-08 15:40:12,persegiMerah,161,386,124,115,67,53,67,50,0,3,True,0.406156218501742
2025-01-08 15:40:12,persegiMerah,182,385,132,120,35,85,39,84,4,1,True,0.12785973254385408
2025-01-08 15:40:13,persegiMerah,176,383,133,114,160,3,156,-2,4,5,False,0.23770745508969188
2025-01-08 15:40:13,Fail to pick,176,383,0,0,0,0,0,0,0,0,False,0
2025-01-08 15:40:13,persegiMerah,164,392,124,116,7,22,4,25,3,3,True,0.3168537353798424
2025-01-08 15:40:21,persegiMerah,786,159,138,133,75,75,79,78,4,3,True,0.4039192574015681
2025-01-08 15:40:21,Merah,786,159,tensor(138.5814),tensor(133.1128),155,72,152,72,3,0,True,0.00051116943359375
2025-01-08 15:40:21,persegiMerah,786,153,130,130,114,38,112,38,2,0,False,0.31601706069470903
2025-01-08 15:40:21,Fail to pick,786,153,0,0,0,0,0,0,0,0,False,0
2025-01-08 15:40:21,persegiMerah,770,99,114,125,141,90,142,86,1,4,False,0.39955850682004646
2025-01-08 15:40:22,persegiMerah,783,160,131,134,108,8,109,7,1,1,True,0.47160123877542326
2025-01-08 15:40:22,persegiMerah,785,157,132,132,113,75,112,70,1,5,True,0.47323195618019354
2025-01-08 15:40:22,Merah,785,157,tensor(132.8748),tensor(132.9431),156,72,158,70,2,2,True,0.0004994869232177734
2025-01-08 15:40:22,Fail to pick,785,157,0,0,0,0,0,0,0,0,False,0
2025-01-08 15:40:22,persegiMerah,793,156,136,129,119,85,120,88,1,3,True,0.17571449961952024
2025-01-08 15:40:22,Fail to pick,793,156,0,0,0,0,0,0,0,0,False,0
2025-01-08 15:40:22,persegiMerah,811,147,128,125,156,27,151,25,5,2,True,0.17545475466571703
2025-01-08 15:40:31,persegiMerah,746,92,108,116,144,85,145,88,1,3,True,0.40142526907508047
2025-01-08 15:40:33,persegiMerah,786,96,118,120,119,31,117,29,2,2,True,0.19017718315089757
2025-01-08 15:40:33,Merah,786,96,tensor(118.9410),tensor(120.5146),173,72,173,71,0,1,True,0.0004990100860595703
2025-01-08 15:40:34,persegiMerah,785,95,116,123,79,51,81,52,2,1,False,0.47576264553202097
2025-01-08 15:40:34,Fail to pick,785,95,0,0,0,0,0,0,0,0,False,0
2025-01-08 15:40:34,persegiMerah,791,108,114,123,111,15,110,18,1,3,True,0.43508030012497767
2025-01-08 15:40:34,Merah,791,108,tensor(114.5236),tensor(123.8840),170,73,173,73,3,0,True,0.0004966259002685547
2025-01-08 15:40:35,persegiMerah,825,131,117,124,79,23,75,19,4,4,True,0.31988252737665956
2025-01-08 15:40:35,persegiMerah,829,131,111,125,151,24,146,28,5,4,True,0.3207073602253565
2025-01-08 15:40:35,Fail to pick,829,131,0,0,0,0,0,0,0,0,False,0
2025-01-08 15:40:37,persegiMerah,813,88,111,124,107,25,104,29,3,4,True,0.22659155888668625
2025-01-08 15:40:37,Merah,813,88,tensor(111.3163),tensor(124.1035),175,75,176,76,1,1,True,0.0004994869232177734
2025-01-08 15:40:37,persegiMerah,805,106,117,120,185,48,183,51,2,3,True,0.20232406312465143
2025-01-08 15:42:26,persegiKuning,805,207,122,145,23,99,27,99,4,0,True,0.2662533565643728
2025-01-08 15:42:26,Kuning,805,207,tensor(122.7047),tensor(145.9895),142,74,138,72,4,2,True,0.0
2025-01-08 15:42:26,persegiMerah,833,182,110,133,96,98,99,102,3,4,True,0.2549887523314871
2025-01-08 15:42:27,persegiMerah,832,182,107,134,175,12,171,11,4,1,True,0.4309115038343797
2025-01-08 15:42:27,Merah,832,182,tensor(107.5085),tensor(134.4995),149,77,146,79,3,2,True,0.0
2025-01-08 15:42:27,Fail to pick,832,182,0,0,0,0,0,0,0,0,False,0
2025-01-08 15:42:27,persegiMerah,846,170,126,133,35,28,36,23,1,5,True,0.3131908292243678
2025-01-08 15:42:28,persegiMerah,805,166,118,126,178,76,174,80,4,4,False,0.28968245167981443
2025-01-08 15:42:28,Merah,805,166,tensor(118.4721),tensor(126.6962),153,74,148,70,5,4,True,0.0
2025-01-08 15:42:42,persegiMerah,782,598,128,117,180,41,176,38,4,3,True,0.1725008444908172
2025-01-08 15:42:42,Merah,782,598,tensor(128.0238),tensor(117.6477),33,72,29,72,4,0,True,0.0003993511199951172
2025-01-08 15:42:43,persegiMerah,785,594,132,119,145,8,147,4,2,4,True,0.321318877676891
2025-01-08 15:42:43,Fail to pick,785,594,0,0,0,0,0,0,0,0,False,0
2025-01-08 15:42:43,persegiMerah,789,586,137,114,97,29,101,31,4,2,True,0.2424967120486247
2025-01-08 15:42:43,Fail to pick,789,586,0,0,0,0,0,0,0,0,False,0
2025-01-08 15:42:44,persegiMerah,792,592,139,121,197,72,195,76,2,4,True,0.3704391116361849
2025-01-08 15:42:44,Merah,792,592,tensor(139.7305),tensor(121.0558),35,73,38,77,3,4,True,0.0004944801330566406
2025-01-08 15:42:44,Fail to pick,792,592,0,0,0,0,0,0,0,0,False,0
2025-01-08 15:42:44,persegiMerah,827,552,128,122,32,61,31,65,1,4,True,0.31054866037492335
2025-01-08 15:46:09,persegiMerah,836,132,139,145,44,26,42,30,2,4,True,0.17093393564831755
2025-01-08 15:46:09,Merah,836,132,tensor(139.7984),tensor(145.9557),163,77,161,74,2,3,True,0.0004992485046386719
2025-01-08 15:46:10,persegiMerah,840,80,119,136,52,97,48,101,4,4,True,0.3067457485455354
2025-01-08 15:46:10,persegiMerah,835,89,115,132,106,97,110,101,4,4,False,0.25387103474424594
2025-01-08 15:46:10,Fail to pick,835,89,0,0,0,0,0,0,0,0,False,0
2025-01-08 15:46:10,persegiMerah,863,86,124,140,35,98,36,96,1,2,True,0.3874852443401725
2025-01-08 15:46:10,Merah,863,86,tensor(124.2368),tensor(140.3527),176,79,172,82,4,3,True,0.0
2025-01-08 15:46:11,persegiMerah,816,85,127,139,115,70,111,71,4,1,True,0.37511886233051916
2025-01-08 15:46:11,persegiMerah,836,90,119,129,25,18,20,21,5,3,True,0.3992832335945694
2025-01-08 15:46:11,persegiMerah,831,93,115,130,164,30,165,26,1,4,True,0.167725241203483
2025-01-08 15:46:11,Fail to pick,831,93,0,0,0,0,0,0,0,0,False,0
2025-01-08 15:46:11,persegiMerah,871,78,129,138,104,38,103,39,1,1,True,0.11486176191545515
2025-01-08 15:46:12,persegiMerah,830,90,118,131,170,75,165,70,5,5,True,0.20156986202261107
2025-01-08 15:46:12,Merah,830,90,tensor(118.1021),tensor(131.9403),175,76,176,80,1,4,True,0.0004973411560058594
2025-01-08 15:46:12,persegiMerah,835,88,115,131,46,3,48,1,2,2,True,0.424624075921185
2025-01-08 15:46:12,Fail to pick,835,88,0,0,0,0,0,0,0,0,False,0
2025-01-08 15:46:12,persegiMerah,858,80,124,136,111,97,108,99,3,2,True,0.45092748840525376
2025-01-08 15:47:10,persegiMerah,862,131,143,151,123,53,118,49,5,4,True,0.18411163529300661
2025-01-08 15:47:10,Merah,862,131,tensor(143.5460),tensor(151.3608),163,79,159,80,4,1,True,0.0004999637603759766
2025-01-08 15:47:10,persegiMerah,835,101,131,138,131,74,128,76,3,2,True,0.410181730509248
2025-01-08 15:48:20,persegiMerah,918,316,129,122,153,9,156,11,3,2,True,0.12910922211525389
2025-01-08 15:48:20,persegiMerah,912,304,138,120,6,75,1,79,5,4,True,0.4459078071740815
2025-01-08 15:48:20,Merah,912,304,tensor(138.0764),tensor(120.4983),115,84,119,86,4,2,True,0.0004980564117431641
2025-01-08 15:48:20,persegiMerah,924,311,136,120,45,86,43,81,2,5,True,0.16639238635542525
2025-01-08 15:48:21,persegiMerah,920,299,132,125,56,63,60,60,4,3,True,0.16149754159945418
2025-01-08 15:48:21,persegiMerah,910,302,136,126,170,71,173,68,3,3,False,0.12219745909732956
2025-01-08 15:48:21,persegiMerah,891,283,135,127,190,76,186,71,4,5,True,0.1834813298524392
2025-01-08 15:48:21,persegiMerah,880,291,128,128,8,38,5,37,3,1,True,0.14741858150005563
2025-01-08 15:48:21,Merah,880,291,tensor(128.5842),tensor(128.2357),119,81,121,81,2,0,True,0.0004987716674804688
2025-01-08 15:48:21,persegiMerah,912,296,129,125,50,49,54,47,4,2,True,0.3085693375316447
2025-01-08 15:48:22,persegiMerah,947,334,137,117,61,94,61,89,0,5,False,0.32138471758161746
2025-01-08 15:48:22,persegiMerah,929,318,135,118,43,89,41,89,2,0,True,0.290243079236405
2025-01-08 15:48:29,persegiMerah,880,324,130,124,157,4,155,3,2,1,True,0.3956454643744255
2025-01-08 15:48:29,Merah,880,324,tensor(130.8854),tensor(124.6826),110,81,112,82,2,1,True,0.0
2025-01-08 15:48:29,persegiMerah,947,304,121,123,110,41,105,45,5,4,True,0.3107504968379334
2025-01-08 15:48:29,persegiMerah,898,300,123,126,79,51,81,50,2,1,True,0.49601263882505875
2025-01-08 15:48:29,persegiMerah,915,293,132,128,169,49,170,47,1,2,False,0.4091027128617025
2025-01-08 15:48:29,persegiMerah,915,293,132,128,144,31,142,34,2,3,True,0.4949966542849077
2025-01-08 15:48:29,Fail to pick,915,293,0,0,0,0,0,0,0,0,False,0
2025-01-08 15:48:29,persegiMerah,909,302,125,129,78,10,82,13,4,3,True,0.2385637277706083
2025-01-08 15:48:29,Fail to pick,909,302,0,0,0,0,0,0,0,0,False,0
2025-01-08 15:48:30,persegiMerah,889,300,123,125,88,74,89,72,1,2,False,0.47956133153289726
2025-01-08 15:48:30,Merah,889,300,tensor(123.6883),tensor(125.2549),116,82,119,78,3,4,True,0.0
2025-01-08 15:48:30,persegiMerah,899,281,129,128,92,47,88,51,4,4,True,0.3885484551210523
2025-01-08 15:48:30,persegiMerah,920,301,126,125,68,86,66,88,2,2,True,0.497088297644391
2025-01-08 15:48:30,persegiMerah,916,305,122,125,151,51,155,51,4,0,True,0.4122475962904323
2025-01-08 15:48:30,Fail to pick,916,305,0,0,0,0,0,0,0,0,False,0
2025-01-08 15:48:30,persegiMerah,931,313,127,121,89,63,90,63,1,0,True,0.38627820704810023
2025-01-08 15:48:30,persegiMerah,921,303,128,128,123,61,124,57,1,4,True,0.14041927508362873
2025-01-08 15:48:31,persegiMerah,903,281,134,128,170,30,170,29,0,1,True,0.4533518192693913
2025-01-08 15:48:31,persegiMerah,911,309,125,126,196,12,195,8,1,4,True,0.29247414115795733
2025-01-08 15:48:31,persegiMerah,900,288,125,131,187,45,190,45,3,0,True,0.3360739076570194
2025-01-08 15:48:31,persegiMerah,921,305,128,124,115,5,111,4,4,1,False,0.2858919394274966
2025-01-08 15:48:31,Merah,921,305,tensor(128.6168),tensor(124.6637),115,85,117,88,2,3,True,0.0
2025-01-08 15:48:31,persegiMerah,924,300,129,124,40,37,44,38,4,1,True,0.11698811219379475
2025-01-08 15:48:31,Fail to pick,924,300,0,0,0,0,0,0,0,0,False,0
2025-01-08 15:48:31,persegiMerah,913,306,129,128,31,23,31,22,0,1,True,0.15980516992789245
2025-01-08 15:48:31,persegiMerah,895,287,128,130,171,70,169,65,2,5,True,0.45045795457897286
2025-01-08 15:48:31,persegiMerah,921,302,129,129,51,71,46,75,5,4,True,0.19305811809947207
2025-01-08 15:48:31,persegiMerah,916,306,127,125,150,40,154,38,4,2,True,0.1853733739228102
2025-01-08 15:48:31,Fail to pick,916,306,0,0,0,0,0,0,0,0,False,0
2025-01-08 15:48:32,persegiMerah,900,280,132,127,31,14,34,16,3,2,False,0.4163792638198316
2025-01-08 15:48:32,persegiMerah,918,301,131,126,189,89,188,88,1,1,True,0.19838792569386593
2025-01-08 15:48:32,persegiMerah,910,306,128,125,113,42,111,46,2,4,True,0.47824771003776356
2025-01-08 15:48:32,Fail to pick,910,306,0,0,0,0,0,0,0,0,False,0
2025-01-08 15:48:32,persegiMerah,921,301,128,125,155,99,154,102,1,3,True,0.47103365866832636
2025-01-08 15:48:32,persegiMerah,917,302,123,123,148,57,150,53,2,4,True,0.3407980785126399
2025-01-08 15:48:32,Merah,917,302,tensor(123.2689),tensor(123.2653),116,84,116,83,0,1,True,0.0004992485046386719
2025-01-08 15:48:32,Fail to pick,917,302,0,0,0,0,0,0,0,0,False,0
2025-01-08 15:48:32,persegiMerah,918,302,126,124,103,81,101,79,2,2,True,0.3331984389056564
2025-01-08 15:48:32,Fail to pick,918,302,0,0,0,0,0,0,0,0,False,0
2025-01-08 15:48:32,persegiMerah,920,300,128,130,49,2,46,2,3,0,True,0.17243995977429322
2025-01-08 15:48:32,Fail to pick,920,300,0,0,0,0,0,0,0,0,False,0
2025-01-08 15:48:32,persegiMerah,895,283,129,132,185,34,187,34,2,0,True,0.13996571260693697
2025-01-08 15:48:32,persegiMerah,929,304,133,126,155,26,153,29,2,3,True,0.37123566677039765
2025-01-08 15:48:33,persegiMerah,915,305,126,125,72,47,70,45,2,2,True,0.1502538425190756
2025-01-08 15:48:33,persegiMerah,908,302,129,125,61,18,60,16,1,2,True,0.42143889502484366
2025-01-08 15:48:33,Fail to pick,908,302,0,0,0,0,0,0,0,0,False,0
2025-01-08 15:48:33,persegiMerah,897,282,133,130,91,38,95,33,4,5,True,0.27737261349542713
2025-01-08 15:48:33,persegiMerah,908,308,131,126,135,87,132,85,3,2,True,0.3656459476310585
2025-01-08 15:48:33,persegiMerah,916,302,129,125,7,31,9,27,2,4,True,0.3433905529191493
2025-01-08 15:48:33,Fail to pick,916,302,0,0,0,0,0,0,0,0,False,0
2025-01-08 15:48:33,persegiMerah,914,300,128,124,175,48,175,45,0,3,True,0.23130534233087818
2025-01-08 15:48:33,Merah,914,300,tensor(128.3726),tensor(124.4288),116,84,120,86,4,2,True,0.0
2025-01-08 15:48:33,Fail to pick,914,300,0,0,0,0,0,0,0,0,False,0
2025-01-08 15:48:33,persegiMerah,911,304,125,123,143,50,144,49,1,1,True,0.37116209716212145
2025-01-08 15:48:33,Fail to pick,911,304,0,0,0,0,0,0,0,0,False,0
2025-01-08 15:48:33,persegiMerah,916,304,126,124,54,45,54,43,0,2,True,0.32453378254413323
2025-01-08 15:48:33,Fail to pick,916,304,0,0,0,0,0,0,0,0,False,0
2025-01-08 15:48:33,persegiMerah,915,303,124,130,75,28,75,30,0,2,True,0.46048574522642094
2025-01-08 15:48:33,Fail to pick,915,303,0,0,0,0,0,0,0,0,False,0
2025-01-08 15:48:34,persegiMerah,921,300,130,124,129,89,124,84,5,5,True,0.29868022660646154
2025-01-08 15:48:34,Fail to pick,921,300,0,0,0,0,0,0,0,0,False,0
2025-01-08 15:48:34,persegiMerah,903,305,131,125,121,25,117,20,4,5,True,0.24017215097871758
2025-01-08 15:48:34,persegiMerah,908,308,130,127,173,60,171,56,2,4,True,0.23458960261056516
2025-01-08 15:48:34,Fail to pick,908,308,0,0,0,0,0,0,0,0,False,0
2025-01-08 15:48:34,persegiMerah,914,300,123,125,122,86,123,82,1,4,True,0.39783020953751
2025-01-08 15:48:34,Fail to pick,914,300,0,0,0,0,0,0,0,0,False,0
2025-01-08 15:48:34,persegiMerah,898,286,129,130,1,1,2,5,1,4,True,0.2552599236737769
2025-01-08 15:48:34,Merah,898,286,tensor(129.0740),tensor(130.8145),120,83,121,83,1,0,True,0.0
2025-01-08 15:48:34,persegiMerah,920,299,129,128,43,74,46,72,3,2,True,0.33851143271881323
2025-01-08 15:48:34,persegiMerah,908,308,130,127,86,82,84,86,2,4,True,0.2432804393562989
2025-01-08 15:48:34,persegiMerah,900,280,130,127,83,21,80,23,3,2,True,0.24749832518968293
2025-01-08 15:48:35,persegiMerah,899,288,127,132,54,2,51,1,3,1,True,0.4942603633324276
2025-01-08 15:48:35,Fail to pick,899,288,0,0,0,0,0,0,0,0,False,0
2025-01-08 15:48:35,persegiMerah,912,311,129,125,161,58,164,54,3,4,True,0.33791413894993627
2025-01-08 15:48:35,persegiMerah,918,304,132,129,139,15,141,12,2,3,True,0.10038089042251924
2025-01-08 15:48:35,Fail to pick,918,304,0,0,0,0,0,0,0,0,False,0
2025-01-08 15:48:35,persegiMerah,894,341,137,128,128,47,126,51,2,4,False,0.3512816150014161
2025-01-08 15:48:35,persegiMerah,925,305,129,123,188,66,185,67,3,1,True,0.2809952590762216
2025-01-08 15:48:35,persegiMerah,925,305,131,124,144,18,141,20,3,2,True,0.32231545966034436
2025-01-08 15:48:35,Fail to pick,925,305,0,0,0,0,0,0,0,0,False,0
2025-01-08 15:48:35,persegiMerah,922,301,135,130,145,35,140,35,5,0,True,0.18928901844834495
2025-01-08 15:48:35,Merah,922,301,tensor(135.3908),tensor(130.4976),116,85,112,81,4,4,True,0.0
2025-01-08 15:48:35,Fail to pick,922,301,0,0,0,0,0,0,0,0,False,0
2025-01-08 15:48:35,persegiMerah,923,301,126,125,29,71,33,68,4,3,True,0.11759190225590972
2025-01-08 15:48:35,Fail to pick,923,301,0,0,0,0,0,0,0,0,False,0
2025-01-08 15:48:35,persegiMerah,889,343,136,131,38,42,35,45,3,3,True,0.34527873682776367
2025-01-08 15:48:36,persegiMerah,875,294,126,122,30,1,25,-1,5,2,True,0.21148885551282467
2025-01-08 15:48:37,persegiMerah,917,163,132,130,79,17,79,13,0,4,True,0.4129009506416733
2025-01-08 15:48:37,Merah,917,163,tensor(132.8700),tensor(130.1411),154,84,154,80,0,4,True,0.0004992485046386719
2025-01-08 15:48:37,persegiMerah,878,138,126,135,165,50,167,50,2,0,True,0.15677170277904692
2025-01-08 15:48:37,persegiMerah,918,164,131,133,185,1,180,1,5,0,True,0.3403692427603671
2025-01-08 15:48:37,persegiMerah,921,165,129,127,23,92,19,93,4,1,True,0.22981759101856658
2025-01-08 15:48:37,Fail to pick,921,165,0,0,0,0,0,0,0,0,False,0
2025-01-08 15:48:37,persegiMerah,919,168,129,128,116,25,120,26,4,1,True,0.3589392004255839
2025-01-08 15:48:37,Fail to pick,919,168,0,0,0,0,0,0,0,0,False,0
2025-01-08 15:48:37,persegiMerah,914,163,131,130,40,29,44,31,4,2,True,0.3640948647035074
2025-01-08 15:48:37,Fail to pick,914,163,0,0,0,0,0,0,0,0,False,0
2025-01-08 15:48:37,persegiMerah,916,158,129,129,178,57,176,53,2,4,True,0.3974901810741961
2025-01-08 15:48:37,Fail to pick,916,158,0,0,0,0,0,0,0,0,False,0
2025-01-08 15:48:37,persegiMerah,911,163,133,133,54,54,53,49,1,5,True,0.4774805053600947
2025-01-08 15:48:37,Fail to pick,911,163,0,0,0,0,0,0,0,0,False,0
2025-01-08 15:48:38,persegiMerah,921,163,130,130,117,59,114,60,3,1,True,0.17062219298039516
2025-01-08 15:48:38,persegiMerah,921,163,130,130,184,1,188,3,4,2,True,0.4683498880169734
2025-01-08 15:48:38,Merah,921,163,tensor(130.5468),tensor(130.1766),154,85,149,80,5,5,True,0.0
2025-01-08 15:48:38,Fail to pick,921,163,0,0,0,0,0,0,0,0,False,0
2025-01-08 15:48:38,persegiMerah,914,167,132,128,6,34,7,29,1,5,True,0.3584857813668736
2025-01-08 15:48:38,Fail to pick,914,167,0,0,0,0,0,0,0,0,False,0
2025-01-08 15:48:38,persegiMerah,920,163,128,127,179,75,179,74,0,1,False,0.38495979390880375
2025-01-08 15:48:38,Fail to pick,920,163,0,0,0,0,0,0,0,0,False,0
2025-01-08 15:48:38,persegiMerah,919,163,130,126,7,59,6,56,1,3,True,0.4458363298039595
2025-01-08 15:48:38,Fail to pick,919,163,0,0,0,0,0,0,0,0,False,0
2025-01-08 15:48:38,persegiMerah,923,166,133,133,42,76,46,77,4,1,True,0.2714028749706715
2025-01-08 15:48:38,Fail to pick,923,166,0,0,0,0,0,0,0,0,False,0
2025-01-08 15:48:38,persegiMerah,921,165,127,135,185,85,183,81,2,4,True,0.30136752979515524
2025-01-08 15:48:38,Fail to pick,921,165,0,0,0,0,0,0,0,0,False,0
2025-01-08 15:48:38,persegiMerah,922,163,133,133,95,50,97,49,2,1,False,0.17198832562250427
2025-01-08 15:48:38,Fail to pick,922,163,0,0,0,0,0,0,0,0,False,0
2025-01-08 15:48:38,persegiMerah,923,165,130,133,73,27,68,23,5,4,True,0.3937214584482117
2025-01-08 15:48:38,Fail to pick,923,165,0,0,0,0,0,0,0,0,False,0
2025-01-08 15:48:39,persegiMerah,925,165,127,132,119,63,123,67,4,4,True,0.28666709369734855
2025-01-08 15:48:39,Fail to pick,925,165,0,0,0,0,0,0,0,0,False,0
2025-01-08 15:48:39,persegiMerah,917,172,132,132,21,84,25,86,4,2,True,0.2913574212919948
2025-01-08 15:48:39,Merah,917,172,tensor(132.3756),tensor(132.5890),152,84,148,80,4,4,True,0.0004990100860595703
2025-01-08 15:48:39,Fail to pick,917,172,0,0,0,0,0,0,0,0,False,0
2025-01-08 15:48:39,persegiMerah,921,169,133,129,2,41,1,40,1,1,True,0.42123107894766465
2025-01-08 15:48:39,Fail to pick,921,169,0,0,0,0,0,0,0,0,False,0
2025-01-08 15:48:39,persegiMerah,920,172,133,130,143,53,141,53,2,0,True,0.4090679844008108
2025-01-08 15:48:39,Fail to pick,920,172,0,0,0,0,0,0,0,0,False,0
2025-01-08 15:48:39,persegiMerah,915,166,128,134,82,28,84,24,2,4,True,0.36201112295453164
2025-01-08 15:48:39,Fail to pick,915,166,0,0,0,0,0,0,0,0,False,0
2025-01-08 15:48:39,persegiMerah,919,170,133,129,18,31,20,29,2,2,True,0.33273172784356975
2025-01-08 15:48:39,Fail to pick,919,170,0,0,0,0,0,0,0,0,False,0
2025-01-08 15:48:39,persegiMerah,920,172,130,126,23,23,23,20,0,3,True,0.1623035131325112
2025-01-08 15:48:39,Fail to pick,920,172,0,0,0,0,0,0,0,0,False,0
2025-01-08 15:48:39,persegiMerah,909,172,127,129,125,91,127,87,2,4,True,0.33257253493514854
2025-01-08 15:48:40,persegiMerah,921,168,138,130,52,44,56,44,4,0,True,0.44981009957588713
2025-01-08 15:48:40,persegiMerah,921,172,135,128,87,64,86,63,1,1,True,0.26087404961589544
2025-01-08 15:48:40,Merah,921,172,tensor(135.1549),tensor(128.4885),152,85,153,82,1,3,True,0.0
2025-01-08 15:48:40,Fail to pick,921,172,0,0,0,0,0,0,0,0,False,0
2025-01-08 15:48:40,persegiMerah,916,176,132,129,33,41,30,45,3,4,True,0.4627833112761697
2025-01-08 15:48:40,Fail to pick,916,176,0,0,0,0,0,0,0,0,False,0
2025-01-08 15:48:40,persegiMerah,925,168,133,131,146,5,147,5,1,0,True,0.2988430229128233
2025-01-08 15:48:40,Fail to pick,925,168,0,0,0,0,0,0,0,0,False,0
2025-01-08 15:48:40,persegiMerah,920,170,134,129,37,94,34,90,3,4,True,0.3947821121562245
2025-01-08 15:48:40,Fail to pick,920,170,0,0,0,0,0,0,0,0,False,0
2025-01-08 15:48:40,persegiMerah,922,172,136,127,145,80,146,78,1,2,True,0.19999940958683882
2025-01-08 15:48:40,Fail to pick,922,172,0,0,0,0,0,0,0,0,False,0
2025-01-08 15:48:40,persegiMerah,921,174,130,126,195,85,197,83,2,2,False,0.3530430518762443
2025-01-08 15:48:40,Fail to pick,921,174,0,0,0,0,0,0,0,0,False,0
2025-01-08 15:48:40,persegiMerah,916,174,129,127,54,15,49,13,5,2,True,0.3895664724669686
2025-01-08 15:48:40,Fail to pick,916,174,0,0,0,0,0,0,0,0,False,0
2025-01-08 15:48:41,persegiMerah,923,168,132,130,93,21,95,21,2,0,True,0.2700066077714174
2025-01-08 15:48:41,Merah,923,168,tensor(132.9847),tensor(130.8909),153,85,154,82,1,3,True,0.0009088516235351562
2025-01-08 15:48:41,Fail to pick,923,168,0,0,0,0,0,0,0,0,False,0
2025-01-08 15:48:42,persegiMerah,962,537,116,99,96,72,98,68,2,4,True,0.4936385565008855
2025-01-08 15:48:42,persegiMerah,938,512,127,113,64,78,64,73,0,5,True,0.19737717493578952
2025-01-08 15:48:42,persegiMerah,946,512,130,111,76,9,76,7,0,2,True,0.42981875022267835
2025-01-08 15:48:42,Fail to pick,946,512,0,0,0,0,0,0,0,0,False,0
2025-01-08 15:48:42,persegiMerah,923,536,133,108,166,51,170,50,4,1,True,0.16017894135827368
2025-01-08 15:48:42,persegiMerah,939,537,130,103,2,78,1,75,1,3,True,0.15835210553687254
2025-01-08 15:48:42,persegiMerah,922,524,135,109,183,71,180,71,3,0,True,0.3436220898000346
2025-01-08 15:48:42,persegiMerah,919,541,134,111,158,13,157,17,1,4,False,0.25586076335117325
2025-01-08 15:48:43,persegiMerah,945,512,130,110,52,19,47,22,5,3,True,0.42413717383427374
2025-01-08 15:48:43,Merah,945,512,tensor(130.7040),tensor(110.4211),57,87,60,91,3,4,True,0.0005092620849609375
2025-01-08 15:48:43,persegiMerah,947,509,132,110,199,15,203,14,4,1,True,0.3186023425771606
2025-01-08 15:48:43,Fail to pick,947,509,0,0,0,0,0,0,0,0,False,0
2025-01-08 15:48:43,persegiMerah,945,513,132,111,54,69,57,71,3,2,True,0.37446275472032986
2025-01-08 15:48:43,Fail to pick,945,513,0,0,0,0,0,0,0,0,False,0
2025-01-08 15:48:43,persegiMerah,946,512,131,111,5,35,2,38,3,3,True,0.3058777361402597
2025-01-08 15:48:43,Fail to pick,946,512,0,0,0,0,0,0,0,0,False,0
2025-01-08 15:48:43,persegiMerah,914,497,128,114,60,94,61,91,1,3,True,0.14054327737781658
2025-01-08 15:48:43,persegiMerah,919,543,133,108,0,4,3,8,3,4,True,0.342604475161012
2025-01-08 15:48:43,persegiMerah,916,552,136,108,56,76,52,76,4,0,True,0.4903248035283799
2025-01-08 15:48:43,Fail to pick,916,552,0,0,0,0,0,0,0,0,False,0
2025-01-08 15:48:44,persegiMerah,947,509,132,108,23,67,24,70,1,3,True,0.42816580975291696
2025-01-08 15:48:44,persegiMerah,946,510,132,110,99,74,98,71,1,3,True,0.24859131132438816
2025-01-08 15:48:44,Merah,946,510,tensor(132.0883),tensor(110.9942),58,87,59,91,1,4,True,0.0
2025-01-08 15:48:44,Fail to pick,946,510,0,0,0,0,0,0,0,0,False,0
2025-01-08 15:48:44,persegiMerah,935,508,130,107,140,74,135,71,5,3,True,0.11927477790906829
2025-01-08 15:48:44,persegiMerah,941,511,130,110,57,6,54,5,3,1,True,0.2227760866594574
2025-01-08 15:48:44,Fail to pick,941,511,0,0,0,0,0,0,0,0,False,0
2025-01-08 15:48:44,persegiMerah,940,510,132,110,123,42,123,37,0,5,True,0.16253245729755098
2025-01-08 15:48:44,Fail to pick,940,510,0,0,0,0,0,0,0,0,False,0
2025-01-08 15:48:45,persegiMerah,944,505,131,108,3,77,3,79,0,2,True,0.4439330738774666
2025-01-08 15:48:45,Fail to pick,944,505,0,0,0,0,0,0,0,0,False,0
2025-01-08 15:48:45,persegiMerah,931,513,134,110,79,36,77,39,2,3,True,0.4525929400928662
2025-01-08 15:48:45,persegiMerah,941,511,127,111,56,63,52,61,4,2,True,0.17345268496044378
2025-01-08 15:48:45,Merah,941,511,tensor(127.8471),tensor(111.6519),58,87,57,86,1,1,True,0.0
2025-01-08 15:48:45,persegiMerah,938,510,130,109,154,12,157,16,3,4,False,0.30353951336326945
2025-01-08 15:48:45,Fail to pick,938,510,0,0,0,0,0,0,0,0,False,0
2025-01-08 15:48:45,persegiMerah,946,509,131,108,20,92,18,94,2,2,True,0.40716461004238447
2025-01-08 15:48:45,Fail to pick,946,509,0,0,0,0,0,0,0,0,False,0
2025-01-08 15:48:45,persegiMerah,947,509,133,109,108,80,105,82,3,2,True,0.24752986125000584
2025-01-08 15:48:45,Fail to pick,947,509,0,0,0,0,0,0,0,0,False,0
2025-01-08 15:48:45,persegiMerah,938,511,128,109,181,68,185,70,4,2,True,0.45754280413712234
2025-01-08 15:48:45,Fail to pick,938,511,0,0,0,0,0,0,0,0,False,0
2025-01-08 15:48:46,persegiMerah,945,509,130,107,80,64,82,63,2,1,True,0.3627121738336524
2025-01-08 15:48:46,Fail to pick,945,509,0,0,0,0,0,0,0,0,False,0
2025-01-08 15:48:46,persegiMerah,940,509,131,107,112,20,110,20,2,0,True,0.47116424484955777
2025-01-08 15:48:46,Fail to pick,940,509,0,0,0,0,0,0,0,0,False,0
2025-01-08 15:48:46,persegiMerah,940,512,129,109,130,83,133,86,3,3,True,0.12534023119005427
2025-01-08 15:48:46,Fail to pick,940,512,0,0,0,0,0,0,0,0,False,0
2025-01-08 15:48:46,persegiMerah,945,510,134,112,152,66,147,65,5,1,True,0.2003433452346362
2025-01-08 15:48:46,Fail to pick,945,510,0,0,0,0,0,0,0,0,False,0
2025-01-08 15:48:47,persegiMerah,920,502,137,114,177,64,174,68,3,4,True,0.28831575044471003
2025-01-08 15:48:47,Merah,920,502,tensor(137.0894),tensor(114.3974),60,85,62,80,2,5,True,0.0005018711090087891
2025-01-08 15:48:48,persegiMerah,939,517,128,112,79,1,79,-1,0,2,True,0.10100610264302134
2025-01-08 15:48:48,persegiMerah,938,518,127,116,109,14,111,14,2,0,True,0.3982378980675405
2025-01-08 15:48:48,Fail to pick,938,518,0,0,0,0,0,0,0,0,False,0
2025-01-08 15:48:48,persegiMerah,940,502,128,112,175,53,171,48,4,5,True,0.2329892626944946
2025-01-08 15:48:49,persegiMerah,945,510,127,113,41,10,44,6,3,4,True,0.11349354411066015
2025-01-08 15:48:49,Merah,945,510,tensor(127.0161),tensor(113.2642),58,87,57,85,1,2,True,0.0
2025-01-08 15:48:49,Fail to pick,945,510,0,0,0,0,0,0,0,0,False,0
2025-01-08 15:48:49,persegiMerah,943,509,125,111,37,18,33,13,4,5,True,0.4855024232821956
2025-01-08 15:48:49,Fail to pick,943,509,0,0,0,0,0,0,0,0,False,0
2025-01-08 15:48:49,persegiMerah,946,510,128,112,105,12,106,9,1,3,True,0.2859723785331282
2025-01-08 15:48:49,Fail to pick,946,510,0,0,0,0,0,0,0,0,False,0
2025-01-08 15:48:49,persegiMerah,945,511,125,111,91,77,91,79,0,2,True,0.3846487091968266
2025-01-08 15:48:49,Fail to pick,945,511,0,0,0,0,0,0,0,0,False,0
2025-01-08 15:48:49,persegiMerah,939,515,125,108,136,68,131,64,5,4,True,0.3997711649787036
2025-01-08 15:48:49,Fail to pick,939,515,0,0,0,0,0,0,0,0,False,0
2025-01-08 15:48:49,persegiMerah,947,539,129,109,55,87,59,86,4,1,True,0.28053224742436755
2025-01-08 15:48:49,persegiMerah,947,544,128,109,162,15,161,19,1,4,True,0.10305498262107769
2025-01-08 15:48:49,Fail to pick,947,544,0,0,0,0,0,0,0,0,False,0
2025-01-08 15:48:50,persegiMerah,940,549,124,106,50,63,50,63,0,0,True,0.11198869948262385
2025-01-08 15:48:50,Fail to pick,940,549,0,0,0,0,0,0,0,0,False,0
2025-01-08 15:48:50,persegiMerah,897,566,136,112,70,78,69,75,1,3,False,0.39536530161093764
2025-01-08 15:48:50,Merah,897,566,tensor(136.7623),tensor(112.7187),42,83,37,80,5,3,True,0.0
2025-01-08 15:48:52,persegiMerah,884,585,134,115,39,31,38,26,1,5,False,0.3344246169275391
2025-01-08 15:48:52,Merah,884,585,tensor(134.6656),tensor(115.7114),37,81,32,82,5,1,True,0.0004990100860595703
2025-01-08 15:48:52,persegiMerah,895,573,136,110,51,43,49,47,2,4,True,0.49854272122285903
2025-01-08 15:48:52,persegiMerah,900,570,136,109,184,53,184,54,0,1,True,0.42374375045028223
2025-01-08 15:48:52,Fail to pick,900,570,0,0,0,0,0,0,0,0,False,0
2025-01-08 15:48:52,persegiMerah,891,526,125,116,147,0,147,-1,0,1,True,0.20391141881371122
2025-01-08 15:48:53,persegiMerah,905,558,135,105,146,67,148,69,2,2,True,0.2652281676538455
2025-01-08 15:48:53,persegiMerah,904,559,137,105,185,74,181,76,4,2,True,0.45739632553603327
2025-01-08 15:48:53,Fail to pick,904,559,0,0,0,0,0,0,0,0,False,0
2025-01-08 15:48:53,persegiMerah,911,554,133,106,64,13,68,15,4,2,True,0.4496040202978593
2025-01-08 15:48:53,Fail to pick,911,554,0,0,0,0,0,0,0,0,False,0
2025-01-08 15:48:53,persegiMerah,945,536,129,106,66,13,62,15,4,2,True,0.3178109603560731
2025-01-08 15:48:53,persegiMerah,945,533,130,107,22,20,22,21,0,1,True,0.30806162176356167
2025-01-08 15:48:53,Fail to pick,945,533,0,0,0,0,0,0,0,0,False,0
2025-01-08 15:48:53,persegiMerah,939,551,130,106,145,21,144,21,1,0,True,0.37816004585466956
2025-01-08 15:48:53,Merah,939,551,tensor(130.9374),tensor(106.4565),46,86,47,83,1,3,True,0.0
2025-01-08 15:48:53,persegiMerah,907,556,134,108,23,56,18,55,5,1,True,0.22652459919478152
2025-01-08 15:48:53,persegiMerah,894,532,127,117,110,70,114,68,4,2,True,0.15620969994872036
2025-01-08 15:48:56,persegiMerah,498,503,144,134,132,92,132,93,0,1,True,0.37804299081380177
2025-01-08 15:48:56,Merah,498,503,tensor(144.6614),tensor(134.3693),60,46,56,42,4,4,True,0.0
2025-01-08 15:48:57,persegiMerah,500,507,149,132,83,5,83,7,0,2,True,0.4133601255216415
2025-01-08 15:48:57,Fail to pick,500,507,0,0,0,0,0,0,0,0,False,0
2025-01-08 15:49:06,persegiMerah,783,246,142,140,52,24,52,23,0,1,True,0.16555186299834668
2025-01-08 15:49:08,persegiMerah,819,214,136,129,127,56,124,51,3,5,True,0.22275662466017307
2025-01-08 15:49:08,Merah,819,214,tensor(136.8333),tensor(129.8346),140,75,135,71,5,4,True,0.0
2025-01-08 15:49:08,persegiMerah,792,209,132,133,84,53,85,53,1,0,True,0.17011994201647923
2025-01-08 15:49:08,persegiMerah,801,208,132,131,39,91,42,91,3,0,True,0.17956792939700336
2025-01-08 15:49:09,Fail to pick,801,208,0,0,0,0,0,0,0,0,False,0
2025-01-08 15:49:09,persegiMerah,791,204,127,132,16,65,11,65,5,0,True,0.23210922317973057
2025-01-08 15:49:09,persegiMerah,801,211,131,132,146,90,147,88,1,2,True,0.3687357774592285
2025-01-08 15:49:10,persegiMerah,797,210,132,134,79,3,80,0,1,3,True,0.36481995563017233
2025-01-08 15:49:10,Merah,797,210,tensor(132.5561),tensor(134.1529),141,73,145,76,4,3,True,0.0005040168762207031
2025-01-08 15:49:10,Fail to pick,797,210,0,0,0,0,0,0,0,0,False,0
2025-01-08 15:49:10,persegiMerah,756,248,141,142,25,67,23,62,2,5,True,0.40353063595360483
2025-01-08 15:49:10,persegiMerah,769,179,138,140,45,42,48,45,3,3,True,0.39278496090965
2025-01-08 15:49:11,persegiMerah,788,210,131,134,172,59,176,60,4,1,True,0.14983722455908965
2025-01-08 15:49:11,Merah,788,210,tensor(131.0441),tensor(134.4246),141,72,139,69,2,3,True,0.0004982948303222656
2025-01-08 15:49:11,persegiMerah,791,203,132,135,76,77,77,76,1,1,True,0.28405431601047626
2025-01-08 15:49:11,Fail to pick,791,203,0,0,0,0,0,0,0,0,False,0
2025-01-08 15:49:11,persegiMerah,804,206,132,133,0,9,4,12,4,3,True,0.11558141505091313
2025-01-08 15:49:11,persegiMerah,793,203,134,135,3,49,2,47,1,2,True,0.35616875608763177
2025-01-08 15:49:11,persegiMerah,795,213,131,132,197,47,194,43,3,4,True,0.12884584959115558
2025-01-08 15:49:11,persegiMerah,794,204,130,136,49,43,48,39,1,4,True,0.13158012547272557
2025-01-08 15:49:11,Fail to pick,794,204,0,0,0,0,0,0,0,0,False,0
2025-01-08 15:49:12,persegiMerah,793,209,132,134,199,7,201,11,2,4,True,0.22972878150095696
2025-01-08 15:49:12,Fail to pick,793,209,0,0,0,0,0,0,0,0,False,0
2025-01-08 15:49:12,persegiMerah,790,207,131,134,50,69,46,70,4,1,True,0.30178612814069133
2025-01-08 15:49:12,Fail to pick,790,207,0,0,0,0,0,0,0,0,False,0
2025-01-08 15:49:12,persegiMerah,789,205,130,136,71,52,66,56,5,4,True,0.39626917391434324
2025-01-08 15:49:12,Merah,789,205,tensor(130.0962),tensor(136.1966),143,73,139,70,4,3,True,0.0004990100860595703
2025-01-08 15:49:12,Fail to pick,789,205,0,0,0,0,0,0,0,0,False,0
2025-01-08 15:49:13,persegiMerah,792,207,131,133,192,64,191,59,1,5,True,0.47613673475357177
2025-01-08 15:49:13,Fail to pick,792,207,0,0,0,0,0,0,0,0,False,0
2025-01-08 15:49:13,persegiMerah,803,206,128,134,85,84,88,84,3,0,True,0.3402237706123149
2025-01-08 15:49:13,persegiMerah,801,204,134,134,52,40,55,42,3,2,True,0.13052534651530523
2025-01-08 15:49:13,Fail to pick,801,204,0,0,0,0,0,0,0,0,False,0
2025-01-08 15:49:13,persegiMerah,767,197,129,137,87,55,88,56,1,1,True,0.37710705538054345
2025-01-08 15:49:13,persegiMerah,796,207,131,135,50,93,46,88,4,5,True,0.4452687935517644
2025-01-08 15:49:13,Merah,796,207,tensor(131.7050),tensor(135.5569),142,73,142,69,0,4,True,0.0
2025-01-08 15:49:14,persegiMerah,790,218,134,136,27,75,27,71,0,4,True,0.41340375771594506
2025-01-08 15:49:14,persegiMerah,773,235,138,144,152,69,156,65,4,4,True,0.24915985678567718
2025-01-08 15:49:14,persegiMerah,820,232,137,138,7,78,2,74,5,4,True,0.1933238507658318
2025-01-08 15:49:14,persegiMerah,784,238,131,148,116,33,119,35,3,2,True,0.3946588941774066
2025-01-08 15:49:14,persegiMerah,781,233,131,144,88,93,87,89,1,4,True,0.39828025919025334
2025-01-08 15:49:14,Fail to pick,781,233,0,0,0,0,0,0,0,0,False,0
2025-01-08 15:49:15,persegiMerah,831,230,127,137,20,38,16,38,4,0,True,0.4767984560212084
2025-01-08 15:49:15,Merah,831,230,tensor(127.0389),tensor(137.5569),136,76,140,79,4,3,True,0.0
2025-01-08 15:49:15,persegiMerah,831,235,125,134,88,1,89,-3,1,4,True,0.11212769475800793
2025-01-08 15:49:15,Fail to pick,831,235,0,0,0,0,0,0,0,0,False,0
2025-01-08 15:49:15,persegiMerah,776,241,144,141,8,69,9,67,1,2,True,0.19081467466583263
2025-01-08 15:49:15,persegiMerah,823,223,133,139,36,66,33,64,3,2,True,0.1189201923979006
2025-01-08 15:52:28,persegiMerah,781,194,138,125,170,58,172,57,2,1,True,0.47909198849301227
2025-01-08 15:52:28,Merah,781,194,tensor(138.9130),tensor(125.8582),146,72,144,75,2,3,True,0.0004987716674804688
2025-01-08 15:52:29,persegiMerah,750,188,127,129,43,91,39,92,4,1,True,0.396755210894848
2025-01-08 15:52:29,persegiMerah,752,198,123,128,25,21,27,22,2,1,True,0.11622057576212264
2025-01-08 15:52:29,persegiMerah,824,228,135,130,152,72,151,67,1,5,True,0.3141251186031029
2025-01-08 15:52:29,persegiMerah,761,196,133,131,183,76,186,76,3,0,True,0.2538475264057894
2025-01-08 15:52:29,Merah,761,196,tensor(133.8162),tensor(131.6497),145,70,141,70,4,0,True,0.0
2025-01-08 15:52:29,persegiMerah,763,193,133,135,40,43,38,45,2,2,True,0.42948165486940026
2025-01-08 15:52:29,Fail to pick,763,193,0,0,0,0,0,0,0,0,False,0
2025-01-08 15:52:29,persegiMerah,755,203,126,128,40,50,36,45,4,5,True,0.23777347497764445
2025-01-08 15:52:30,persegiMerah,762,180,132,138,196,90,193,89,3,1,True,0.1939747516805762
2025-01-08 15:52:30,persegiMerah,764,189,129,133,52,18,52,18,0,0,True,0.20643180206910908
2025-01-08 15:52:30,Fail to pick,764,189,0,0,0,0,0,0,0,0,False,0
2025-01-08 15:52:30,persegiMerah,709,208,145,145,3,33,-1,34,4,1,True,0.2353063159408023
2025-01-08 15:52:30,persegiMerah,762,200,126,128,6,4,9,-1,3,5,False,0.28431317875134565
2025-01-08 15:52:30,persegiMerah,758,187,132,135,90,88,86,86,4,2,True,0.4979834980716974
2025-01-08 15:52:30,Merah,758,187,tensor(132.4659),tensor(135.0928),148,70,152,74,4,4,True,0.0
2025-01-08 15:52:30,persegiMerah,759,189,131,136,13,80,9,80,4,0,True,0.2578006162622653
2025-01-08 15:52:30,Fail to pick,759,189,0,0,0,0,0,0,0,0,False,0
2025-01-08 15:52:30,persegiMerah,746,211,125,126,40,38,41,42,1,4,True,0.36970473948020466
2025-01-08 15:52:31,persegiMerah,713,205,143,144,142,11,137,14,5,3,True,0.4155905817373803
2025-01-08 15:52:31,persegiMerah,758,180,134,139,87,27,89,22,2,5,True,0.46108796758850856
2025-01-08 15:52:31,persegiMerah,758,179,130,135,140,37,142,32,2,5,True,0.331902996375513
2025-01-08 15:52:31,Merah,758,179,tensor(130.0353),tensor(135.0846),150,70,151,65,1,5,True,0.000499725341796875
2025-01-08 15:52:31,Fail to pick,758,179,0,0,0,0,0,0,0,0,False,0
2025-01-08 15:52:31,persegiMerah,761,193,127,132,6,1,8,-4,2,5,True,0.19632863018181995
2025-01-08 15:52:31,persegiMerah,757,181,133,137,81,46,76,48,5,2,True,0.25185267096749964
2025-01-08 15:52:32,persegiMerah,761,176,133,136,185,66,188,69,3,3,True,0.29558044408818823
2025-01-08 15:52:32,Fail to pick,761,176,0,0,0,0,0,0,0,0,False,0
2025-01-08 15:52:38,persegiBiru,735,506,122,103,128,34,127,38,1,4,True,0.3052967914861356
2025-01-08 15:52:38,Biru,735,506,tensor(122.3577),tensor(103.5091),59,68,61,67,2,1,True,0.0005002021789550781
2025-01-08 15:52:39,persegiKuning,762,517,122,100,172,93,176,89,4,4,True,0.25007880544954697
2025-01-08 15:52:39,persegiKuning,746,488,114,105,71,78,71,82,0,4,False,0.2526345579686798
2025-01-08 15:52:39,persegiBiru,769,507,121,101,81,24,85,27,4,3,True,0.18286431706116338
2025-01-08 15:52:40,persegiBiru,725,488,120,109,102,72,105,71,3,1,True,0.261516513033225
2025-01-08 15:52:40,persegiBiru,744,500,124,106,58,35,59,31,1,4,True,0.38423349638361937
2025-01-08 15:52:40,Biru,744,500,tensor(124.4500),tensor(106.3435),61,68,56,67,5,1,True,0.0
2025-01-08 15:52:40,persegiBiru,737,490,122,109,97,13,92,11,5,2,True,0.15113114362482727
2025-01-08 15:52:40,persegiBiru,750,503,122,108,149,79,146,81,3,2,True,0.30038582239111355
2025-01-08 15:52:41,persegiBiru,752,504,122,107,57,32,58,33,1,1,True,0.2760622617945723
2025-01-08 15:52:41,Fail to pick,752,504,0,0,0,0,0,0,0,0,False,0
2025-01-08 15:52:41,persegiBiru,757,495,122,107,77,81,77,85,0,4,True,0.25021892258249673
2025-01-08 15:52:41,Fail to pick,757,495,0,0,0,0,0,0,0,0,False,0
2025-01-08 15:52:41,persegiBiru,742,488,118,109,28,36,25,39,3,3,True,0.26634917630459337
2025-01-08 15:52:41,Biru,742,488,tensor(118.7449),tensor(109.9409),64,68,66,71,2,3,True,0.0
2025-01-08 15:52:41,persegiBiru,754,506,123,106,1,47,1,51,0,4,True,0.36868184751110744
2025-01-08 15:52:41,persegiBiru,734,481,126,111,33,26,29,29,4,3,False,0.2770979154926885
2025-01-08 15:52:42,persegiBiru,737,487,123,109,15,26,13,29,2,3,True,0.43221996262100404
2025-01-08 15:52:42,Fail to pick,737,487,0,0,0,0,0,0,0,0,False,0
2025-01-08 15:52:42,persegiBiru,735,485,126,112,169,29,173,30,4,1,True,0.13389543898118755
2025-01-08 15:52:42,Biru,735,485,tensor(126.4474),tensor(112.9696),65,68,65,71,0,3,True,0.0
2025-01-08 15:52:42,Fail to pick,735,485,0,0,0,0,0,0,0,0,False,0
2025-01-08 15:52:42,persegiBiru,713,482,123,113,129,97,133,94,4,3,True,0.2658692217483657
2025-01-08 15:52:43,persegiBiru,755,504,120,109,133,57,134,53,1,4,True,0.46131048251730655
2025-01-08 15:52:43,Biru,755,504,tensor(120.1404),tensor(109.5609),60,69,56,68,4,1,True,0.0
2025-01-08 15:52:45,persegiBiru,739,485,125,116,148,11,145,10,3,1,True,0.22209913858964098
2025-01-08 15:52:45,Biru,739,485,tensor(125.2330),tensor(116.4851),65,68,67,72,2,4,True,0.0004944801330566406
2025-01-08 15:52:45,persegiBiru,762,494,129,111,37,28,40,29,3,1,True,0.1328415096369799
2025-01-08 15:52:46,persegiBiru,759,503,121,108,149,90,150,91,1,1,False,0.2902947081999472
2025-01-08 15:52:46,Fail to pick,759,503,0,0,0,0,0,0,0,0,False,0
2025-01-08 15:52:46,persegiBiru,733,492,118,114,133,88,132,90,1,2,True,0.22750372648814615
2025-01-08 15:52:46,persegiBiru,761,495,128,110,69,9,68,6,1,3,True,0.13820553824572868
2025-01-08 15:52:46,Biru,761,495,tensor(128.8980),tensor(110.5864),62,70,58,65,4,5,True,0.0
2025-01-08 15:52:46,persegiBiru,760,495,125,109,33,61,28,63,5,2,True,0.40667042375068374
2025-01-08 15:52:46,Fail to pick,760,495,0,0,0,0,0,0,0,0,False,0
2025-01-08 15:52:46,persegiBiru,761,501,123,111,136,30,131,27,5,3,True,0.2496958609562146
2025-01-08 15:52:46,Fail to pick,761,501,0,0,0,0,0,0,0,0,False,0
2025-01-08 15:52:47,persegiBiru,756,498,121,110,131,1,133,0,2,1,True,0.46115108673409455
2025-01-08 15:52:47,Biru,756,498,tensor(121.8683),tensor(110.2821),61,70,65,72,4,2,True,0.0
2025-01-08 15:52:47,Fail to pick,756,498,0,0,0,0,0,0,0,0,False,0
2025-01-08 15:52:49,persegiBiru,754,494,126,111,55,81,53,79,2,2,True,0.28854232402893
2025-01-08 15:52:49,Biru,754,494,tensor(126.5062),tensor(111.3521),62,69,59,64,3,5,True,0.0004951953887939453
2025-01-08 15:52:49,Fail to pick,754,494,0,0,0,0,0,0,0,0,False,0
2025-01-08 15:52:49,persegiBiru,749,490,128,110,54,97,50,92,4,5,True,0.4435049301150539
2025-01-08 15:52:49,Fail to pick,749,490,0,0,0,0,0,0,0,0,False,0
2025-01-08 15:52:49,persegiBiru,749,486,126,115,118,40,114,44,4,4,True,0.3519123148314931
2025-01-08 15:52:49,Fail to pick,749,486,0,0,0,0,0,0,0,0,False,0
2025-01-08 15:52:50,persegiBiru,764,501,121,108,192,46,189,44,3,2,True,0.3614571931021222
2025-01-08 15:52:50,Biru,764,501,tensor(121.4545),tensor(108.2029),60,70,62,70,2,0,True,0.00030541419982910156
2025-01-08 15:52:51,persegiBiru,740,486,122,114,81,14,76,11,5,3,True,0.3722488776880629
2025-01-08 15:52:51,persegiBiru,731,528,125,115,118,61,114,63,4,2,True,0.12871227023292708
2025-01-08 15:52:54,persegiMerah,845,182,131,130,193,26,190,25,3,1,True,0.24464898215192146
2025-01-08 15:52:54,Merah,845,182,tensor(131.5291),tensor(130.5731),149,78,146,73,3,5,True,0.0
2025-01-08 15:52:54,persegiMerah,894,217,132,130,189,61,193,64,4,3,True,0.13612515315810603
2025-01-08 15:52:54,persegiMerah,824,225,135,133,179,57,178,55,1,2,True,0.4779614549965455
2025-01-08 15:52:55,persegiMerah,885,228,130,130,159,48,159,47,0,1,True,0.496064542447073
2025-01-08 15:52:55,persegiMerah,891,230,133,132,87,43,88,44,1,1,True,0.12336493573076157
2025-01-08 15:52:55,Merah,891,230,tensor(133.1415),tensor(132.8369),136,82,136,82,0,0,True,0.0004985332489013672
2025-01-08 15:52:55,Fail to pick,891,230,0,0,0,0,0,0,0,0,False,0
2025-01-08 15:52:55,persegiMerah,893,236,133,134,141,39,144,42,3,3,True,0.36118691441888695
2025-01-08 15:52:55,Fail to pick,893,236,0,0,0,0,0,0,0,0,False,0
2025-01-08 15:52:55,persegiMerah,895,234,131,136,171,77,175,73,4,4,True,0.28176089987745845
2025-01-08 15:52:55,Fail to pick,895,234,0,0,0,0,0,0,0,0,False,0
2025-01-08 15:52:55,persegiMerah,899,230,134,132,55,8,56,8,1,0,True,0.2225070501006326
2025-01-08 15:52:55,Fail to pick,899,230,0,0,0,0,0,0,0,0,False,0
2025-01-08 15:52:56,persegiMerah,896,237,131,132,38,39,33,35,5,4,False,0.14580202946279697
2025-01-08 15:52:56,Fail to pick,896,237,0,0,0,0,0,0,0,0,False,0
2025-01-08 15:52:59,persegiMerah,913,230,122,131,153,49,150,48,3,1,True,0.31196064471235935
2025-01-08 15:52:59,Merah,913,230,tensor(122.3433),tensor(131.1397),136,84,131,79,5,5,True,0.0005860328674316406
2025-01-08 15:53:00,persegiMerah,857,188,124,129,37,67,40,69,3,2,False,0.44011373575703483
2025-01-08 15:53:00,persegiMerah,827,181,113,128,121,26,118,29,3,3,True,0.22901886743879923
2025-01-08 15:53:00,Merah,827,181,tensor(113.8714),tensor(128.2620),149,76,149,74,0,2,True,0.0005037784576416016
2025-01-08 15:53:02,persegiMerah,902,220,132,138,33,4,35,4,2,0,True,0.2763330689427799
2025-01-08 15:53:02,Merah,902,220,tensor(132.2553),tensor(138.3060),138,83,134,80,4,3,True,0.0
2025-01-08 15:53:02,persegiMerah,897,234,139,134,17,21,18,18,1,3,True,0.37552942440731196
2025-01-08 15:53:02,persegiMerah,882,231,140,138,179,69,176,67,3,2,True,0.13513811886356952
2025-01-08 15:53:03,persegiMerah,892,225,141,132,66,37,64,39,2,2,True,0.2526053327916609
2025-01-08 15:55:38,persegiMerah,844,217,137,136,15,89,14,86,1,3,True,0.4764096551058036
2025-01-08 15:55:38,Merah,844,217,tensor(137.9877),tensor(136.8238),139,78,139,82,0,4,True,0.000499725341796875
2025-01-08 15:55:39,persegiMerah,850,215,136,138,54,15,50,10,4,5,True,0.49445271139253777
2025-01-08 15:55:39,Fail to pick,850,215,0,0,0,0,0,0,0,0,False,0
2025-01-08 15:55:39,persegiMerah,848,214,138,136,135,52,135,48,0,4,True,0.3064571652176252
2025-01-08 15:55:39,Fail to pick,848,214,0,0,0,0,0,0,0,0,False,0
2025-01-08 15:55:39,persegiMerah,863,206,132,133,28,28,27,24,1,4,False,0.10843308727552509
2025-01-08 15:55:39,persegiMerah,855,209,133,134,124,27,120,29,4,2,False,0.4650679810822822
2025-01-08 15:55:39,Fail to pick,855,209,0,0,0,0,0,0,0,0,False,0
2025-01-08 15:55:39,persegiMerah,788,181,127,135,109,64,105,60,4,4,True,0.2316884828232676
2025-01-08 15:55:39,persegiMerah,840,219,136,134,110,27,113,24,3,3,True,0.44687312813006974
2025-01-08 15:55:39,persegiMerah,847,217,137,133,173,33,172,37,1,4,True,0.4913041532952874
2025-01-08 15:55:39,Fail to pick,847,217,0,0,0,0,0,0,0,0,False,0
2025-01-08 15:55:39,persegiMerah,786,188,132,139,167,62,163,61,4,1,True,0.3199546049995148
2025-01-08 15:55:40,persegiMerah,805,170,130,135,124,87,127,90,3,3,True,0.1429189334465154
2025-01-08 15:55:40,Merah,805,170,tensor(130.5736),tensor(135.5576),152,74,153,76,1,2,True,0.0
2025-01-08 15:55:40,persegiMerah,792,191,138,138,126,15,123,13,3,2,True,0.22730834341929482
2025-01-08 15:55:40,persegiMerah,804,171,131,131,60,70,60,69,0,1,True,0.13266824675745445
2025-01-08 15:55:40,persegiMerah,846,211,142,134,7,37,2,40,5,3,False,0.29340163373279854
2025-01-08 15:55:40,persegiMerah,798,177,135,136,155,19,157,22,2,3,True,0.23367288559395913
2025-01-08 15:55:40,persegiMerah,811,182,118,127,100,88,99,88,1,0,True,0.29442146890604004
2025-01-08 15:55:40,persegiMerah,848,215,135,134,134,5,130,5,4,0,True,0.18712448094039016
2025-01-08 15:55:40,persegiMerah,790,189,125,137,119,87,117,91,2,4,True,0.262045988419666
2025-01-08 15:55:40,persegiMerah,806,167,127,134,75,11,73,14,2,3,True,0.4780363061555756
2025-01-08 15:55:40,persegiMerah,804,175,127,133,74,42,70,44,4,2,True,0.4457136545777808
2025-01-08 15:55:40,Fail to pick,804,175,0,0,0,0,0,0,0,0,False,0
2025-01-08 15:55:41,persegiMerah,849,213,137,137,127,93,122,95,5,2,False,0.4723279356474974
2025-01-08 15:55:41,Merah,849,213,tensor(137.4510),tensor(137.4977),140,78,138,76,2,2,True,0.0
2025-01-08 15:55:41,persegiMerah,853,209,136,135,118,7,121,4,3,3,True,0.410624026921766
2025-01-08 15:55:41,Fail to pick,853,209,0,0,0,0,0,0,0,0,False,0
2025-01-08 15:55:41,persegiMerah,848,218,139,138,19,37,17,34,2,3,True,0.21980994424048897
2025-01-08 15:55:41,Fail to pick,848,218,0,0,0,0,0,0,0,0,False,0
2025-01-08 15:55:41,persegiMerah,793,173,133,133,160,64,156,62,4,2,True,0.16458560581246334
2025-01-08 15:55:41,persegiMerah,783,187,133,136,117,21,117,19,0,2,True,0.41366740108862343
2025-01-08 15:55:41,persegiMerah,807,180,124,130,10,38,9,38,1,0,True,0.36590763464124154
2025-01-08 15:55:41,persegiMerah,805,183,133,137,107,84,110,87,3,3,True,0.41198897905863596
2025-01-08 15:55:41,Fail to pick,805,183,0,0,0,0,0,0,0,0,False,0
2025-01-08 15:55:41,persegiMerah,851,214,139,135,30,54,29,56,1,2,True,0.42569730607503486
2025-01-08 15:55:48,persegiMerah,848,146,119,134,179,34,181,37,2,3,True,0.14198889179167595
2025-01-08 15:55:48,Merah,848,146,tensor(119.4897),tensor(134.5648),159,78,161,73,2,5,True,0.0004887580871582031
2025-01-08 15:55:48,persegiMerah,812,170,127,127,66,11,68,13,2,2,True,0.21421759859764078
2025-01-08 15:55:48,persegiMerah,815,163,126,133,38,25,41,20,3,5,True,0.10578401770908759
2025-01-08 15:55:48,Fail to pick,815,163,0,0,0,0,0,0,0,0,False,0
2025-01-08 15:55:49,persegiMerah,813,165,128,127,152,27,148,27,4,0,True,0.1760471201297792
2025-01-08 15:55:49,Fail to pick,813,165,0,0,0,0,0,0,0,0,False,0
2025-01-08 15:55:49,persegiMerah,814,166,121,127,87,84,87,82,0,2,True,0.1561710248701838
2025-01-08 15:55:49,Fail to pick,814,166,0,0,0,0,0,0,0,0,False,0
2025-01-08 15:55:49,persegiMerah,811,153,126,133,147,24,145,25,2,1,False,0.37632966600021267
2025-01-08 15:55:49,Merah,811,153,tensor(126.2656),tensor(133.2712),157,75,156,74,1,1,True,0.0005002021789550781
2025-01-08 15:55:50,persegiMerah,852,213,130,136,159,15,158,13,1,2,True,0.2284732206560202
2025-01-08 15:55:50,persegiMerah,846,215,137,137,164,94,160,97,4,3,True,0.13449465521454376
2025-01-08 15:55:50,Fail to pick,846,215,0,0,0,0,0,0,0,0,False,0
2025-01-08 15:55:50,persegiMerah,807,157,125,131,72,76,75,75,3,1,True,0.14600325402830952
2025-01-08 15:55:50,persegiMerah,813,161,127,136,109,83,113,84,4,1,True,0.2821512250171784
2025-01-08 15:55:50,Fail to pick,813,161,0,0,0,0,0,0,0,0,False,0
2025-01-08 15:55:56,persegiMerah,905,403,137,129,175,7,170,6,5,1,True,0.1627444127134573
2025-01-08 15:55:56,Merah,905,403,tensor(137.3456),tensor(129.7666),88,83,90,87,2,4,True,0.0
2025-01-08 15:55:56,persegiMerah,901,381,138,129,171,54,166,57,5,3,True,0.23094920818128284
2025-01-08 15:55:56,persegiMerah,893,397,137,128,65,24,65,24,0,0,True,0.2725997353499495
2025-01-08 15:55:56,persegiMerah,899,385,138,121,15,5,15,8,0,3,True,0.39431997149895637
2025-01-08 15:55:56,persegiMerah,902,386,139,123,5,34,6,31,1,3,True,0.39185839820562507
2025-01-08 15:55:56,Fail to pick,902,386,0,0,0,0,0,0,0,0,False,0
2025-01-08 15:55:56,persegiMerah,898,392,138,125,50,34,52,30,2,4,True,0.4262459685231845
2025-01-08 15:55:56,Fail to pick,898,392,0,0,0,0,0,0,0,0,False,0
2025-01-08 15:55:56,persegiMerah,902,393,136,121,186,31,187,27,1,4,True,0.13058709070836164
2025-01-08 15:55:56,Fail to pick,902,393,0,0,0,0,0,0,0,0,False,0
2025-01-08 15:55:57,persegiMerah,898,398,136,122,20,77,23,77,3,0,True,0.29449538791290975
2025-01-08 15:55:57,Fail to pick,898,398,0,0,0,0,0,0,0,0,False,0
2025-01-08 15:55:57,persegiMerah,893,398,139,122,147,67,146,66,1,1,True,0.2200971563460196
2025-01-08 15:55:57,Fail to pick,893,398,0,0,0,0,0,0,0,0,False,0
2025-01-08 15:55:57,persegiMerah,893,400,135,123,145,8,149,8,4,0,True,0.1200473678445515
2025-01-08 15:55:57,Fail to pick,893,400,0,0,0,0,0,0,0,0,False,0
2025-01-08 15:55:57,persegiMerah,890,403,138,123,7,90,3,93,4,3,True,0.3307767081432374
2025-01-08 15:55:57,Fail to pick,890,403,0,0,0,0,0,0,0,0,False,0
2025-01-08 15:55:57,persegiMerah,895,403,135,122,36,74,34,77,2,3,True,0.33526653586439814
2025-01-08 15:55:57,Merah,895,403,tensor(135.2937),tensor(122.8363),88,82,91,86,3,4,True,0.0005068778991699219
2025-01-08 15:55:57,Fail to pick,895,403,0,0,0,0,0,0,0,0,False,0
2025-01-08 15:55:57,persegiMerah,894,403,136,123,167,52,168,52,1,0,True,0.22246280347122538
2025-01-08 15:55:57,Fail to pick,894,403,0,0,0,0,0,0,0,0,False,0
2025-01-08 15:55:57,persegiMerah,895,400,135,121,111,71,107,75,4,4,True,0.3914056886490944
2025-01-08 15:55:57,Fail to pick,895,400,0,0,0,0,0,0,0,0,False,0
2025-01-08 15:55:58,persegiMerah,890,402,137,124,29,43,25,42,4,1,True,0.2492451612806097
2025-01-08 15:55:58,Fail to pick,890,402,0,0,0,0,0,0,0,0,False,0
2025-01-08 15:55:58,persegiMerah,906,402,136,124,90,13,86,9,4,4,True,0.4477878573105678
2025-01-08 15:55:58,persegiMerah,908,413,130,126,97,90,95,86,2,4,True,0.4502606985751365
2025-01-08 15:58:27,persegiMerah,887,398,134,136,32,2,27,0,5,2,True,0.3760757557721438
2025-01-08 15:58:27,Merah,887,398,tensor(134.4545),tensor(136.4124),89,82,86,82,3,0,True,0.0
2025-01-08 15:58:28,persegiMerah,882,406,138,126,135,25,133,22,2,3,True,0.29650566844163584
2025-01-08 15:58:28,Fail to pick,882,406,0,0,0,0,0,0,0,0,False,0
2025-01-08 15:58:28,persegiMerah,879,414,141,126,169,95,164,91,5,4,True,0.2730049593850064
2025-01-08 15:58:28,Fail to pick,879,414,0,0,0,0,0,0,0,0,False,0
2025-01-08 15:58:28,persegiMerah,895,395,134,130,10,41,7,36,3,5,True,0.3981480640075219
2025-01-08 15:58:28,persegiMerah,887,405,137,124,73,40,72,36,1,4,True,0.13914497460684477
2025-01-08 15:58:28,persegiMerah,882,408,140,125,98,61,95,62,3,1,True,0.4063021969109588
2025-01-08 15:58:28,Fail to pick,882,408,0,0,0,0,0,0,0,0,False,0
2025-01-08 15:58:28,persegiMerah,919,385,134,126,35,45,34,40,1,5,True,0.4440175424603241
2025-01-08 15:58:28,persegiMerah,879,365,128,125,130,45,134,47,4,2,True,0.3946108598357707
2025-01-08 15:58:28,persegiMerah,884,364,130,127,123,11,119,6,4,5,True,0.4593528687544096
2025-01-08 15:58:28,Fail to pick,884,364,0,0,0,0,0,0,0,0,False,0
2025-01-08 15:58:29,persegiMerah,880,414,136,124,114,85,114,87,0,2,True,0.14999469816670905
2025-01-08 15:58:29,Merah,880,414,tensor(136.4964),tensor(124.1969),85,81,87,82,2,1,True,0.0004992485046386719
2025-01-08 15:58:29,persegiMerah,852,395,139,128,119,69,117,70,2,1,True,0.11857776996696674
2025-01-08 15:58:29,persegiMerah,854,391,140,129,7,55,6,52,1,3,True,0.3205464484867951
2025-01-08 15:58:29,Fail to pick,854,391,0,0,0,0,0,0,0,0,False,0
2025-01-08 15:58:29,persegiMerah,891,405,141,127,131,73,129,70,2,3,True,0.14453642859660737
2025-01-08 15:58:29,persegiMerah,900,385,134,125,28,13,30,16,2,3,True,0.35983554408724994
2025-01-08 15:58:29,persegiMerah,846,395,139,130,169,12,169,10,0,2,False,0.4277102061713137
2025-01-08 15:59:23,persegiMerah,871,218,135,131,127,72,130,68,3,4,True,0.15816299081227708
2025-01-08 15:59:23,persegiMerah,784,230,137,135,179,58,175,54,4,4,True,0.3660712157293583
2025-01-08 15:59:23,Merah,784,230,tensor(137.1356),tensor(135.9566),136,72,140,67,4,5,True,0.0004978179931640625
2025-01-08 15:59:23,persegiMerah,790,203,136,140,4,1,3,4,1,3,True,0.2848066492535195
2025-01-08 15:59:23,persegiMerah,862,219,129,137,28,17,27,20,1,3,True,0.23724015704152826
2025-01-08 15:59:23,persegiMerah,853,222,139,132,187,38,185,35,2,3,True,0.14224252438613574
2025-01-08 15:59:23,Fail to pick,853,222,0,0,0,0,0,0,0,0,False,0
2025-01-08 15:59:23,persegiMerah,826,209,125,130,36,78,31,75,5,3,True,0.3107058831646873
2025-01-08 15:59:23,persegiMerah,873,218,133,127,56,34,55,32,1,2,False,0.30362530898489515
2025-01-08 15:59:24,persegiMerah,822,194,130,137,17,38,18,42,1,4,True,0.4075701335703761
2025-01-08 15:59:24,persegiMerah,858,217,130,133,13,4,11,6,2,2,True,0.17000841896768565
2025-01-08 15:59:24,Merah,858,217,tensor(130.8406),tensor(133.4231),139,79,142,82,3,3,True,0.0
2025-01-08 15:59:24,persegiMerah,827,202,128,132,187,37,190,32,3,5,True,0.41496258435106725
2025-01-08 15:59:24,persegiMerah,859,224,132,135,137,56,136,54,1,2,True,0.17879975952766616
2025-01-08 15:59:24,persegiMerah,826,210,120,127,51,82,51,81,0,1,True,0.11201926585765541
2025-01-08 16:00:10,persegiKuning,911,217,120,151,32,18,31,17,1,1,True,0.25908968544623556
2025-01-08 16:00:10,Kuning,911,217,tensor(120.8575),tensor(151.4334),139,84,135,85,4,1,True,0.0004978179931640625
2025-01-08 16:00:10,persegiMerah,856,223,124,144,82,58,86,60,4,2,True,0.4117602926521672
2025-01-08 16:00:10,persegiMerah,856,219,130,142,7,61,5,60,2,1,True,0.41559823644982263
2025-01-08 16:00:10,Fail to pick,856,219,0,0,0,0,0,0,0,0,False,0
2025-01-08 16:00:11,persegiMerah,846,215,123,148,101,76,98,76,3,0,True,0.47379638474685737
2025-01-08 16:00:11,Merah,846,215,tensor(123.4990),tensor(148.2866),140,78,136,82,4,4,True,0.0004966259002685547
2025-01-08 16:00:11,persegiMerah,853,216,128,141,11,1,14,4,3,3,True,0.4940457472797749
2025-01-08 16:00:11,Fail to pick,853,216,0,0,0,0,0,0,0,0,False,0
2025-01-08 16:00:19,persegiMerah,917,466,118,117,113,2,117,4,4,2,True,0.13689158455106068
2025-01-08 16:00:19,Merah,917,466,tensor(118.9008),tensor(117.1942),70,84,74,84,4,0,True,0.0
2025-01-08 16:00:23,persegiMerah,917,460,120,120,192,65,193,65,1,0,True,0.3355314475938629
2025-01-08 16:00:23,Fail to pick,917,460,0,0,0,0,0,0,0,0,False,0
2025-01-08 16:00:33,persegiMerah,927,465,120,120,15,56,14,60,1,4,True,0.48297121053584346
2025-01-08 16:00:33,Merah,927,465,tensor(120.8155),tensor(120.6498),70,85,74,88,4,3,True,0.0
2025-01-08 16:00:33,persegiMerah,919,465,116,120,95,99,93,98,2,1,True,0.26913758429216683
2025-01-08 16:00:33,Fail to pick,919,465,0,0,0,0,0,0,0,0,False,0
2025-01-08 16:00:34,persegiMerah,922,468,121,124,189,2,191,-3,2,5,True,0.22106024244303743
2025-01-08 16:00:34,Fail to pick,922,468,0,0,0,0,0,0,0,0,False,0
2025-01-08 16:00:35,persegiMerah,895,495,128,124,52,93,50,93,2,0,False,0.33122233079295094
2025-01-08 16:00:35,Merah,895,495,tensor(128.4115),tensor(124.9051),62,82,58,78,4,4,True,0.0004985332489013672
2025-01-08 16:00:35,persegiMerah,899,491,124,125,142,9,146,6,4,3,True,0.13647738739127624
2025-01-08 16:00:35,Fail to pick,899,491,0,0,0,0,0,0,0,0,False,0
2025-01-08 16:00:36,persegiMerah,892,487,125,129,147,24,149,19,2,5,True,0.23529541345245436
2025-01-08 16:00:36,Merah,892,487,tensor(125.9999),tensor(129.2235),64,82,64,82,0,0,True,0.0004990100860595703
2025-01-08 16:00:36,Fail to pick,892,487,0,0,0,0,0,0,0,0,False,0
2025-01-08 16:00:36,persegiMerah,894,487,127,129,50,72,54,70,4,2,True,0.3873166533528464
2025-01-08 16:00:36,Fail to pick,894,487,0,0,0,0,0,0,0,0,False,0
2025-01-08 16:00:36,persegiMerah,899,493,128,124,159,91,158,89,1,2,True,0.20676176648765307
2025-01-08 16:00:36,Fail to pick,899,493,0,0,0,0,0,0,0,0,False,0
2025-01-08 16:00:37,persegiMerah,896,479,130,127,12,30,8,26,4,4,True,0.19583628081840498
2025-01-08 16:00:37,persegiMerah,895,486,130,125,156,18,160,16,4,2,True,0.46946571003134363
2025-01-08 16:00:37,Fail to pick,895,486,0,0,0,0,0,0,0,0,False,0
2025-01-08 16:00:37,persegiMerah,895,493,129,120,163,91,163,87,0,4,True,0.37999190752605005
2025-01-08 16:00:37,Fail to pick,895,493,0,0,0,0,0,0,0,0,False,0
2025-01-08 16:00:47,persegiMerah,903,483,124,129,29,56,27,54,2,2,True,0.10494472506774484
2025-01-08 16:00:47,Merah,903,483,tensor(124.8299),tensor(129.8904),65,83,69,82,4,1,True,0.0
2025-01-08 16:00:47,persegiMerah,898,493,130,127,85,57,82,54,3,3,True,0.47976968413737
2025-01-08 16:00:47,persegiMerah,905,494,130,127,114,44,116,40,2,4,True,0.3816651525757633
2025-01-08 16:00:47,Fail to pick,905,494,0,0,0,0,0,0,0,0,False,0
2025-01-08 16:00:47,persegiMerah,905,490,126,130,42,69,42,68,0,1,True,0.3388857514121022
2025-01-08 16:00:47,Fail to pick,905,490,0,0,0,0,0,0,0,0,False,0
2025-01-08 16:00:47,persegiMerah,905,490,126,130,24,3,27,-1,3,4,True,0.3208495135376951
2025-01-08 16:00:47,Fail to pick,905,490,0,0,0,0,0,0,0,0,False,0
2025-01-08 16:00:47,persegiMerah,911,489,124,123,143,3,146,-2,3,5,True,0.18117819148679432
2025-01-08 16:00:47,Fail to pick,911,489,0,0,0,0,0,0,0,0,False,0
2025-01-08 16:00:47,persegiMerah,895,500,131,128,88,27,85,27,3,0,True,0.2668886499323009
2025-01-08 16:00:48,persegiMerah,903,493,132,128,157,30,158,30,1,0,True,0.44878132873722243
2025-01-08 16:00:48,Fail to pick,903,493,0,0,0,0,0,0,0,0,False,0
2025-01-08 16:00:48,persegiMerah,897,494,131,127,129,91,126,89,3,2,True,0.2773337200507465
2025-01-08 16:00:48,Merah,897,494,tensor(131.1376),tensor(127.0626),62,83,58,78,4,5,True,0.0
2025-01-08 16:00:48,Fail to pick,897,494,0,0,0,0,0,0,0,0,False,0
2025-01-08 16:00:48,persegiMerah,903,491,131,126,169,30,172,33,3,3,True,0.3225502367084334
2025-01-08 16:00:48,Fail to pick,903,491,0,0,0,0,0,0,0,0,False,0
2025-01-08 16:00:48,persegiMerah,899,495,125,123,36,35,32,32,4,3,True,0.18653314482168112
2025-01-08 16:00:48,Fail to pick,899,495,0,0,0,0,0,0,0,0,False,0
2025-01-08 16:00:48,persegiMerah,897,490,129,124,61,29,57,29,4,0,True,0.1970542390599381
2025-01-08 16:00:48,Fail to pick,897,490,0,0,0,0,0,0,0,0,False,0
2025-01-08 16:00:48,persegiMerah,909,488,124,122,161,9,163,8,2,1,True,0.2179703957505751
2025-01-08 16:00:49,persegiMerah,895,506,130,124,10,59,12,54,2,5,True,0.21791615909793696
2025-01-08 16:00:49,persegiMerah,900,496,129,124,170,72,174,72,4,0,True,0.39687408787646883
2025-01-08 16:00:49,Merah,900,496,tensor(129.1918),tensor(124.5374),62,83,65,80,3,3,True,0.0
2025-01-08 16:00:49,persegiMerah,903,495,126,127,4,95,5,99,1,4,True,0.11182155289740675
2025-01-08 16:00:49,Fail to pick,903,495,0,0,0,0,0,0,0,0,False,0
2025-01-08 16:00:49,persegiMerah,901,497,127,129,115,43,116,41,1,2,True,0.15503923314148224
2025-01-08 16:00:49,Fail to pick,901,497,0,0,0,0,0,0,0,0,False,0
2025-01-08 16:00:49,persegiMerah,898,481,130,124,194,7,189,4,5,3,True,0.4908937806660716
2025-01-08 16:00:50,persegiMerah,909,469,126,123,117,1,119,-1,2,2,True,0.10939806567757092
2025-01-08 16:00:50,persegiMerah,912,468,123,124,130,3,126,4,4,1,False,0.30703564852221044
2025-01-08 16:00:50,Fail to pick,912,468,0,0,0,0,0,0,0,0,False,0
2025-01-08 16:00:50,persegiMerah,896,493,129,126,76,52,79,48,3,4,True,0.43109531942202883
2025-01-08 16:00:50,persegiMerah,902,489,127,126,163,60,163,60,0,0,False,0.15448730338232802
2025-01-08 16:00:50,Fail to pick,902,489,0,0,0,0,0,0,0,0,False,0
2025-01-08 16:00:58,persegiMerah,839,146,115,125,79,77,80,75,1,2,True,0.322553070899391
2025-01-08 16:00:58,Merah,839,146,tensor(115.9458),tensor(125.7912),159,77,162,80,3,3,True,0.0
2025-01-08 16:00:59,persegiMerah,856,134,117,128,43,42,39,44,4,2,True,0.4200409903749064
2025-01-08 16:01:00,persegiMerah,875,149,115,132,127,41,125,38,2,3,True,0.4300399696806604
2025-01-08 16:01:00,Merah,875,149,tensor(115.6353),tensor(132.1980),158,81,159,81,1,0,True,0.0003314018249511719
2025-01-08 16:01:01,persegiMerah,861,133,117,134,28,44,28,40,0,4,True,0.11906808048740745
2025-01-08 16:01:02,persegiMerah,864,143,120,126,148,39,146,37,2,2,True,0.34548859576952357
2025-01-08 16:01:02,persegiMerah,866,141,123,128,102,3,102,3,0,0,True,0.1314549982321232
2025-01-08 16:01:02,Merah,866,141,tensor(123.0474),tensor(128.3346),160,80,158,75,2,5,True,0.0
2025-01-08 16:01:02,Fail to pick,866,141,0,0,0,0,0,0,0,0,False,0
2025-01-08 16:01:12,persegiMerah,814,154,111,121,48,88,52,89,4,1,True,0.4801128948518292
2025-01-08 16:01:12,Merah,814,154,tensor(111.6332),tensor(121.9347),157,75,156,75,1,0,True,0.0
2025-01-08 16:01:14,persegiMerah,825,135,116,127,93,22,92,17,1,5,True,0.4939515264893377
2025-01-08 16:01:14,Merah,825,135,tensor(116.5361),tensor(127.4069),162,76,160,75,2,1,True,0.0
2025-01-08 16:01:14,persegiMerah,843,159,123,126,153,85,149,88,4,3,True,0.256366834811385
2025-01-08 16:01:15,persegiMerah,868,137,124,134,89,65,90,68,1,3,True,0.38556169387609285
2025-01-08 16:01:15,persegiMerah,868,136,119,135,185,61,189,64,4,3,True,0.38738078436978396
2025-01-08 16:01:15,Fail to pick,868,136,0,0,0,0,0,0,0,0,False,0
2025-01-08 16:01:15,persegiMerah,861,146,117,131,104,28,105,31,1,3,True,0.33214027141819247
2025-01-08 16:01:15,Merah,861,146,tensor(117.3894),tensor(131.7984),159,79,161,75,2,4,True,0.0004954338073730469
2025-01-08 16:01:18,persegiMerah,804,116,124,133,32,28,29,27,3,1,False,0.2827780995408604
2025-01-08 16:01:18,Merah,804,116,tensor(124.2026),tensor(133.0651),167,74,169,76,2,2,True,0.0
2025-01-08 16:01:18,persegiMerah,861,164,122,134,151,68,147,69,4,1,True,0.2305725988537513
2025-01-08 16:01:19,persegiMerah,785,151,132,134,27,42,29,45,2,3,True,0.184091629522813
2025-01-08 16:01:19,Merah,785,151,tensor(132.2603),tensor(134.2642),158,72,161,68,3,4,True,0.0
2025-01-08 16:02:43,persegiMerah,795,165,124,124,72,25,75,28,3,3,True,0.43174854197948875
2025-01-08 16:02:43,Merah,795,165,tensor(124.6356),tensor(124.1713),154,73,151,72,3,1,True,0.0004992485046386719
2025-01-08 16:02:44,persegiMerah,801,158,119,127,104,2,100,0,4,2,True,0.37040965390133984
2025-01-08 16:02:44,Fail to pick,801,158,0,0,0,0,0,0,0,0,False,0
2025-01-08 16:02:44,persegiMerah,884,164,130,128,76,84,80,84,4,0,True,0.3680615464714089
2025-01-08 16:02:44,persegiMerah,892,164,133,129,59,12,63,14,4,2,True,0.4569313245258342
2025-01-08 16:02:44,Fail to pick,892,164,0,0,0,0,0,0,0,0,False,0
2025-01-08 16:02:44,persegiMerah,921,179,140,134,105,45,100,45,5,0,True,0.1708842682969201
2025-01-08 16:02:44,persegiMerah,881,165,129,128,23,50,25,46,2,4,True,0.29242993083987245
2025-01-08 16:02:44,persegiMerah,898,163,135,126,66,26,66,30,0,4,True,0.4229277833556234
2025-01-08 16:02:44,persegiMerah,800,142,135,137,37,43,33,44,4,1,False,0.2500346767190843
2025-01-08 16:02:45,persegiMerah,910,172,134,129,112,98,114,93,2,5,True,0.41213432537939454
2025-01-08 16:02:45,Merah,910,172,tensor(134.2698),tensor(129.5142),152,84,150,85,2,1,True,0.0
2025-01-08 16:02:45,persegiMerah,815,126,131,136,30,39,25,42,5,3,True,0.4455329032913201
2025-01-08 16:02:45,persegiMerah,843,141,131,131,156,12,151,7,5,5,True,0.12033275451100285
2025-01-08 16:02:45,persegiMerah,879,158,132,126,78,85,76,82,2,3,True,0.249342363197536
2025-01-08 16:02:45,persegiMerah,883,162,131,125,107,83,109,87,2,4,True,0.34623279654357075
2025-01-08 16:02:45,Fail to pick,883,162,0,0,0,0,0,0,0,0,False,0
2025-01-08 16:02:45,persegiMerah,803,162,142,139,17,40,16,40,1,0,True,0.1305309072121117
2025-01-08 16:02:55,persegiMerah,289,234,158,147,125,86,123,82,2,4,True,0.2479395551342495
2025-01-08 16:02:55,Merah,289,234,tensor(158.0863),tensor(147.2299),135,26,139,28,4,2,True,0.0004987716674804688
2025-01-08 16:02:55,persegiMerah,285,229,148,149,55,70,53,71,2,1,True,0.12212678250451514
2025-01-08 16:02:55,Fail to pick,285,229,0,0,0,0,0,0,0,0,False,0
2025-01-08 16:02:56,persegiMerah,273,216,146,143,80,62,79,57,1,5,True,0.42648837540192075
2025-01-08 16:02:56,persegiMerah,280,224,150,148,182,47,186,43,4,4,True,0.21127743185071637
2025-01-08 16:02:56,Fail to pick,280,224,0,0,0,0,0,0,0,0,False,0
2025-01-08 16:02:56,persegiMerah,233,179,135,141,139,82,142,78,3,4,True,0.2249474857970832
2025-01-08 16:02:56,persegiMerah,184,234,163,145,24,91,22,92,2,1,True,0.44668462594282243
2025-01-08 16:02:56,Merah,184,234,tensor(163.4507),tensor(145.6529),135,17,138,13,3,4,True,0.0004894733428955078
2025-01-08 16:02:56,persegiMerah,271,217,149,142,145,58,141,54,4,4,True,0.12860376886469815
2025-01-08 16:02:57,persegiMerah,276,214,148,145,83,36,86,38,3,2,True,0.4467840607495246
2025-01-08 16:02:57,Fail to pick,276,214,0,0,0,0,0,0,0,0,False,0
2025-01-08 16:02:57,persegiMerah,271,218,150,145,22,43,17,46,5,3,True,0.46206105542666887
2025-01-08 16:02:57,Fail to pick,271,218,0,0,0,0,0,0,0,0,False,0
2025-01-08 16:02:57,persegiMerah,272,214,148,144,162,58,157,59,5,1,True,0.2748521291135713
2025-01-08 16:02:57,Fail to pick,272,214,0,0,0,0,0,0,0,0,False,0
2025-01-08 16:02:57,persegiMerah,287,231,164,148,141,74,137,72,4,2,True,0.13249956928268822
2025-01-08 16:02:57,persegiMerah,272,222,149,145,8,44,10,45,2,1,True,0.12011896606840802
2025-01-08 16:02:57,Merah,272,222,tensor(149.7393),tensor(145.9796),138,25,135,29,3,4,True,0.00051116943359375
2025-01-08 16:02:58,persegiMerah,297,245,159,148,144,55,145,56,1,1,True,0.18368252934226598
2025-01-08 16:02:58,persegiMerah,270,229,154,149,48,76,47,78,1,2,True,0.19368079262511115
2025-01-08 16:03:02,persegiMerah,232,228,126,140,71,2,67,0,4,2,True,0.1192459219233994
2025-01-08 16:06:21,persegiBiru,215,297,122,112,129,77,132,81,3,4,True,0.1474420758971871
2025-01-08 16:06:21,Biru,215,297,tensor(122.2928),tensor(112.5210),117,19,114,22,3,3,True,0.0004966259002685547
2025-01-08 16:06:21,persegiBiru,216,296,120,111,89,72,91,74,2,2,True,0.2400299487403113
2025-01-08 16:06:21,Fail to pick,216,296,0,0,0,0,0,0,0,0,False,0
2025-01-08 16:06:22,persegiBiru,217,291,124,109,180,71,175,68,5,3,True,0.38218813205805313
2025-01-08 16:06:22,Fail to pick,217,291,0,0,0,0,0,0,0,0,False,0
2025-01-08 16:06:22,persegiBiru,214,296,120,111,120,82,122,80,2,2,True,0.2860391221477986
2025-01-08 16:06:22,Fail to pick,214,296,0,0,0,0,0,0,0,0,False,0
2025-01-08 16:06:23,persegiBiru,220,290,127,109,64,22,65,21,1,1,True,0.2807412418797465
2025-01-08 16:06:23,Fail to pick,220,290,0,0,0,0,0,0,0,0,False,0
2025-01-08 16:06:23,persegiMerah,236,276,128,115,5,50,2,53,3,3,True,0.19744431424822662
2025-01-08 16:06:23,persegiMerah,211,296,120,114,137,38,135,39,2,1,True,0.18277756210822138
2025-01-08 16:06:29,persegiBiru,167,562,124,101,117,25,119,24,2,1,True,0.11379503651959229
2025-01-08 16:06:29,Biru,167,562,tensor(124.3707),tensor(101.1626),43,15,45,10,2,5,True,0.0
2025-01-08 16:06:29,persegiBiru,159,566,123,102,39,82,37,84,2,2,True,0.4279262881156404
2025-01-08 16:06:29,Fail to pick,159,566,0,0,0,0,0,0,0,0,False,0
2025-01-08 16:06:29,persegiBiru,150,572,127,102,63,77,58,78,5,1,True,0.3568063680367586
2025-01-08 16:06:29,Fail to pick,150,572,0,0,0,0,0,0,0,0,False,0
2025-01-08 16:06:30,persegiBiru,156,569,126,105,86,19,86,20,0,1,True,0.2680670036224022
2025-01-08 16:06:30,Fail to pick,156,569,0,0,0,0,0,0,0,0,False,0
2025-01-08 16:06:30,persegiBiru,165,563,124,103,183,86,181,86,2,0,True,0.2844878794719393
2025-01-08 16:06:30,Fail to pick,165,563,0,0,0,0,0,0,0,0,False,0
2025-01-08 16:06:31,persegiBiru,166,570,128,106,183,55,186,56,3,1,True,0.2387049046176565
2025-01-08 16:06:31,Fail to pick,166,570,0,0,0,0,0,0,0,0,False,0
2025-01-08 16:06:31,persegiBiru,162,569,125,105,90,0,90,-4,0,4,False,0.21427226983284667
2025-01-08 16:06:31,Fail to pick,162,569,0,0,0,0,0,0,0,0,False,0
2025-01-08 16:06:31,persegiBiru,175,565,125,104,64,88,65,91,1,3,True,0.20993568839611731
2025-01-08 16:06:31,persegiBiru,176,567,126,106,50,18,49,16,1,2,False,0.3731756819693458
2025-01-08 16:06:31,Fail to pick,176,567,0,0,0,0,0,0,0,0,False,0
2025-01-08 16:06:31,persegiBiru,179,566,128,108,25,49,27,44,2,5,False,0.3539069372582093
2025-01-08 16:06:31,Fail to pick,179,566,0,0,0,0,0,0,0,0,False,0
2025-01-08 16:06:31,persegiBiru,176,566,129,107,195,8,191,5,4,3,True,0.28035962197496866
2025-01-08 16:06:31,Fail to pick,176,566,0,0,0,0,0,0,0,0,False,0
2025-01-08 16:06:31,persegiBiru,166,571,127,106,112,66,110,62,2,4,True,0.10217317455816098
2025-01-08 16:06:32,persegiBiru,175,564,126,104,43,11,41,13,2,2,True,0.3400213001723277
2025-01-08 16:06:32,Fail to pick,175,564,0,0,0,0,0,0,0,0,False,0
2025-01-08 16:06:32,persegiBiru,175,563,128,103,169,91,168,90,1,1,False,0.10767121206504414
2025-01-08 16:06:32,Fail to pick,175,563,0,0,0,0,0,0,0,0,False,0
2025-01-08 16:06:32,persegiBiru,172,564,125,103,180,79,176,74,4,5,True,0.45936964385270695
2025-01-08 16:06:32,Fail to pick,172,564,0,0,0,0,0,0,0,0,False,0
2025-01-08 16:06:32,persegiBiru,173,562,128,101,8,57,7,57,1,0,True,0.21029729710417638
2025-01-08 16:06:32,Fail to pick,173,562,0,0,0,0,0,0,0,0,False,0
2025-01-08 16:06:33,persegiBiru,179,566,126,104,167,77,168,76,1,1,False,0.31784146863422946
2025-01-08 16:06:33,Fail to pick,179,566,0,0,0,0,0,0,0,0,False,0
2025-01-08 16:06:33,persegiBiru,175,564,128,103,7,54,3,58,4,4,True,0.46434782675532094
2025-01-08 16:06:33,Fail to pick,175,564,0,0,0,0,0,0,0,0,False,0
2025-01-08 16:06:33,persegiBiru,166,570,127,106,82,46,77,43,5,3,True,0.355400252841944
2025-01-08 16:06:33,Fail to pick,166,570,0,0,0,0,0,0,0,0,False,0
2025-01-08 16:06:33,persegiBiru,181,566,125,106,3,6,4,1,1,5,True,0.4601637423064401
2025-01-08 16:06:33,persegiBiru,174,564,128,106,155,63,157,67,2,4,False,0.21559466115914147
2025-01-08 16:06:33,Fail to pick,174,564,0,0,0,0,0,0,0,0,False,0
2025-01-08 16:06:33,persegiBiru,169,570,126,106,50,9,51,4,1,5,True,0.17312310121847566
2025-01-08 16:06:33,Fail to pick,169,570,0,0,0,0,0,0,0,0,False,0
2025-01-08 16:06:34,persegiBiru,176,566,128,105,4,45,6,49,2,4,False,0.47607898934625836
2025-01-08 16:06:34,Fail to pick,176,566,0,0,0,0,0,0,0,0,False,0
2025-01-08 16:06:34,persegiBiru,177,564,129,107,101,48,105,50,4,2,True,0.321079927909491
2025-01-08 16:06:34,Fail to pick,177,564,0,0,0,0,0,0,0,0,False,0
2025-01-08 16:06:34,persegiBiru,175,568,128,105,48,70,45,70,3,0,True,0.22991227566858163
2025-01-08 16:06:34,Fail to pick,175,568,0,0,0,0,0,0,0,0,False,0
2025-01-08 16:06:34,persegiBiru,167,570,128,106,168,35,168,32,0,3,True,0.4920467637899931
2025-01-08 16:06:34,Fail to pick,167,570,0,0,0,0,0,0,0,0,False,0
2025-01-08 16:06:34,persegiBiru,167,568,128,105,133,46,133,43,0,3,True,0.24231171126141043
2025-01-08 16:06:34,Fail to pick,167,568,0,0,0,0,0,0,0,0,False,0
2025-01-08 16:06:34,persegiBiru,167,569,129,106,75,67,79,62,4,5,False,0.33291756643633863
2025-01-08 16:06:34,Fail to pick,167,569,0,0,0,0,0,0,0,0,False,0
2025-01-08 16:06:35,persegiBiru,165,569,128,104,12,46,14,45,2,1,True,0.36663552502383845
2025-01-08 16:06:35,Fail to pick,165,569,0,0,0,0,0,0,0,0,False,0
2025-01-08 16:06:35,persegiBiru,169,569,126,104,109,54,105,49,4,5,True,0.3811390431292495
2025-01-08 16:06:35,Fail to pick,169,569,0,0,0,0,0,0,0,0,False,0
2025-01-08 16:06:35,persegiBiru,163,569,127,106,190,93,188,88,2,5,True,0.25977947428287124
2025-01-08 16:06:35,Fail to pick,163,569,0,0,0,0,0,0,0,0,False,0
2025-01-08 16:06:35,persegiBiru,166,561,131,106,19,8,20,3,1,5,True,0.20080309475290387
2025-01-08 16:06:35,Fail to pick,166,561,0,0,0,0,0,0,0,0,False,0
2025-01-08 16:06:35,persegiBiru,166,562,128,104,50,84,48,87,2,3,True,0.49252288030982294
2025-01-08 16:06:35,Fail to pick,166,562,0,0,0,0,0,0,0,0,False,0
2025-01-08 16:06:35,persegiBiru,167,562,130,103,141,12,139,8,2,4,True,0.3020782719121854
2025-01-08 16:06:35,Fail to pick,167,562,0,0,0,0,0,0,0,0,False,0
2025-01-08 16:06:36,persegiBiru,167,562,126,103,194,45,194,48,0,3,True,0.21517986023498717
2025-01-08 16:06:36,Fail to pick,167,562,0,0,0,0,0,0,0,0,False,0
2025-01-08 16:06:36,persegiBiru,165,569,131,105,12,24,9,23,3,1,True,0.270649014683532
2025-01-08 16:06:36,Fail to pick,165,569,0,0,0,0,0,0,0,0,False,0
2025-01-08 16:06:36,persegiBiru,168,561,128,105,54,76,53,79,1,3,True,0.3369229141033335
2025-01-08 16:06:36,Fail to pick,168,561,0,0,0,0,0,0,0,0,False,0
2025-01-08 16:06:36,persegiBiru,174,560,126,105,138,36,134,40,4,4,True,0.47289821107743946
2025-01-08 16:06:36,Fail to pick,174,560,0,0,0,0,0,0,0,0,False,0
2025-01-08 16:06:36,persegiBiru,162,556,126,106,143,39,143,42,0,3,True,0.18130279274323927
2025-01-08 16:06:36,persegiBiru,168,558,130,104,164,76,164,79,0,3,True,0.3391258859450682
2025-01-08 16:06:36,Fail to pick,168,558,0,0,0,0,0,0,0,0,False,0
2025-01-08 16:06:45,persegiBiru,171,562,135,104,194,3,192,2,2,1,True,0.2507984080515163
2025-01-08 16:06:45,Fail to pick,171,562,0,0,0,0,0,0,0,0,False,0
2025-01-08 16:06:45,persegiBiru,166,565,125,102,178,28,177,23,1,5,False,0.41175543764529277
2025-01-08 16:06:45,Fail to pick,166,565,0,0,0,0,0,0,0,0,False,0
2025-01-08 16:06:57,persegiBiru,168,576,140,100,120,13,119,15,1,2,True,0.39644791013224434
2025-01-08 16:06:57,persegiBiru,164,580,131,96,109,24,105,27,4,3,True,0.36727463863337895
2025-01-08 16:06:57,Fail to pick,164,580,0,0,0,0,0,0,0,0,False,0
2025-01-08 16:06:58,persegiBiru,164,576,129,100,17,30,13,25,4,5,True,0.48722490666016893
2025-01-08 16:06:58,Fail to pick,164,576,0,0,0,0,0,0,0,0,False,0
2025-01-08 16:06:58,persegiBiru,156,580,134,98,101,9,97,7,4,2,False,0.4935752798526494
2025-01-08 16:06:58,Fail to pick,156,580,0,0,0,0,0,0,0,0,False,0
2025-01-08 16:06:58,persegiBiru,175,570,140,101,187,47,188,45,1,2,True,0.2966078743281271
2025-01-08 16:06:58,persegiBiru,169,579,133,96,36,54,35,58,1,4,True,0.23230279525118852
2025-01-08 16:06:58,Fail to pick,169,579,0,0,0,0,0,0,0,0,False,0
2025-01-08 16:06:59,persegiBiru,170,577,131,99,124,96,122,95,2,1,True,0.4102544466757083
2025-01-08 16:06:59,Fail to pick,170,577,0,0,0,0,0,0,0,0,False,0
2025-01-08 16:06:59,persegiBiru,168,578,134,97,169,86,168,86,1,0,True,0.3987810371638847
2025-01-08 16:06:59,Fail to pick,168,578,0,0,0,0,0,0,0,0,False,0
2025-01-08 16:06:59,persegiBiru,165,577,129,98,54,50,55,53,1,3,True,0.39851268622554026
2025-01-08 16:06:59,Fail to pick,165,577,0,0,0,0,0,0,0,0,False,0
2025-01-08 16:07:01,persegiBiru,175,582,131,93,5,87,4,82,1,5,True,0.24325084680388276
2025-01-08 16:07:01,persegiBiru,175,582,131,93,15,63,12,63,3,0,True,0.21737221702920115
2025-01-08 16:07:01,Fail to pick,175,582,0,0,0,0,0,0,0,0,False,0
2025-01-08 16:07:01,persegiBiru,191,577,131,98,199,12,198,13,1,1,True,0.24180943400027696
2025-01-08 16:07:02,persegiBiru,191,578,131,96,158,55,153,57,5,2,True,0.253214276849397
2025-01-08 16:07:02,Fail to pick,191,578,0,0,0,0,0,0,0,0,False,0
2025-01-08 16:07:02,persegiBiru,181,579,134,96,192,38,187,42,5,4,True,0.28529230347503864
2025-01-08 16:07:02,persegiBiru,188,575,133,99,110,21,112,17,2,4,True,0.44585317381150646
2025-01-08 16:07:02,Fail to pick,188,575,0,0,0,0,0,0,0,0,False,0
2025-01-08 16:07:02,persegiBiru,179,580,130,95,113,33,112,32,1,1,True,0.3669751111772489
2025-01-08 16:07:02,Fail to pick,179,580,0,0,0,0,0,0,0,0,False,0
2025-01-08 16:07:02,persegiBiru,178,582,132,95,157,0,158,-1,1,1,False,0.31427699580634716
2025-01-08 16:07:02,Fail to pick,178,582,0,0,0,0,0,0,0,0,False,0
2025-01-08 16:13:51,persegiBiru,303,601,123,99,40,47,38,46,2,1,True,0.27048284144268103
2025-01-08 16:13:51,Biru,303,601,tensor(123.6530),tensor(99.3514),33,28,34,26,1,2,True,0.000499725341796875
2025-01-08 16:13:51,persegiBiru,238,589,108,106,142,77,145,78,3,1,True,0.31832636880759974
2025-01-08 16:13:52,persegiBiru,308,609,123,97,194,3,192,5,2,2,True,0.3763566994891453
2025-01-08 16:13:52,persegiBiru,298,613,115,97,35,7,33,7,2,0,True,0.24964564873803186
2025-01-08 16:13:52,persegiBiru,251,587,111,112,38,90,39,86,1,4,True,0.26473387591967845
2025-01-08 16:13:58,persegiMerah,277,597,131,111,183,48,184,52,1,4,True,0.262847056161121
2025-01-08 16:13:58,persegiMerah,269,593,128,114,179,98,179,93,0,5,True,0.1533200730488279
2025-01-08 16:13:58,Fail to pick,269,593,0,0,0,0,0,0,0,0,False,0
2025-01-08 16:13:58,persegiMerah,269,587,125,112,69,67,68,68,1,1,True,0.2056327293427728
2025-01-08 16:13:58,Fail to pick,269,587,0,0,0,0,0,0,0,0,False,0
2025-01-08 16:13:59,persegiMerah,252,599,126,111,71,2,74,-2,3,4,True,0.2564878945170699
2025-01-08 16:13:59,persegiMerah,258,562,128,118,108,17,105,12,3,5,False,0.347213884620351
2025-01-08 16:13:59,persegiMerah,246,559,129,108,0,74,1,70,1,4,True,0.2227984742412985
2025-01-08 16:14:02,persegiMerah,227,567,133,118,113,13,112,11,1,2,False,0.3138102211162882
2025-01-08 16:19:52,persegiMerah,738,544,146,129,132,14,128,13,4,1,True,0.18316904897862837
2025-01-08 16:19:52,Merah,738,544,tensor(146.6916),tensor(129.5995),48,68,43,70,5,2,True,0.0004999637603759766
2025-01-08 16:19:52,persegiMerah,744,544,158,132,114,44,115,41,1,3,True,0.19184037528820902
2025-01-08 16:19:52,Fail to pick,744,544,0,0,0,0,0,0,0,0,False,0
2025-01-08 16:19:52,persegiMerah,756,542,159,138,28,31,27,35,1,4,True,0.2617790247181487
2025-01-08 16:19:52,persegiMerah,744,545,151,127,196,25,195,22,1,3,True,0.13412388005938614
2025-01-08 16:19:53,persegiMerah,738,540,146,131,101,92,104,95,3,3,True,0.3067544030206886
2025-01-08 16:19:53,Fail to pick,738,540,0,0,0,0,0,0,0,0,False,0
2025-01-08 16:19:53,persegiMerah,736,544,145,126,23,6,27,6,4,0,True,0.3646983013393209
2025-01-08 16:19:53,Fail to pick,736,544,0,0,0,0,0,0,0,0,False,0
2025-01-08 16:19:53,persegiMerah,741,544,144,128,105,12,100,10,5,2,True,0.3180918496335864
2025-01-08 16:19:53,Fail to pick,741,544,0,0,0,0,0,0,0,0,False,0
2025-01-08 16:20:04,persegiMerah,792,131,129,132,88,65,84,66,4,1,True,0.22947673733035767
2025-01-08 16:20:04,Merah,792,131,tensor(129.2682),tensor(132.1582),163,73,162,71,1,2,True,0.0
2025-01-08 16:20:04,persegiMerah,794,136,127,126,58,42,54,38,4,4,True,0.23793768374219304
2025-01-08 16:20:04,Fail to pick,794,136,0,0,0,0,0,0,0,0,False,0
2025-01-08 16:20:04,persegiMerah,795,132,122,129,117,40,114,38,3,2,True,0.400440773541331
2025-01-08 16:20:04,Fail to pick,795,132,0,0,0,0,0,0,0,0,False,0
2025-01-08 16:20:04,persegiMerah,792,133,128,130,47,47,46,50,1,3,False,0.12664673613859967
2025-01-08 16:20:04,Fail to pick,792,133,0,0,0,0,0,0,0,0,False,0
2025-01-08 16:20:04,persegiMerah,790,129,124,128,182,67,179,64,3,3,True,0.29360641894851025
2025-01-08 16:20:04,Fail to pick,790,129,0,0,0,0,0,0,0,0,False,0
2025-01-08 16:20:04,persegiMerah,795,138,124,128,89,82,88,86,1,4,True,0.18848178097408388
2025-01-08 16:20:04,Fail to pick,795,138,0,0,0,0,0,0,0,0,False,0
2025-01-08 16:20:05,persegiMerah,787,134,122,128,65,74,64,69,1,5,True,0.4155336826110435
2025-01-08 16:20:05,Fail to pick,787,134,0,0,0,0,0,0,0,0,False,0
2025-01-08 16:20:05,persegiMerah,789,132,124,127,185,84,183,80,2,4,True,0.12955278066693932
2025-01-08 16:20:05,Merah,789,132,tensor(124.4547),tensor(127.5425),163,73,161,72,2,1,True,0.0
2025-01-08 16:20:05,Fail to pick,789,132,0,0,0,0,0,0,0,0,False,0
2025-01-08 16:20:05,persegiMerah,800,132,124,125,68,10,66,7,2,3,False,0.3239290068800361
2025-01-08 16:20:05,persegiMerah,793,135,128,124,102,36,103,33,1,3,True,0.19820862713131593
2025-01-08 16:20:05,Fail to pick,793,135,0,0,0,0,0,0,0,0,False,0
2025-01-08 16:20:14,persegiMerah,790,142,123,119,191,65,187,66,4,1,False,0.1292521634659489
2025-01-08 16:20:14,Merah,790,142,tensor(123.3414),tensor(119.8212),160,73,158,73,2,0,True,0.0005297660827636719
2025-01-08 16:20:14,Fail to pick,790,142,0,0,0,0,0,0,0,0,False,0
2025-01-08 16:20:15,persegiMerah,807,131,123,118,184,14,187,16,3,2,True,0.1716868918344111
2025-01-08 16:20:15,persegiMerah,797,143,120,119,90,37,94,33,4,4,True,0.2272007561855881
2025-01-08 16:20:15,persegiMerah,790,142,121,121,85,80,88,79,3,1,True,0.31928066539591865
2025-01-08 16:20:15,Fail to pick,790,142,0,0,0,0,0,0,0,0,False,0
2025-01-08 16:20:15,persegiMerah,794,140,122,119,15,69,16,64,1,5,True,0.4766223593375728
2025-01-08 16:20:15,Fail to pick,794,140,0,0,0,0,0,0,0,0,False,0
2025-01-08 16:20:16,persegiMerah,794,142,121,118,8,97,8,93,0,4,True,0.19953206608008323
2025-01-08 16:20:16,Merah,794,142,tensor(121.6566),tensor(118.9519),160,73,163,76,3,3,True,0.0002894401550292969
2025-01-08 16:20:16,Fail to pick,794,142,0,0,0,0,0,0,0,0,False,0
2025-01-08 16:20:16,persegiMerah,788,144,123,121,146,36,150,36,4,0,True,0.17182989440993407
2025-01-08 16:20:16,Fail to pick,788,144,0,0,0,0,0,0,0,0,False,0
2025-01-08 16:20:16,persegiMerah,791,137,128,122,141,19,136,16,5,3,True,0.1897429116807682
2025-01-08 16:20:16,Fail to pick,791,137,0,0,0,0,0,0,0,0,False,0
2025-01-08 16:20:16,persegiMerah,793,139,122,120,76,7,79,5,3,2,True,0.4960593168232026
2025-01-08 16:20:16,Fail to pick,793,139,0,0,0,0,0,0,0,0,False,0
2025-01-08 16:20:16,persegiMerah,792,142,124,121,1,78,0,82,1,4,True,0.23504132443105746
2025-01-08 16:20:16,Fail to pick,792,142,0,0,0,0,0,0,0,0,False,0
2025-01-08 16:20:16,persegiMerah,788,140,125,121,188,23,188,25,0,2,True,0.43211169005780026
2025-01-08 16:20:16,Fail to pick,788,140,0,0,0,0,0,0,0,0,False,0
2025-01-08 16:20:16,persegiMerah,791,139,128,124,152,27,150,24,2,3,True,0.3861509846600263
2025-01-08 16:20:16,Fail to pick,791,139,0,0,0,0,0,0,0,0,False,0
2025-01-08 16:20:17,persegiMerah,794,142,124,122,55,48,59,48,4,0,True,0.37311807594398316
2025-01-08 16:20:17,Merah,794,142,tensor(124.3332),tensor(122.0220),160,73,156,68,4,5,True,0.0004982948303222656
2025-01-08 16:20:17,Fail to pick,794,142,0,0,0,0,0,0,0,0,False,0
2025-01-08 16:20:17,persegiMerah,788,143,123,121,172,61,172,64,0,3,True,0.11549248431763592
2025-01-08 16:20:17,Fail to pick,788,143,0,0,0,0,0,0,0,0,False,0
2025-01-08 16:20:17,persegiMerah,787,139,121,124,117,39,114,35,3,4,True,0.342242258113914
2025-01-08 16:20:17,Fail to pick,787,139,0,0,0,0,0,0,0,0,False,0
2025-01-08 16:20:17,persegiMerah,790,139,130,120,171,67,167,70,4,3,True,0.3052496701931293
2025-01-08 16:20:17,Fail to pick,790,139,0,0,0,0,0,0,0,0,False,0
2025-01-08 16:20:17,persegiMerah,794,138,125,122,128,91,126,92,2,1,True,0.401516230589693
2025-01-08 16:20:17,Fail to pick,794,138,0,0,0,0,0,0,0,0,False,0
2025-01-08 16:20:17,persegiMerah,785,140,129,120,13,85,17,85,4,0,True,0.4463040332174498
2025-01-08 16:20:17,Fail to pick,785,140,0,0,0,0,0,0,0,0,False,0
2025-01-08 16:20:18,persegiMerah,789,138,129,119,158,95,162,96,4,1,True,0.15858269554471371
2025-01-08 16:20:18,Fail to pick,789,138,0,0,0,0,0,0,0,0,False,0
2025-01-08 16:20:18,persegiMerah,792,140,133,119,104,14,100,11,4,3,True,0.20515935337548719
2025-01-08 16:20:18,Merah,792,140,tensor(133.0566),tensor(119.4852),161,73,163,73,2,0,True,0.0004978179931640625
2025-01-08 16:20:18,Fail to pick,792,140,0,0,0,0,0,0,0,0,False,0
2025-01-08 16:20:18,persegiMerah,791,140,131,121,81,26,76,21,5,5,True,0.2577518138890851
2025-01-08 16:20:18,Fail to pick,791,140,0,0,0,0,0,0,0,0,False,0
2025-01-08 16:20:18,persegiMerah,787,138,130,122,12,41,10,41,2,0,True,0.44557043441470234
2025-01-08 16:20:18,Fail to pick,787,138,0,0,0,0,0,0,0,0,False,0
2025-01-08 16:20:19,persegiMerah,791,137,130,122,72,38,75,34,3,4,True,0.2775045184825603
2025-01-08 16:20:19,Fail to pick,791,137,0,0,0,0,0,0,0,0,False,0
2025-01-08 16:20:19,persegiMerah,789,141,130,123,164,44,165,41,1,3,True,0.4695107304950821
2025-01-08 16:20:19,Fail to pick,789,141,0,0,0,0,0,0,0,0,False,0
2025-01-08 16:20:20,persegiMerah,787,140,131,124,91,73,95,71,4,2,True,0.299665672827208
2025-01-08 16:20:20,Merah,787,140,tensor(131.0460),tensor(124.9128),161,72,159,74,2,2,True,0.0
2025-01-08 16:20:20,Fail to pick,787,140,0,0,0,0,0,0,0,0,False,0
2025-01-08 16:20:20,persegiMerah,791,134,133,124,74,71,70,74,4,3,True,0.22754539501753826
2025-01-08 16:20:20,Fail to pick,791,134,0,0,0,0,0,0,0,0,False,0
2025-01-08 16:32:37,persegiKuning,827,115,109,120,10,67,7,69,3,2,True,0.3394787693069403
2025-01-08 16:32:37,Kuning,827,115,tensor(109.7275),tensor(120.6780),168,76,164,76,4,0,True,0.0
2025-01-08 16:32:38,persegiKuning,831,116,113,116,33,26,35,28,2,2,True,0.4201854468373838
2025-01-08 16:32:38,Fail to pick,831,116,0,0,0,0,0,0,0,0,False,0
2025-01-08 16:32:46,persegiMerah,848,110,124,119,159,35,159,33,0,2,True,0.19372763571488993
2025-01-08 16:32:46,Merah,848,110,tensor(124.5049),tensor(119.1567),169,78,171,79,2,1,True,0.0005044937133789062
2025-01-08 16:32:52,persegiMerah,846,118,116,127,22,4,25,6,3,2,True,0.16757678381074848
2025-01-08 16:32:52,Merah,846,118,tensor(116.9047),tensor(127.2566),167,78,165,79,2,1,True,0.0004990100860595703
2025-01-08 16:32:52,Fail to pick,846,118,0,0,0,0,0,0,0,0,False,0
2025-01-08 16:36:32,persegiKuning,872,124,118,128,60,23,55,22,5,1,True,0.13526875784788778
2025-01-08 16:36:32,Kuning,872,124,tensor(118.9140),tensor(128.6801),165,80,169,76,4,4,True,0.0
2025-01-08 16:36:32,persegiKuning,875,125,118,127,103,48,106,45,3,3,True,0.4412215525022287
2025-01-08 16:36:32,Fail to pick,875,125,0,0,0,0,0,0,0,0,False,0
2025-01-08 16:36:32,persegiKuning,829,96,111,129,80,90,75,87,5,3,True,0.4265097499211904
2025-01-08 16:36:32,persegiMerah,883,145,129,133,183,98,181,96,2,2,True,0.14899330820756843
2025-01-08 16:36:39,persegiMerah,268,382,150,131,24,41,22,40,2,1,True,0.2726657322098612
2025-01-08 16:36:39,Merah,268,382,tensor(150.9584),tensor(131.2552),93,24,91,27,2,3,True,0.0005002021789550781
2025-01-08 16:36:39,persegiMerah,268,382,150,131,141,25,138,24,3,1,False,0.126595968301781
2025-01-08 16:36:39,Fail to pick,268,382,0,0,0,0,0,0,0,0,False,0
2025-01-08 16:36:39,persegiMerah,269,380,150,128,81,84,76,87,5,3,True,0.29203362127188626
2025-01-08 16:36:39,Fail to pick,269,380,0,0,0,0,0,0,0,0,False,0
2025-01-08 16:36:40,persegiMerah,287,393,131,129,90,99,85,98,5,1,True,0.39221663246211513
2025-01-08 16:36:40,Merah,287,393,tensor(131.7384),tensor(129.5732),90,26,89,27,1,1,True,0.0005006790161132812
2025-01-08 16:36:40,persegiMerah,287,386,132,126,121,7,123,3,2,4,False,0.23564021148845843
2025-01-08 16:36:40,Fail to pick,287,386,0,0,0,0,0,0,0,0,False,0
2025-01-08 16:36:40,persegiMerah,276,387,131,124,92,31,89,27,3,4,True,0.2347992176290616
2025-01-08 16:36:40,persegiMerah,290,382,132,127,195,90,195,91,0,1,False,0.21203081265870832
2025-01-08 16:36:41,persegiMerah,251,420,130,136,74,60,76,57,2,3,True,0.4417965197261057
2025-01-08 16:36:41,persegiMerah,257,413,132,127,121,15,123,12,2,3,True,0.41276180448597577
2025-01-08 16:36:41,Fail to pick,257,413,0,0,0,0,0,0,0,0,False,0
2025-01-08 16:36:47,persegiMerah,733,476,134,125,153,70,152,68,1,2,True,0.47589577425079377
2025-01-08 16:36:47,Merah,733,476,tensor(134.1595),tensor(125.1109),67,67,65,69,2,2,True,0.0
2025-01-08 16:36:47,persegiMerah,756,457,130,124,17,19,20,19,3,0,False,0.47027250979650703
2025-01-08 16:36:48,persegiMerah,761,436,128,122,123,51,125,47,2,4,True,0.3181896912954454
2025-01-08 16:36:48,persegiMerah,777,430,130,122,182,57,179,59,3,2,True,0.20962850591009652
2025-01-08 16:36:48,persegiMerah,778,430,126,127,44,29,42,27,2,2,True,0.3065768821293169
2025-01-08 16:36:48,Merah,778,430,tensor(126.8190),tensor(127.5717),80,72,75,75,5,3,True,0.0
2025-01-08 16:36:48,Fail to pick,778,430,0,0,0,0,0,0,0,0,False,0
2025-01-08 16:36:48,persegiMerah,776,431,129,122,32,99,30,103,2,4,True,0.4981722763885723
2025-01-08 16:36:48,Fail to pick,776,431,0,0,0,0,0,0,0,0,False,0
2025-01-08 16:36:56,persegiMerah,795,162,113,139,156,74,154,78,2,4,True,0.32616273971397924
2025-01-08 16:36:56,Merah,795,162,tensor(113.5864),tensor(139.4581),155,73,159,71,4,2,True,0.0004985332489013672
2025-01-08 16:36:57,persegiMerah,833,191,124,129,137,64,138,63,1,1,True,0.4370153452068398
2025-01-08 16:36:57,persegiMerah,819,202,130,129,124,26,128,30,4,4,True,0.34594149912648764
2025-01-08 16:36:57,persegiMerah,815,206,135,133,183,17,182,18,1,1,True,0.1303379052526805
2025-01-08 16:36:57,Fail to pick,815,206,0,0,0,0,0,0,0,0,False,0
2025-01-08 16:36:57,persegiMerah,861,169,126,126,130,1,129,5,1,4,True,0.4305991689371941
2025-01-08 16:36:57,persegiMerah,826,199,130,130,8,93,9,88,1,5,True,0.3791501902340009
2025-01-08 16:36:57,persegiMerah,832,200,125,131,107,95,104,91,3,4,True,0.393479810319027
2025-01-08 16:36:57,Merah,832,200,tensor(125.9159),tensor(131.3972),144,77,142,78,2,1,True,0.0
2025-01-08 16:36:57,Fail to pick,832,200,0,0,0,0,0,0,0,0,False,0
2025-01-08 16:36:58,persegiMerah,828,199,125,128,168,46,172,45,4,1,True,0.36918618423159644
2025-01-08 16:36:58,Fail to pick,828,199,0,0,0,0,0,0,0,0,False,0
2025-01-08 16:36:58,persegiMerah,827,203,128,130,94,98,97,93,3,5,True,0.26741887341230763
2025-01-08 16:36:58,Fail to pick,827,203,0,0,0,0,0,0,0,0,False,0
2025-01-08 16:36:58,persegiMerah,832,201,124,131,88,18,88,19,0,1,True,0.2547423245771394
2025-01-08 16:36:58,Fail to pick,832,201,0,0,0,0,0,0,0,0,False,0
2025-01-08 16:36:59,persegiMerah,827,201,128,128,91,34,89,34,2,0,True,0.4437095144102
2025-01-08 16:36:59,Merah,827,201,tensor(128.8486),tensor(128.9919),144,76,146,80,2,4,True,0.0
2025-01-08 16:36:59,Fail to pick,827,201,0,0,0,0,0,0,0,0,False,0
2025-01-08 16:36:59,persegiMerah,815,212,135,132,1,77,-3,79,4,2,True,0.45862716513281176
2025-01-08 16:36:59,persegiMerah,834,202,129,129,125,41,123,36,2,5,True,0.12970926813144598
2025-01-08 16:36:59,persegiMerah,852,179,127,125,73,84,70,81,3,3,True,0.16948217704460916
2025-01-08 16:36:59,persegiMerah,830,197,124,126,98,4,93,5,5,1,True,0.47572919175744266
2025-01-08 16:36:59,persegiMerah,858,182,123,125,41,49,39,46,2,3,True,0.47462753245022193
2025-01-08 16:36:59,persegiMerah,831,200,133,128,176,64,176,63,0,1,True,0.1664985737225182
2025-01-08 16:37:00,persegiMerah,848,181,127,123,76,82,71,86,5,4,True,0.20723453714121487
2025-01-08 16:37:00,persegiMerah,857,185,123,121,105,10,107,11,2,1,True,0.49193324569241426
2025-01-08 16:37:00,Fail to pick,857,185,0,0,0,0,0,0,0,0,False,0
2025-01-08 16:37:00,persegiMerah,851,184,122,119,2,37,-2,40,4,3,True,0.17714289733939748
2025-01-08 16:37:00,Merah,851,184,tensor(122.1367),tensor(119.9240),148,78,143,80,5,2,True,0.0
2025-01-08 16:37:00,Fail to pick,851,184,0,0,0,0,0,0,0,0,False,0
2025-01-08 16:37:00,persegiMerah,844,182,130,121,89,49,86,46,3,3,False,0.360687606177686
2025-01-08 16:37:00,Fail to pick,844,182,0,0,0,0,0,0,0,0,False,0
2025-01-08 16:37:00,persegiMerah,849,183,130,118,157,80,156,81,1,1,True,0.1931903161524073
2025-01-08 16:37:00,Fail to pick,849,183,0,0,0,0,0,0,0,0,False,0
2025-01-08 16:37:00,persegiMerah,856,187,126,117,182,8,179,5,3,3,True,0.2758197286401006
2025-01-08 16:37:00,Fail to pick,856,187,0,0,0,0,0,0,0,0,False,0
2025-01-08 16:37:00,persegiMerah,856,185,124,119,57,70,57,66,0,4,True,0.4259713507680235
2025-01-08 16:37:00,Fail to pick,856,185,0,0,0,0,0,0,0,0,False,0
2025-01-08 16:37:00,persegiMerah,856,179,124,118,73,81,75,78,2,3,True,0.45117663266614183
2025-01-08 16:37:00,Fail to pick,856,179,0,0,0,0,0,0,0,0,False,0
2025-01-08 16:37:00,persegiMerah,844,181,132,123,187,45,187,47,0,2,True,0.24381762502609067
2025-01-08 16:37:01,persegiMerah,857,184,123,120,90,92,87,95,3,3,True,0.3771419634981453
2025-01-08 16:37:01,persegiMerah,850,184,127,119,21,86,20,87,1,1,True,0.18052470361230802
2025-01-08 16:37:01,Fail to pick,850,184,0,0,0,0,0,0,0,0,False,0
2025-01-08 16:37:01,persegiMerah,853,188,126,120,14,57,13,55,1,2,True,0.24805394024413163
2025-01-08 16:37:01,Fail to pick,853,188,0,0,0,0,0,0,0,0,False,0
2025-01-08 16:37:01,persegiMerah,856,187,124,120,61,5,57,5,4,0,True,0.4768736916262448
2025-01-08 16:37:01,Merah,856,187,tensor(124.0064),tensor(120.6036),148,79,149,78,1,1,True,0.0004992485046386719
2025-01-08 16:37:01,Fail to pick,856,187,0,0,0,0,0,0,0,0,False,0
2025-01-08 16:37:01,persegiMerah,851,183,126,118,99,77,101,74,2,3,True,0.34116284373161865
2025-01-08 16:37:01,Fail to pick,851,183,0,0,0,0,0,0,0,0,False,0
2025-01-08 16:37:01,persegiMerah,854,186,130,121,12,18,10,13,2,5,True,0.14673546646420066
2025-01-08 16:37:01,Fail to pick,854,186,0,0,0,0,0,0,0,0,False,0
2025-01-08 16:37:02,persegiMerah,819,215,131,128,168,89,171,85,3,4,True,0.469857451123037
2025-01-08 16:37:02,persegiMerah,819,219,138,128,18,22,13,25,5,3,True,0.3973147136944075
2025-01-08 16:37:02,Fail to pick,819,219,0,0,0,0,0,0,0,0,False,0
2025-01-08 16:37:02,persegiMerah,813,216,135,125,84,84,80,87,4,3,True,0.4232557101024179
2025-01-08 16:37:02,Fail to pick,813,216,0,0,0,0,0,0,0,0,False,0
2025-01-08 16:37:12,persegiKuning,850,187,112,120,125,33,128,32,3,1,True,0.15109742862614783
2025-01-08 16:37:12,persegiKuning,844,184,112,122,127,45,125,46,2,1,True,0.4425710738783494
2025-01-08 16:37:12,Kuning,844,184,tensor(112.2474),tensor(122.0651),148,78,150,75,2,3,True,0.0005004405975341797
2025-01-08 16:37:12,Fail to pick,844,184,0,0,0,0,0,0,0,0,False,0
2025-01-08 16:37:12,persegiKuning,840,182,115,123,57,75,60,76,3,1,True,0.1611355418788486
2025-01-08 16:37:12,Fail to pick,840,182,0,0,0,0,0,0,0,0,False,0
2025-01-08 16:37:13,persegiKuning,842,182,107,124,159,95,159,99,0,4,True,0.3412518587917215
2025-01-08 16:37:13,Fail to pick,842,182,0,0,0,0,0,0,0,0,False,0
2025-01-08 16:37:13,persegiKuning,841,183,115,123,124,38,122,34,2,4,True,0.4651829100736118
2025-01-08 16:37:13,Kuning,841,183,tensor(115.7565),tensor(123.7475),149,77,145,80,4,3,True,0.0004935264587402344
2025-01-08 16:37:13,Fail to pick,841,183,0,0,0,0,0,0,0,0,False,0
2025-01-08 16:37:13,persegiKuning,844,185,115,122,166,28,167,32,1,4,False,0.20825684774093883
2025-01-08 16:37:13,Fail to pick,844,185,0,0,0,0,0,0,0,0,False,0
2025-01-08 16:37:13,persegiKuning,841,183,116,123,54,85,49,86,5,1,True,0.422446460436839
2025-01-08 16:37:13,Fail to pick,841,183,0,0,0,0,0,0,0,0,False,0
2025-01-08 16:46:08,persegiKuning,801,69,115,135,165,48,162,43,3,5,True,0.3299320081364765
2025-01-08 16:46:08,Kuning,801,69,tensor(115.1476),tensor(135.7437),180,74,184,69,4,5,True,0.0004992485046386719
2025-01-08 16:46:09,persegiKuning,812,91,115,130,19,90,14,93,5,3,True,0.41302145340846097
2025-01-08 16:46:09,persegiKuning,841,115,115,127,62,30,57,28,5,2,True,0.28262512766873527
2025-01-08 16:46:09,persegiKuning,810,71,118,134,12,18,8,21,4,3,False,0.3814974851383123
2025-01-08 16:46:14,persegiKuning,811,74,110,134,187,59,187,59,0,0,True,0.4907993545366517
2025-01-08 16:46:14,Kuning,811,74,tensor(110.1224),tensor(134.8349),179,75,175,79,4,4,True,0.0
2025-01-08 16:46:14,Fail to pick,811,74,0,0,0,0,0,0,0,0,False,0
2025-01-08 16:46:20,persegiMerah,212,376,136,137,50,53,50,53,0,0,True,0.16645066373295717
2025-01-08 16:46:20,persegiMerah,217,379,133,134,3,61,-2,59,5,2,True,0.20810225681248623
2025-01-08 16:46:20,Fail to pick,217,379,0,0,0,0,0,0,0,0,False,0
2025-01-08 16:46:21,persegiMerah,224,378,131,131,108,18,107,20,1,2,True,0.3629319188244975
2025-01-08 16:46:21,Merah,224,378,tensor(131.8242),tensor(131.1603),95,20,95,22,0,2,True,0.0004987716674804688
2025-01-08 16:46:21,Fail to pick,224,378,0,0,0,0,0,0,0,0,False,0
2025-01-08 16:46:21,persegiMerah,229,381,134,128,100,67,101,64,1,3,True,0.1918070929985523
2025-01-08 16:46:21,Fail to pick,229,381,0,0,0,0,0,0,0,0,False,0
2025-01-08 16:46:21,persegiMerah,222,379,134,129,19,71,21,68,2,3,True,0.16437941029919823
2025-01-08 16:46:21,Fail to pick,222,379,0,0,0,0,0,0,0,0,False,0
2025-01-08 16:46:21,persegiMerah,227,377,135,132,16,48,16,46,0,2,True,0.4797352842424958
2025-01-08 16:46:21,Fail to pick,227,377,0,0,0,0,0,0,0,0,False,0
2025-01-08 16:46:21,persegiMerah,215,389,139,130,154,26,150,23,4,3,True,0.1783348318331247
2025-01-08 16:46:21,persegiMerah,217,385,133,129,164,43,163,38,1,5,True,0.4641328939517926
2025-01-08 16:46:21,Fail to pick,217,385,0,0,0,0,0,0,0,0,False,0
2025-01-08 16:46:21,persegiMerah,177,403,148,129,40,94,41,91,1,3,True,0.13906260636214918
2025-01-08 16:46:21,persegiMerah,247,370,132,131,111,7,106,5,5,2,True,0.3818653490941649
2025-01-08 16:46:22,persegiMerah,228,380,137,129,27,18,26,20,1,2,True,0.4202192002722597
2025-01-08 16:46:22,persegiMerah,222,381,134,129,119,84,118,85,1,1,True,0.14374978022908833
2025-01-08 16:46:22,Merah,222,381,tensor(134.6949),tensor(129.9213),94,20,97,17,3,3,True,0.0
2025-01-08 16:46:22,Fail to pick,222,381,0,0,0,0,0,0,0,0,False,0
2025-01-08 16:46:22,persegiMerah,226,379,134,128,179,78,176,77,3,1,True,0.3185999460115815
2025-01-08 16:46:22,Fail to pick,226,379,0,0,0,0,0,0,0,0,False,0
2025-01-08 16:46:22,persegiMerah,222,382,136,130,123,69,121,73,2,4,True,0.39256805007865825
2025-01-08 16:46:22,Fail to pick,222,382,0,0,0,0,0,0,0,0,False,0
2025-01-08 16:46:22,persegiMerah,231,381,132,127,162,44,162,45,0,1,True,0.40895758498301993
2025-01-08 16:46:22,Fail to pick,231,381,0,0,0,0,0,0,0,0,False,0
2025-01-08 16:46:22,persegiMerah,223,381,130,124,137,92,137,88,0,4,True,0.4184535808951615
2025-01-08 16:46:22,Fail to pick,223,381,0,0,0,0,0,0,0,0,False,0
2025-01-08 16:46:22,persegiMerah,223,383,130,124,118,67,122,69,4,2,True,0.13094088197159667
2025-01-08 16:46:22,Fail to pick,223,383,0,0,0,0,0,0,0,0,False,0
2025-01-08 16:46:33,persegiMerah,79,438,158,145,191,46,190,46,1,0,True,0.46214698355075956
2025-01-08 16:46:33,Merah,79,438,tensor(158.2506),tensor(145.5509),78,7,77,5,1,2,True,0.0
2025-01-08 16:46:34,persegiMerah,104,493,180,150,34,10,34,12,0,2,True,0.30111216304913074
2025-01-08 16:46:34,persegiMerah,104,488,180,148,141,24,136,19,5,5,True,0.4173590871052507
2025-01-08 16:46:34,Merah,104,488,tensor(180.4414),tensor(148.5371),64,9,63,10,1,1,True,0.000499725341796875
2025-01-08 16:46:34,Fail to pick,104,488,0,0,0,0,0,0,0,0,False,0
2025-01-08 16:50:19,persegiMerah,852,81,121,133,90,10,94,13,4,3,True,0.12363974608406735
2025-01-08 16:50:19,Merah,852,81,tensor(121.3953),tensor(133.6500),177,78,173,74,4,4,True,0.0005049705505371094
2025-01-08 16:50:20,persegiMerah,832,86,131,126,167,82,171,79,4,3,True,0.14103327436767865
2025-01-08 16:50:20,Merah,832,86,tensor(131.2303),tensor(126.8065),176,77,179,73,3,4,True,0.0
2025-01-08 16:50:20,persegiMerah,842,86,135,125,101,95,100,96,1,1,True,0.4768950825833983
2025-01-08 16:50:20,persegiMerah,843,82,139,129,155,17,157,13,2,4,True,0.32237721181905477
2025-01-08 16:50:20,Fail to pick,843,82,0,0,0,0,0,0,0,0,False,0
2025-01-08 16:50:21,persegiMerah,836,85,138,128,45,70,43,69,2,1,False,0.46771047971124713
2025-01-08 16:50:21,Fail to pick,836,85,0,0,0,0,0,0,0,0,False,0
2025-01-08 16:50:34,persegiMerah,226,370,123,119,71,65,71,66,0,1,False,0.3358962494136386
2025-01-08 16:50:34,persegiMerah,223,373,124,121,47,28,46,24,1,4,False,0.11180539135351326
2025-01-08 16:50:34,Fail to pick,223,373,0,0,0,0,0,0,0,0,False,0
2025-01-08 16:50:34,persegiMerah,226,375,123,118,189,60,184,63,5,3,True,0.39444636471384564
2025-01-08 16:50:34,Merah,226,375,tensor(123.1626),tensor(118.6794),95,20,95,16,0,4,True,0.0004985332489013672
2025-01-08 16:50:34,Fail to pick,226,375,0,0,0,0,0,0,0,0,False,0
2025-01-08 16:50:34,persegiMerah,225,377,124,118,56,78,51,82,5,4,True,0.33706001489176785
2025-01-08 16:50:34,Fail to pick,225,377,0,0,0,0,0,0,0,0,False,0
2025-01-08 16:50:34,persegiMerah,227,375,124,117,83,90,78,92,5,2,True,0.41578351330900254
2025-01-08 16:50:34,Fail to pick,227,375,0,0,0,0,0,0,0,0,False,0
2025-01-08 16:50:34,persegiMerah,226,377,125,119,42,30,37,25,5,5,True,0.494403890236895
2025-01-08 16:50:34,Fail to pick,226,377,0,0,0,0,0,0,0,0,False,0
2025-01-08 16:50:34,persegiMerah,225,376,121,119,44,21,48,24,4,3,True,0.16914512370473628
2025-01-08 16:50:34,Fail to pick,225,376,0,0,0,0,0,0,0,0,False,0
2025-01-08 16:50:34,persegiMerah,226,377,124,120,131,4,126,3,5,1,False,0.1253272504860723
2025-01-08 16:50:34,Fail to pick,226,377,0,0,0,0,0,0,0,0,False,0
2025-01-08 16:50:34,persegiMerah,227,374,124,118,153,95,151,92,2,3,True,0.2689733049912276
2025-01-08 16:50:34,Fail to pick,227,374,0,0,0,0,0,0,0,0,False,0
2025-01-08 16:50:35,persegiMerah,225,375,125,119,94,53,98,56,4,3,True,0.2325365150337477
2025-01-08 16:50:35,Fail to pick,225,375,0,0,0,0,0,0,0,0,False,0
2025-01-08 16:50:35,persegiMerah,227,379,129,118,95,96,95,91,0,5,False,0.18226059824457597
2025-01-08 16:50:35,Fail to pick,227,379,0,0,0,0,0,0,0,0,False,0
2025-01-08 16:50:35,persegiMerah,222,378,126,119,81,56,84,57,3,1,True,0.16853361622523902
2025-01-08 16:50:35,Merah,222,378,tensor(126.5558),tensor(119.7149),95,20,97,22,2,2,True,0.0
2025-01-08 16:50:35,Fail to pick,222,378,0,0,0,0,0,0,0,0,False,0
2025-01-08 16:50:35,persegiMerah,232,375,128,120,131,7,128,10,3,3,True,0.26116607296309347
2025-01-08 16:50:35,persegiMerah,227,373,123,118,99,10,98,12,1,2,False,0.34734299489602516
2025-01-08 16:50:35,Fail to pick,227,373,0,0,0,0,0,0,0,0,False,0
2025-01-08 16:50:35,persegiMerah,226,373,128,119,150,41,151,37,1,4,True,0.20702863394615273
2025-01-08 16:50:35,Fail to pick,226,373,0,0,0,0,0,0,0,0,False,0
2025-01-08 16:50:35,persegiMerah,224,375,127,121,29,18,24,19,5,1,True,0.26220298467195674
2025-01-08 16:50:35,Fail to pick,224,375,0,0,0,0,0,0,0,0,False,0
2025-01-08 16:50:35,persegiMerah,221,381,122,116,194,77,192,74,2,3,True,0.1399250787433738
2025-01-08 16:50:35,Fail to pick,221,381,0,0,0,0,0,0,0,0,False,0
2025-01-08 16:50:35,persegiMerah,221,381,127,117,86,61,88,59,2,2,True,0.3680200553039118
2025-01-08 16:50:35,Fail to pick,221,381,0,0,0,0,0,0,0,0,False,0
2025-01-08 16:50:36,persegiMerah,218,382,127,115,187,3,186,5,1,2,True,0.4005943391920421
2025-01-08 16:50:36,Fail to pick,218,382,0,0,0,0,0,0,0,0,False,0
2025-01-08 16:50:48,persegiBiru,818,411,125,109,117,56,117,54,0,2,True,0.3614926779880513
2025-01-08 16:50:48,Biru,818,411,tensor(125.3978),tensor(109.9639),85,75,83,72,2,3,True,0.0
2025-01-08 16:50:48,persegiBiru,812,415,122,111,153,48,157,50,4,2,True,0.23924351381740092
2025-01-08 16:50:48,Fail to pick,812,415,0,0,0,0,0,0,0,0,False,0
2025-01-08 16:50:49,persegiBiru,833,389,115,112,186,35,187,32,1,3,True,0.36702660019768873
2025-01-08 16:50:49,Biru,833,389,tensor(115.0609),tensor(112.2122),91,77,89,76,2,1,True,0.0
2025-01-08 16:51:06,persegiMerah,891,479,128,131,59,28,59,23,0,5,True,0.1279918067187137
2025-01-08 16:51:06,persegiMerah,865,484,133,129,103,49,98,50,5,1,True,0.42888418364149505
2025-01-08 16:51:07,persegiMerah,882,477,134,131,76,89,77,87,1,2,True,0.25634134082550086
2025-01-08 16:51:07,Merah,882,477,tensor(134.9921),tensor(131.7888),67,81,62,81,5,0,True,0.0
2025-01-08 16:51:07,persegiMerah,875,478,142,124,116,31,115,26,1,5,True,0.1410204576194894
2025-01-08 16:51:07,Fail to pick,875,478,0,0,0,0,0,0,0,0,False,0
2025-01-08 16:51:07,persegiMerah,886,478,142,122,60,91,55,89,5,2,True,0.2764360891034069
2025-01-08 16:51:07,persegiMerah,882,481,130,118,160,41,163,38,3,3,True,0.4757507638420626
2025-01-08 16:51:07,Fail to pick,882,481,0,0,0,0,0,0,0,0,False,0
2025-01-08 16:51:07,persegiMerah,896,476,137,117,93,0,94,-2,1,2,True,0.13622358700315781
2025-01-08 16:51:16,persegiMerah,282,97,143,136,158,38,153,42,5,4,True,0.33247763647088246
2025-01-08 16:51:16,Merah,282,97,tensor(143.5819),tensor(136.5239),173,26,175,22,2,4,True,0.0
2025-01-08 16:51:16,persegiMerah,290,97,154,138,153,31,152,35,1,4,True,0.41414877707828246
2025-01-08 16:51:16,Fail to pick,290,97,0,0,0,0,0,0,0,0,False,0
2025-01-08 16:51:16,persegiMerah,290,97,152,139,147,80,148,83,1,3,True,0.3408081886643187
2025-01-08 16:51:16,Fail to pick,290,97,0,0,0,0,0,0,0,0,False,0
2025-01-08 16:51:17,persegiMerah,281,97,141,137,156,78,156,76,0,2,True,0.49920897588952695
2025-01-08 16:51:17,Fail to pick,281,97,0,0,0,0,0,0,0,0,False,0
2025-01-08 16:51:17,persegiMerah,290,94,148,133,20,87,20,82,0,5,True,0.4652845763140172
2025-01-08 16:51:17,Fail to pick,290,94,0,0,0,0,0,0,0,0,False,0
2025-01-08 16:51:17,persegiMerah,293,97,146,136,97,76,100,78,3,2,True,0.1268089590882122
2025-01-08 16:51:17,Fail to pick,293,97,0,0,0,0,0,0,0,0,False,0
2025-01-08 16:51:17,persegiMerah,297,97,149,136,70,98,68,96,2,2,True,0.1920142979962697
2025-01-08 16:51:17,Fail to pick,297,97,0,0,0,0,0,0,0,0,False,0
2025-01-08 16:51:17,persegiMerah,287,101,143,138,197,49,199,49,2,0,True,0.2529979117287589
2025-01-08 16:51:17,persegiMerah,288,101,152,137,165,40,163,40,2,0,True,0.2262545626711619
2025-01-08 16:51:17,Fail to pick,288,101,0,0,0,0,0,0,0,0,False,0
2025-01-08 16:51:17,persegiMerah,286,99,145,135,109,66,110,66,1,0,False,0.12130608704660029
2025-01-08 16:51:17,Merah,286,99,tensor(145.7284),tensor(135.7936),172,26,168,23,4,3,True,0.0
2025-01-08 16:51:17,Fail to pick,286,99,0,0,0,0,0,0,0,0,False,0
2025-01-08 16:51:17,persegiMerah,293,97,141,134,154,53,150,50,4,3,True,0.3198838971365557
2025-01-08 16:51:17,Fail to pick,293,97,0,0,0,0,0,0,0,0,False,0
2025-01-08 16:51:17,persegiMerah,293,98,145,136,168,76,169,73,1,3,True,0.4118186409719794
2025-01-08 16:51:17,Fail to pick,293,98,0,0,0,0,0,0,0,0,False,0
2025-01-08 16:51:18,persegiMerah,286,101,140,136,184,58,182,62,2,4,True,0.1540518469124642
2025-01-08 16:51:18,Fail to pick,286,101,0,0,0,0,0,0,0,0,False,0
2025-01-08 16:51:18,persegiMerah,287,100,155,135,47,3,44,-1,3,4,True,0.30143596751819307
2025-01-08 16:51:18,Fail to pick,287,100,0,0,0,0,0,0,0,0,False,0
2025-01-08 16:51:18,persegiMerah,286,102,142,137,53,64,52,59,1,5,True,0.4401272637382766
2025-01-08 16:51:18,Fail to pick,286,102,0,0,0,0,0,0,0,0,False,0
2025-01-08 16:51:18,persegiMerah,282,99,143,138,128,44,129,41,1,3,True,0.14785138704257125
2025-01-08 16:51:18,Fail to pick,282,99,0,0,0,0,0,0,0,0,False,0
2025-01-08 16:51:18,persegiMerah,299,102,152,136,175,87,172,83,3,4,True,0.4598376885004509
2025-01-08 16:51:18,persegiMerah,294,100,146,136,90,11,85,9,5,2,True,0.2082829636249371
2025-01-08 16:51:18,Fail to pick,294,100,0,0,0,0,0,0,0,0,False,0
2025-01-08 16:51:18,persegiMerah,297,99,148,136,155,82,151,84,4,2,True,0.3277797012806447
2025-01-08 16:51:18,Fail to pick,297,99,0,0,0,0,0,0,0,0,False,0
2025-01-08 16:51:18,persegiMerah,291,98,145,134,82,43,78,47,4,4,True,0.47565795071933814
2025-01-08 16:51:18,Merah,291,98,tensor(145.9509),tensor(134.4158),172,26,174,28,2,2,True,0.0004987716674804688
2025-01-08 16:51:18,Fail to pick,291,98,0,0,0,0,0,0,0,0,False,0
2025-01-08 16:51:19,persegiMerah,296,99,151,133,191,75,193,74,2,1,True,0.46457728482399074
2025-01-08 16:51:19,Fail to pick,296,99,0,0,0,0,0,0,0,0,False,0
2025-01-08 16:51:19,persegiMerah,284,99,141,137,23,21,18,16,5,5,True,0.19605394226429165
2025-01-08 16:51:19,persegiMerah,292,99,147,138,157,99,160,94,3,5,True,0.3978768074711303
2025-01-08 16:51:19,Fail to pick,292,99,0,0,0,0,0,0,0,0,False,0
2025-01-08 16:51:19,persegiMerah,291,99,145,132,135,47,135,49,0,2,True,0.2901015716057478
2025-01-08 16:51:19,Fail to pick,291,99,0,0,0,0,0,0,0,0,False,0
2025-01-08 16:51:19,persegiMerah,295,98,143,138,137,86,135,89,2,3,True,0.21349178488437048
2025-01-08 16:51:19,Fail to pick,295,98,0,0,0,0,0,0,0,0,False,0
2025-01-08 16:51:19,persegiMerah,288,101,140,135,70,3,72,7,2,4,True,0.41516744677378437
2025-01-08 16:51:19,Fail to pick,288,101,0,0,0,0,0,0,0,0,False,0
2025-01-08 17:41:29,persegiMerah,331,180,153,140,87,90,83,94,4,4,True,0.10501965614135456
2025-01-08 17:41:29,Merah,331,180,tensor(153.0044),tensor(140.8750),150,30,150,27,0,3,True,0.0005002021789550781
2025-01-08 17:41:29,persegiMerah,302,163,152,140,150,86,149,83,1,3,True,0.17185133415567122
2025-01-08 17:41:30,persegiMerah,325,178,162,143,113,59,114,57,1,2,True,0.3069056257306253
2025-01-08 17:41:30,persegiMerah,303,164,151,142,5,82,4,79,1,3,True,0.4965751121988847
2025-01-08 17:41:30,persegiMerah,304,169,147,141,89,18,85,17,4,1,True,0.36958293478736615
2025-01-08 17:41:30,Fail to pick,304,169,0,0,0,0,0,0,0,0,False,0
2025-01-08 17:41:30,persegiMerah,308,166,151,141,97,73,101,74,4,1,False,0.14892349994329362
2025-01-08 17:41:30,Fail to pick,308,166,0,0,0,0,0,0,0,0,False,0
2025-01-08 17:41:30,persegiMerah,306,167,145,138,111,41,115,37,4,4,False,0.4279317250918855
2025-01-08 17:41:30,Merah,306,167,tensor(145.8163),tensor(138.8176),153,28,155,23,2,5,True,0.0005085468292236328
2025-01-08 17:41:30,Fail to pick,306,167,0,0,0,0,0,0,0,0,False,0
2025-01-08 17:41:30,persegiMerah,310,167,150,141,116,89,118,87,2,2,True,0.2688716833969428
2025-01-08 17:41:30,Fail to pick,310,167,0,0,0,0,0,0,0,0,False,0
2025-01-08 17:41:30,persegiMerah,322,169,151,140,29,81,24,82,5,1,True,0.37894088705828854
2025-01-08 17:41:31,persegiMerah,314,174,151,144,144,12,145,8,1,4,True,0.40640364288109154
2025-01-08 17:41:31,Fail to pick,314,174,0,0,0,0,0,0,0,0,False,0
2025-01-08 17:41:31,persegiMerah,304,173,149,137,154,17,152,15,2,2,True,0.3619271004269462
2025-01-08 17:41:31,persegiMerah,307,165,147,140,179,77,182,75,3,2,True,0.1961726411755744
2025-01-08 17:41:31,Fail to pick,307,165,0,0,0,0,0,0,0,0,False,0
2025-01-08 17:41:31,persegiMerah,310,162,151,140,174,18,176,22,2,4,True,0.1296547861961937
2025-01-08 17:41:31,Fail to pick,310,162,0,0,0,0,0,0,0,0,False,0
2025-01-08 17:41:31,persegiMerah,313,167,149,136,185,38,183,36,2,2,False,0.37420077800789675
2025-01-08 17:41:31,Fail to pick,313,167,0,0,0,0,0,0,0,0,False,0
2025-01-08 17:41:31,persegiMerah,315,166,150,142,150,63,147,67,3,4,True,0.35440650888230796
2025-01-08 17:41:31,Fail to pick,315,166,0,0,0,0,0,0,0,0,False,0
2025-01-08 17:41:31,persegiMerah,309,172,149,145,3,25,6,21,3,4,True,0.2151392897884068
2025-01-08 17:41:31,Fail to pick,309,172,0,0,0,0,0,0,0,0,False,0
2025-01-08 17:41:31,persegiMerah,311,165,153,140,60,28,60,29,0,1,False,0.3491367966876333
2025-01-08 17:41:31,Merah,311,165,tensor(153.8470),tensor(140.9405),154,28,154,28,0,0,True,0.0
2025-01-08 17:41:31,Fail to pick,311,165,0,0,0,0,0,0,0,0,False,0
2025-01-08 17:41:32,persegiMerah,307,171,148,142,114,30,109,27,5,3,True,0.10959609971779778
2025-01-08 17:41:32,Fail to pick,307,171,0,0,0,0,0,0,0,0,False,0
2025-01-08 17:41:32,persegiMerah,308,164,147,142,195,92,193,91,2,1,True,0.42262891630945143
2025-01-08 17:41:32,Fail to pick,308,164,0,0,0,0,0,0,0,0,False,0
2025-01-08 17:41:32,persegiMerah,311,162,151,141,14,49,10,47,4,2,True,0.19750278623125253
2025-01-08 17:41:32,Fail to pick,311,162,0,0,0,0,0,0,0,0,False,0
2025-01-08 17:41:32,persegiMerah,305,167,146,142,131,45,135,44,4,1,True,0.41584575081830233
2025-01-08 17:41:32,Fail to pick,305,167,0,0,0,0,0,0,0,0,False,0
2025-01-08 17:41:37,persegiMerah,158,83,120,123,8,40,4,43,4,3,True,0.15207099626613815
2025-01-08 17:41:37,Merah,158,83,tensor(120.0756),tensor(123.5481),176,14,176,17,0,3,True,0.0
2025-01-08 17:41:37,persegiMerah,158,89,120,124,68,71,65,71,3,0,True,0.1416862037879263
2025-01-08 17:41:37,Fail to pick,158,89,0,0,0,0,0,0,0,0,False,0
2025-01-08 17:41:37,persegiMerah,158,89,119,125,62,84,62,86,0,2,False,0.34595187689991636
2025-01-08 17:41:37,Fail to pick,158,89,0,0,0,0,0,0,0,0,False,0
2025-01-08 17:41:38,persegiMerah,158,86,117,124,171,12,175,8,4,4,True,0.11269934740425686
2025-01-08 17:41:38,Fail to pick,158,86,0,0,0,0,0,0,0,0,False,0
2025-01-08 17:41:38,persegiMerah,161,85,120,121,169,77,169,81,0,4,True,0.24192566541079571
2025-01-08 17:41:38,Fail to pick,161,85,0,0,0,0,0,0,0,0,False,0
2025-01-08 17:41:38,persegiMerah,156,88,118,122,191,4,190,1,1,3,True,0.1983198524077368
2025-01-08 17:41:38,Fail to pick,156,88,0,0,0,0,0,0,0,0,False,0
2025-01-08 17:41:38,persegiMerah,183,98,127,125,24,99,21,102,3,3,True,0.30179793760166473
2025-01-08 17:41:38,persegiMerah,159,88,114,124,179,80,179,83,0,3,True,0.33787631843165733
2025-01-08 17:41:38,persegiMerah,156,91,115,120,46,20,41,21,5,1,True,0.45409583945849985
2025-01-08 17:41:38,Fail to pick,156,91,0,0,0,0,0,0,0,0,False,0
2025-01-08 17:41:38,persegiMerah,173,99,122,129,76,4,71,7,5,3,True,0.37862207115909763
2025-01-08 17:41:38,Merah,173,99,tensor(122.9080),tensor(129.4677),172,16,176,20,4,4,True,0.0
2025-01-08 17:41:38,persegiMerah,180,100,126,128,162,24,160,21,2,3,True,0.15964515543437086
2025-01-08 17:41:38,Fail to pick,180,100,0,0,0,0,0,0,0,0,False,0
2025-01-08 17:41:38,persegiMerah,152,85,111,127,72,11,74,13,2,2,True,0.2758904521528307
2025-01-08 17:41:39,persegiMerah,157,86,117,129,34,69,37,72,3,3,True,0.39551565077641515
2025-01-08 17:41:39,Fail to pick,157,86,0,0,0,0,0,0,0,0,False,0
2025-01-08 17:41:39,persegiMerah,156,89,117,126,124,33,125,34,1,1,True,0.13234068767013307
2025-01-08 17:41:39,Fail to pick,156,89,0,0,0,0,0,0,0,0,False,0
2025-01-08 17:41:39,persegiMerah,155,89,115,125,70,7,67,6,3,1,True,0.3168695674191072
2025-01-08 17:41:39,Fail to pick,155,89,0,0,0,0,0,0,0,0,False,0
2025-01-08 17:41:39,persegiMerah,157,84,116,124,55,33,53,29,2,4,True,0.19090643425445825
2025-01-08 17:41:39,Fail to pick,157,84,0,0,0,0,0,0,0,0,False,0
2025-01-08 17:41:39,persegiMerah,157,84,116,124,149,5,150,8,1,3,True,0.2910743924149827
2025-01-08 17:41:39,Fail to pick,157,84,0,0,0,0,0,0,0,0,False,0
2025-01-08 17:41:39,persegiMerah,160,91,119,123,55,57,50,53,5,4,True,0.1806769363138014
2025-01-08 17:41:39,Fail to pick,160,91,0,0,0,0,0,0,0,0,False,0
2025-01-08 17:41:39,persegiMerah,178,102,124,129,77,50,76,54,1,4,True,0.2568820720204287
2025-01-08 17:41:39,persegiMerah,164,83,117,122,96,41,99,42,3,1,True,0.33342127550403916
2025-01-08 17:41:39,Merah,164,83,tensor(117.6065),tensor(122.4317),176,15,173,14,3,1,True,0.0004990100860595703
2025-01-08 17:41:39,persegiMerah,155,84,116,127,65,75,67,77,2,2,True,0.1863554194081857
2025-01-08 17:41:39,Fail to pick,155,84,0,0,0,0,0,0,0,0,False,0
2025-01-08 17:41:40,persegiMerah,151,90,113,123,53,13,49,9,4,4,False,0.4565397033476081
2025-01-08 17:41:40,Fail to pick,151,90,0,0,0,0,0,0,0,0,False,0
2025-01-08 17:41:40,persegiMerah,165,86,115,124,22,35,21,39,1,4,True,0.1649853081947546
2025-01-08 17:41:40,persegiMerah,174,102,125,130,70,67,68,67,2,0,True,0.12101964559167318
2025-01-08 17:41:40,persegiMerah,155,88,114,124,0,78,-4,82,4,4,True,0.30815258326518324
2025-01-08 17:41:40,persegiMerah,160,88,118,121,173,3,175,-1,2,4,True,0.3719645179444985
2025-01-08 17:41:40,Fail to pick,160,88,0,0,0,0,0,0,0,0,False,0
2025-01-08 17:41:40,persegiMerah,160,82,120,123,177,96,174,98,3,2,True,0.1871726568528755
2025-01-08 17:41:40,Fail to pick,160,82,0,0,0,0,0,0,0,0,False,0
2025-01-08 17:41:40,persegiMerah,161,88,119,122,110,44,113,39,3,5,True,0.19119343430255986
2025-01-08 17:41:40,Fail to pick,161,88,0,0,0,0,0,0,0,0,False,0
2025-01-08 17:41:40,persegiMerah,161,90,119,124,184,22,188,23,4,1,True,0.3606311703112207
2025-01-08 17:41:40,Merah,161,90,tensor(119.9039),tensor(124.5099),175,14,178,17,3,3,True,0.0004982948303222656
2025-01-08 17:41:40,Fail to pick,161,90,0,0,0,0,0,0,0,0,False,0
2025-01-08 17:41:40,persegiMerah,151,87,115,127,197,2,193,0,4,2,True,0.47588023491932707
2025-01-08 17:41:41,persegiMerah,152,88,114,126,101,40,103,41,2,1,True,0.4315276279217799
2025-01-08 17:41:41,Fail to pick,152,88,0,0,0,0,0,0,0,0,False,0
2025-01-08 17:41:41,persegiMerah,158,88,117,125,40,94,42,93,2,1,True,0.15852388378547266
2025-01-08 17:41:41,Fail to pick,158,88,0,0,0,0,0,0,0,0,False,0
2025-01-08 17:41:41,persegiMerah,158,84,116,123,10,3,13,5,3,2,True,0.23324344560937857
2025-01-08 17:41:41,Fail to pick,158,84,0,0,0,0,0,0,0,0,False,0
2025-01-08 17:41:41,persegiMerah,158,87,115,121,195,7,190,8,5,1,True,0.21593954519447897
2025-01-08 17:41:41,Fail to pick,158,87,0,0,0,0,0,0,0,0,False,0
2025-01-08 17:41:41,persegiMerah,162,86,122,123,142,79,142,82,0,3,True,0.42914737597289043
2025-01-08 17:41:41,Fail to pick,162,86,0,0,0,0,0,0,0,0,False,0
2025-01-08 17:41:41,persegiMerah,159,92,119,122,35,56,39,60,4,4,True,0.4408767808491184
2025-01-08 17:41:41,Fail to pick,159,92,0,0,0,0,0,0,0,0,False,0
2025-01-08 17:41:41,persegiMerah,155,90,116,122,86,35,89,33,3,2,True,0.3951722323242063
2025-01-08 17:41:41,Fail to pick,155,90,0,0,0,0,0,0,0,0,False,0
2025-01-08 17:41:41,persegiMerah,160,90,121,121,135,73,133,68,2,5,True,0.2518941913650211
2025-01-08 17:41:41,Fail to pick,160,90,0,0,0,0,0,0,0,0,False,0
2025-01-08 17:41:41,persegiMerah,176,102,129,129,26,86,22,90,4,4,True,0.28611068503693804
2025-01-08 17:41:41,Merah,176,102,tensor(129.0288),tensor(129.8940),171,16,175,20,4,4,True,0.0
2025-01-08 17:41:42,persegiMerah,157,88,116,122,97,93,99,89,2,4,True,0.11301963268386342
2025-01-08 17:41:42,persegiMerah,159,86,118,122,64,58,67,61,3,3,True,0.35067684939083343
2025-01-08 17:41:42,Fail to pick,159,86,0,0,0,0,0,0,0,0,False,0
2025-01-08 17:41:42,persegiMerah,160,90,118,125,169,93,168,97,1,4,False,0.43942709475824127
2025-01-08 17:41:42,Fail to pick,160,90,0,0,0,0,0,0,0,0,False,0
2025-01-08 17:41:42,persegiMerah,165,84,122,123,161,79,162,83,1,4,True,0.15259800915973837
2025-01-08 17:41:42,Fail to pick,165,84,0,0,0,0,0,0,0,0,False,0
2025-01-08 17:41:42,persegiMerah,160,85,121,124,122,43,125,41,3,2,False,0.43111932415832865
2025-01-08 17:41:42,Fail to pick,160,85,0,0,0,0,0,0,0,0,False,0
2025-01-08 17:41:42,persegiMerah,160,84,117,120,150,66,149,68,1,2,False,0.21593816591709253
2025-01-08 17:41:42,Fail to pick,160,84,0,0,0,0,0,0,0,0,False,0
2025-01-08 17:41:42,persegiMerah,157,87,117,123,9,5,9,4,0,1,True,0.3089433478752084
2025-01-08 17:41:42,Fail to pick,157,87,0,0,0,0,0,0,0,0,False,0
2025-01-08 17:41:42,persegiMerah,158,87,116,123,134,69,136,72,2,3,True,0.15325478770099554
2025-01-08 17:41:42,Fail to pick,158,87,0,0,0,0,0,0,0,0,False,0
2025-01-08 17:41:42,persegiMerah,163,90,120,123,8,48,10,47,2,1,True,0.31583085638972036
2025-01-08 17:41:42,Fail to pick,163,90,0,0,0,0,0,0,0,0,False,0
2025-01-08 17:41:43,persegiMerah,153,86,113,123,10,23,13,21,3,2,True,0.4591274323721438
2025-01-08 17:41:43,Merah,153,86,tensor(113.4522),tensor(123.7809),176,14,176,9,0,5,True,0.0
2025-01-08 17:41:43,persegiMerah,162,90,120,124,142,31,140,28,2,3,True,0.10884863282597293
2025-01-08 17:41:43,Fail to pick,162,90,0,0,0,0,0,0,0,0,False,0
2025-01-08 17:41:43,persegiMerah,155,85,114,126,109,83,105,85,4,2,True,0.23253757809457595
2025-01-08 17:41:43,Fail to pick,155,85,0,0,0,0,0,0,0,0,False,0
2025-01-08 17:41:43,persegiMerah,184,104,124,127,72,26,73,30,1,4,True,0.3183944622964433
2025-01-08 17:41:43,persegiMerah,150,89,113,126,0,90,-2,88,2,2,True,0.19844120579742894
2025-01-08 17:41:43,persegiMerah,156,84,122,124,59,53,54,50,5,3,True,0.48414341945403483
2025-01-08 17:41:43,Fail to pick,156,84,0,0,0,0,0,0,0,0,False,0
2025-01-08 17:41:43,persegiMerah,161,89,121,124,120,5,115,7,5,2,True,0.4828301199838575
2025-01-08 17:41:43,Fail to pick,161,89,0,0,0,0,0,0,0,0,False,0
2025-01-08 17:41:43,persegiMerah,160,84,117,122,32,54,28,53,4,1,True,0.10669756713445273
2025-01-08 17:41:43,Fail to pick,160,84,0,0,0,0,0,0,0,0,False,0
2025-01-08 17:41:43,persegiMerah,159,86,118,121,132,15,133,14,1,1,True,0.4800855783489869
2025-01-08 17:41:43,Fail to pick,159,86,0,0,0,0,0,0,0,0,False,0
2025-01-08 17:41:44,persegiMerah,157,92,117,120,52,40,53,35,1,5,True,0.32076801923958786
2025-01-08 17:41:44,Merah,157,92,tensor(117.7974),tensor(120.5938),174,14,177,13,3,1,True,0.0004942417144775391
2025-01-08 17:41:44,Fail to pick,157,92,0,0,0,0,0,0,0,0,False,0
2025-01-08 17:41:44,persegiMerah,155,85,113,127,101,11,104,10,3,1,True,0.3574326982493149
2025-01-08 17:41:44,Fail to pick,155,85,0,0,0,0,0,0,0,0,False,0
2025-01-08 17:41:44,persegiMerah,157,86,114,125,185,98,189,96,4,2,True,0.19374987560071408
2025-01-08 17:41:44,Fail to pick,157,86,0,0,0,0,0,0,0,0,False,0
2025-01-08 17:41:48,persegiMerah,165,82,128,136,192,73,194,75,2,2,True,0.11088214614705111
2025-01-08 17:41:48,Merah,165,82,tensor(128.8134),tensor(136.7888),177,15,176,13,1,2,True,0.0004985332489013672
2025-01-08 17:41:48,Fail to pick,165,82,0,0,0,0,0,0,0,0,False,0
2025-01-08 17:41:50,persegiMerah,253,166,122,125,77,65,80,62,3,3,True,0.4310375703454524
2025-01-08 17:41:50,Merah,253,166,tensor(122.9637),tensor(125.4147),153,23,153,18,0,5,True,0.0
2025-01-08 17:41:50,persegiMerah,246,165,122,122,19,90,18,86,1,4,True,0.37842855694629207
2025-01-08 17:41:50,Fail to pick,246,165,0,0,0,0,0,0,0,0,False,0
2025-01-08 17:41:50,persegiMerah,249,166,122,120,9,78,6,80,3,2,True,0.32918016137393874
2025-01-08 17:41:50,Fail to pick,249,166,0,0,0,0,0,0,0,0,False,0
2025-01-08 17:41:50,persegiMerah,241,168,118,121,178,88,177,88,1,0,True,0.17647665802161827
2025-01-08 17:41:50,Fail to pick,241,168,0,0,0,0,0,0,0,0,False,0
2025-01-08 17:41:50,persegiMerah,251,164,119,122,16,47,12,50,4,3,True,0.4964236079848645
2025-01-08 17:41:51,persegiMerah,241,172,119,121,178,7,180,5,2,2,True,0.23291688174197037
2025-01-08 17:41:51,persegiMerah,247,173,120,120,181,47,184,48,3,1,True,0.30453356624127004
2025-01-08 17:41:51,Fail to pick,247,173,0,0,0,0,0,0,0,0,False,0
2025-01-08 17:41:51,persegiMerah,249,163,121,120,144,49,146,50,2,1,True,0.10091800217098675
2025-01-08 17:41:51,persegiMerah,241,170,116,121,50,44,50,47,0,3,True,0.2154374262597739
2025-01-08 17:41:51,Fail to pick,241,170,0,0,0,0,0,0,0,0,False,0
2025-01-08 17:41:51,persegiMerah,236,170,118,122,198,29,197,25,1,4,True,0.42205980316123926
2025-01-08 17:41:51,Fail to pick,236,170,0,0,0,0,0,0,0,0,False,0
2025-01-08 17:41:51,persegiMerah,247,174,121,126,66,16,63,12,3,4,True,0.4085927667821111
2025-01-08 17:41:51,Merah,247,174,tensor(121.7127),tensor(126.1205),151,22,148,24,3,2,True,0.0
2025-01-08 17:41:51,persegiKuning,239,172,115,119,93,97,89,96,4,1,True,0.38086068476828927
2025-01-08 17:41:51,Fail to pick,239,172,0,0,0,0,0,0,0,0,False,0
2025-01-08 17:41:51,persegiMerah,245,172,120,121,97,73,95,68,2,5,True,0.37601212067480394
2025-01-08 17:41:51,Fail to pick,245,172,0,0,0,0,0,0,0,0,False,0
2025-01-08 17:41:51,persegiMerah,269,182,124,123,180,11,183,10,3,1,True,0.10726005902872876
2025-01-08 17:41:51,persegiMerah,244,171,118,121,39,4,40,6,1,2,True,0.3123715575952637
2025-01-08 17:41:52,persegiMerah,241,175,121,126,169,76,164,76,5,0,True,0.3160922680070824
2025-01-08 17:41:52,Fail to pick,241,175,0,0,0,0,0,0,0,0,False,0
2025-01-08 17:41:52,persegiMerah,262,185,123,126,43,97,39,97,4,0,True,0.21720765395505948
2025-01-08 17:41:52,persegiMerah,246,172,126,123,27,92,29,94,2,2,True,0.13601698771994084
2025-01-08 17:41:52,persegiMerah,264,183,123,124,56,37,58,38,2,1,True,0.36833998465065154
2025-01-08 17:41:52,persegiMerah,269,193,123,127,15,83,18,84,3,1,True,0.2084100568624476
2025-01-08 17:41:52,persegiMerah,244,170,122,124,198,76,200,77,2,1,True,0.13546283531072714
2025-01-08 17:41:52,Merah,244,170,tensor(122.3984),tensor(124.3884),152,22,152,19,0,3,True,0.0
2025-01-08 17:41:52,persegiMerah,267,187,122,124,109,2,110,1,1,1,True,0.16748825139115012
2025-01-08 17:41:52,persegiMerah,273,180,129,125,113,58,112,61,1,3,True,0.2991219586632099
2025-01-08 17:41:52,Fail to pick,273,180,0,0,0,0,0,0,0,0,False,0
2025-01-08 17:41:52,persegiMerah,249,171,122,120,72,54,72,57,0,3,True,0.27233826191034416
2025-01-08 17:41:53,persegiMerah,276,187,132,121,140,45,141,45,1,0,True,0.2801274047043494
2025-01-08 17:41:53,persegiMerah,262,189,120,126,187,92,185,90,2,2,True,0.1751386329294743
2025-01-08 17:41:53,persegiMerah,248,162,126,119,50,24,46,25,4,1,True,0.15428150091861714
2025-01-08 17:41:53,persegiMerah,271,187,129,122,168,55,172,55,4,0,True,0.37826317403535026
2025-01-08 17:41:53,persegiMerah,255,179,124,122,15,15,12,10,3,5,True,0.2697221619912643
2025-01-08 17:41:53,persegiMerah,258,184,125,124,125,22,121,21,4,1,True,0.3751339810641443
2025-01-08 17:41:53,Fail to pick,258,184,0,0,0,0,0,0,0,0,False,0
2025-01-08 17:41:53,persegiMerah,259,185,131,125,0,55,-4,56,4,1,True,0.3245989312073588
2025-01-08 17:41:53,Merah,259,185,tensor(131.0258),tensor(125.0998),148,23,147,22,1,1,True,0.0004990100860595703
2025-01-08 17:41:53,Fail to pick,259,185,0,0,0,0,0,0,0,0,False,0
2025-01-08 17:41:53,persegiMerah,272,180,134,123,108,40,110,41,2,1,True,0.45001728962783893
2025-01-08 17:41:53,persegiMerah,233,163,125,118,28,20,26,19,2,1,True,0.18522283462651667
2025-01-08 17:41:54,persegiMerah,234,165,122,116,132,5,136,2,4,3,True,0.2519238208907938
2025-01-08 17:41:54,Fail to pick,234,165,0,0,0,0,0,0,0,0,False,0
2025-01-08 17:41:54,persegiMerah,251,170,128,118,187,84,188,82,1,2,True,0.24455433319413353
2025-01-08 17:41:54,persegiMerah,254,181,128,123,161,45,164,43,3,2,True,0.3534405246088098
2025-01-08 17:41:54,persegiMerah,229,172,125,122,115,6,117,4,2,2,True,0.36169320124748205
2025-01-08 17:41:54,persegiMerah,241,179,123,122,188,9,186,13,2,4,True,0.4075936896817892
2025-01-08 17:41:55,persegiMerah,243,161,123,121,134,76,129,79,5,3,False,0.196486001705573
2025-01-08 17:41:55,Merah,243,161,tensor(123.0385),tensor(121.1300),155,22,154,23,1,1,True,0.0005280971527099609
2025-01-08 17:41:55,persegiMerah,248,162,127,123,161,14,163,17,2,3,True,0.1080282052397891
2025-01-08 17:41:55,Fail to pick,248,162,0,0,0,0,0,0,0,0,False,0
2025-01-08 17:41:55,persegiMerah,273,189,129,123,184,30,180,31,4,1,True,0.23643818425199933
2025-01-08 17:41:55,persegiMerah,250,164,124,122,83,45,81,48,2,3,True,0.41668653987960835
2025-01-08 17:41:55,persegiMerah,246,169,123,125,34,21,31,24,3,3,False,0.33160923362867184
2025-01-08 17:41:55,Fail to pick,246,169,0,0,0,0,0,0,0,0,False,0
2025-01-08 17:41:55,persegiMerah,270,189,121,125,105,53,107,56,2,3,True,0.27165917691436176
2025-01-08 17:41:55,persegiMerah,248,167,125,127,50,75,48,77,2,2,False,0.23171392943259694
2025-01-08 17:41:56,persegiMerah,245,172,120,122,139,62,143,62,4,0,True,0.21334823101745878
2025-01-08 17:41:56,Fail to pick,245,172,0,0,0,0,0,0,0,0,False,0
2025-01-08 17:41:56,persegiMerah,236,174,114,122,37,67,35,64,2,3,True,0.24786304289278172
2025-01-08 17:41:56,Fail to pick,236,174,0,0,0,0,0,0,0,0,False,0
2025-01-08 17:41:56,persegiMerah,250,182,122,129,144,12,142,8,2,4,True,0.24307743536334697
2025-01-08 17:41:56,Merah,250,182,tensor(122.8593),tensor(129.3115),149,23,144,18,5,5,True,0.0
2025-01-08 17:41:59,persegiMerah,278,187,135,130,23,89,24,92,1,3,True,0.4100697680623544
2025-01-08 17:41:59,Merah,278,187,tensor(135.7632),tensor(130.1636),148,25,148,24,0,1,True,0.0
2025-01-08 17:41:59,persegiMerah,277,187,133,131,60,2,62,1,2,1,True,0.24654715421794593
2025-01-08 17:41:59,Fail to pick,277,187,0,0,0,0,0,0,0,0,False,0
2025-01-08 17:42:00,persegiMerah,278,182,131,129,64,46,59,45,5,1,True,0.335283444875227
2025-01-08 17:42:00,Fail to pick,278,182,0,0,0,0,0,0,0,0,False,0
2025-01-08 17:42:00,persegiMerah,286,183,134,130,21,77,20,81,1,4,True,0.34269283566199715
2025-01-08 17:42:00,Fail to pick,286,183,0,0,0,0,0,0,0,0,False,0
2025-01-08 17:42:00,persegiMerah,255,158,126,130,131,29,135,24,4,5,True,0.48601537142359486
2025-01-08 17:42:00,persegiMerah,253,165,127,124,11,40,11,35,0,5,True,0.3343002232556428
2025-01-08 17:42:00,Fail to pick,253,165,0,0,0,0,0,0,0,0,False,0
2025-01-08 17:42:00,persegiMerah,284,189,135,127,98,36,95,31,3,5,True,0.12187898175432062
2025-01-08 17:42:00,persegiMerah,259,164,123,126,192,55,188,53,4,2,True,0.37208606900295704
2025-01-08 17:42:00,persegiMerah,286,184,131,128,30,32,28,29,2,3,True,0.21656628708670822
2025-01-08 17:42:00,persegiMerah,273,186,129,129,27,64,28,65,1,1,True,0.34454344494681166
2025-01-08 17:42:00,persegiMerah,244,166,120,125,18,77,19,74,1,3,True,0.44771405262762154
2025-01-08 17:42:00,Merah,244,166,tensor(120.0541),tensor(125.6056),153,22,155,19,2,3,True,0.0
2025-01-08 17:42:00,persegiMerah,274,186,128,131,165,28,165,27,0,1,True,0.3150086969454998
2025-01-08 17:42:01,persegiMerah,281,193,129,125,46,40,50,43,4,3,False,0.27901378599539994
2025-01-08 17:42:01,Fail to pick,281,193,0,0,0,0,0,0,0,0,False,0
2025-01-08 17:42:01,persegiMerah,275,186,129,130,92,7,90,4,2,3,True,0.354315816299541
2025-01-08 17:42:01,Fail to pick,275,186,0,0,0,0,0,0,0,0,False,0
2025-01-08 17:42:01,persegiMerah,290,185,131,124,50,9,54,9,4,0,True,0.2090037036697542
2025-01-08 17:42:01,persegiMerah,282,186,131,128,57,90,55,91,2,1,True,0.40650487789225187
2025-01-08 17:42:01,Fail to pick,282,186,0,0,0,0,0,0,0,0,False,0
2025-01-08 17:42:01,persegiMerah,255,166,121,124,71,82,74,78,3,4,True,0.14422463230684493
2025-01-08 17:42:01,persegiMerah,275,187,130,130,91,37,86,37,5,0,True,0.2843908401526837
2025-01-08 17:42:01,persegiMerah,247,168,121,127,157,77,158,81,1,4,True,0.1539852444325343
2025-01-08 17:42:01,persegiMerah,277,191,134,129,56,71,56,75,0,4,True,0.3102319463047284
2025-01-08 17:42:01,persegiMerah,278,190,134,130,140,76,136,75,4,1,True,0.10916223312929395
2025-01-08 17:42:01,Fail to pick,278,190,0,0,0,0,0,0,0,0,False,0
2025-01-08 17:42:02,persegiMerah,253,164,127,127,9,10,11,10,2,0,True,0.11933503270583881
2025-01-08 17:42:02,Merah,253,164,tensor(127.1531),tensor(127.1783),154,23,158,18,4,5,True,0.0005061626434326172
2025-01-08 17:42:02,persegiMerah,274,189,133,131,169,1,166,3,3,2,True,0.10443847429321199
2025-01-08 17:42:02,persegiMerah,251,169,123,127,108,56,104,56,4,0,False,0.39180132781600874
2025-01-08 17:42:02,persegiMerah,278,191,134,129,116,8,116,8,0,0,True,0.22527748155727578
2025-01-08 17:42:02,persegiMerah,249,171,122,120,11,98,6,93,5,5,True,0.36714041380318074
2025-01-08 17:42:02,persegiMerah,248,165,128,123,182,20,183,17,1,3,True,0.3438220121427549
2025-01-08 17:42:02,Fail to pick,248,165,0,0,0,0,0,0,0,0,False,0
2025-01-08 17:42:02,persegiMerah,275,188,133,129,168,8,171,3,3,5,True,0.4114792331789222
2025-01-08 17:42:02,persegiMerah,274,191,135,128,191,68,188,63,3,5,True,0.3232419001673743
2025-01-08 17:42:02,Fail to pick,274,191,0,0,0,0,0,0,0,0,False,0
2025-01-08 17:42:02,persegiMerah,276,194,134,129,173,27,176,23,3,4,True,0.18267211157070573
2025-01-08 17:42:02,Fail to pick,276,194,0,0,0,0,0,0,0,0,False,0
2025-01-08 17:42:03,persegiMerah,252,164,127,125,22,82,24,81,2,1,True,0.45085917919537666
2025-01-08 17:42:03,Merah,252,164,tensor(127.6841),tensor(125.5494),154,23,153,26,1,3,True,0.0004987716674804688
2025-01-08 17:42:03,persegiMerah,278,188,132,130,185,22,189,21,4,1,True,0.29793032694369126
2025-01-08 17:42:03,persegiMerah,281,185,130,127,39,85,39,83,0,2,False,0.2766419370527964
2025-01-08 17:42:03,Fail to pick,281,185,0,0,0,0,0,0,0,0,False,0
2025-01-08 17:42:03,persegiMerah,276,194,131,129,86,65,87,68,1,3,True,0.36096748298436443
2025-01-08 17:42:03,Fail to pick,276,194,0,0,0,0,0,0,0,0,False,0
2025-01-08 17:42:03,persegiMerah,251,163,129,125,3,20,6,22,3,2,True,0.2950793880131515
2025-01-08 17:42:03,persegiMerah,276,195,128,128,27,46,22,42,5,4,True,0.23416222537469908
2025-01-08 17:42:03,persegiMerah,274,188,134,130,138,25,139,28,1,3,True,0.2276977139860928
2025-01-08 17:42:03,Fail to pick,274,188,0,0,0,0,0,0,0,0,False,0
2025-01-08 17:42:03,persegiMerah,244,162,122,131,24,26,25,29,1,3,True,0.1319224804644315
2025-01-08 17:42:03,persegiMerah,242,169,120,133,12,8,13,3,1,5,True,0.4431811005370042
2025-01-08 17:42:03,Fail to pick,242,169,0,0,0,0,0,0,0,0,False,0
2025-01-08 17:42:04,persegiMerah,252,162,123,126,136,3,136,-2,0,5,False,0.15032209650966322
2025-01-08 17:42:04,persegiMerah,241,169,121,129,92,63,89,59,3,4,True,0.14277643314189425
2025-01-08 17:42:04,Merah,241,169,tensor(121.9415),tensor(129.0757),153,22,150,19,3,3,True,0.0
2025-01-08 17:42:04,persegiMerah,255,160,121,128,94,13,98,11,4,2,True,0.3914730028651716
2025-01-08 17:42:04,persegiMerah,255,174,123,125,49,92,50,93,1,1,False,0.49347660822316863
2025-01-08 17:42:04,persegiMerah,284,194,132,127,127,87,128,89,1,2,True,0.17228258091159676
2025-01-08 17:42:04,persegiMerah,276,192,131,130,129,21,127,24,2,3,True,0.23876833478187698
2025-01-08 17:42:04,Fail to pick,276,192,0,0,0,0,0,0,0,0,False,0
2025-01-08 17:42:04,persegiMerah,243,167,122,125,9,47,4,45,5,2,True,0.4219920770391117
2025-01-08 17:42:04,persegiMerah,285,189,132,126,132,46,129,41,3,5,True,0.16906398189860838
2025-01-08 17:42:04,persegiMerah,248,163,122,124,25,64,23,62,2,2,False,0.21986677635323099
2025-01-08 17:42:05,persegiMerah,248,166,129,124,66,72,69,68,3,4,True,0.34040358632008705
2025-01-08 17:42:05,Fail to pick,248,166,0,0,0,0,0,0,0,0,False,0
2025-01-08 17:42:05,persegiMerah,251,170,129,129,146,22,145,20,1,2,True,0.317409212300684
2025-01-08 17:42:05,Fail to pick,251,170,0,0,0,0,0,0,0,0,False,0
2025-01-08 17:42:05,persegiMerah,251,162,126,127,158,17,157,17,1,0,True,0.3095617104000139
2025-01-08 17:42:05,Merah,251,162,tensor(126.9428),tensor(127.7394),155,23,159,20,4,3,True,0.0
2025-01-08 17:42:05,Fail to pick,251,162,0,0,0,0,0,0,0,0,False,0
2025-01-08 17:42:05,persegiMerah,244,167,121,128,45,46,45,42,0,4,True,0.15122689781915738
2025-01-08 17:42:05,Fail to pick,244,167,0,0,0,0,0,0,0,0,False,0
2025-01-08 17:42:05,persegiMerah,275,185,127,129,120,59,118,54,2,5,True,0.16183035224030784
2025-01-08 17:42:05,persegiMerah,281,192,132,129,56,3,53,-2,3,5,True,0.15733529503390464
2025-01-08 17:42:05,Fail to pick,281,192,0,0,0,0,0,0,0,0,False,0
2025-01-08 17:42:05,persegiMerah,284,187,134,128,80,18,75,22,5,4,True,0.31270327002524106
2025-01-08 17:42:05,Fail to pick,284,187,0,0,0,0,0,0,0,0,False,0
2025-01-08 17:42:05,persegiMerah,271,188,130,131,109,42,106,45,3,3,True,0.2581262098911148
2025-01-08 17:42:05,persegiMerah,278,189,134,129,114,85,116,80,2,5,True,0.2879133699462001
2025-01-08 17:42:05,Fail to pick,278,189,0,0,0,0,0,0,0,0,False,0
2025-01-08 17:42:06,persegiMerah,271,178,132,129,54,8,57,9,3,1,True,0.1864814686214647
2025-01-08 17:42:06,persegiMerah,244,171,127,127,74,24,69,19,5,5,True,0.42457264163103425
2025-01-08 17:42:06,persegiMerah,279,185,133,129,119,96,118,98,1,2,False,0.43975966593135074
2025-01-08 17:42:06,persegiMerah,282,188,134,129,182,30,186,33,4,3,True,0.4089444563225474
2025-01-08 17:42:06,Merah,282,188,tensor(134.6466),tensor(129.0081),147,26,143,22,4,4,True,0.0
2025-01-08 17:42:06,Fail to pick,282,188,0,0,0,0,0,0,0,0,False,0
2025-01-08 17:42:06,persegiMerah,288,187,134,128,12,75,13,79,1,4,True,0.22213511647919582
2025-01-08 17:42:06,Fail to pick,288,187,0,0,0,0,0,0,0,0,False,0
2025-01-08 17:42:06,persegiMerah,284,191,133,125,131,50,132,51,1,1,False,0.49809840800357297
2025-01-08 17:42:06,Fail to pick,284,191,0,0,0,0,0,0,0,0,False,0
2025-01-08 17:42:06,persegiMerah,243,168,121,127,95,40,93,41,2,1,True,0.342442917122631
2025-01-08 17:42:06,persegiMerah,278,192,134,126,178,61,182,59,4,2,True,0.1530217304048124
2025-01-08 17:42:06,persegiMerah,281,186,133,128,122,8,125,9,3,1,True,0.43823794414570016
2025-01-08 17:42:06,Fail to pick,281,186,0,0,0,0,0,0,0,0,False,0
2025-01-08 17:42:06,persegiMerah,285,186,134,126,20,91,15,95,5,4,True,0.470628275346646
2025-01-08 17:42:06,Fail to pick,285,186,0,0,0,0,0,0,0,0,False,0
2025-01-08 17:42:07,persegiMerah,285,184,135,128,114,96,114,91,0,5,True,0.24244812663042858
2025-01-08 17:42:07,Fail to pick,285,184,0,0,0,0,0,0,0,0,False,0
2025-01-08 17:42:07,persegiMerah,275,189,133,132,94,18,96,14,2,4,False,0.4170331451323779
2025-01-08 17:42:07,persegiMerah,278,181,131,130,28,87,26,87,2,0,True,0.17677468318904804
2025-01-08 17:42:07,Fail to pick,278,181,0,0,0,0,0,0,0,0,False,0
2025-01-08 17:42:07,persegiMerah,285,185,134,126,40,29,36,29,4,0,True,0.3251630260479612
2025-01-08 17:42:07,Fail to pick,285,185,0,0,0,0,0,0,0,0,False,0
2025-01-08 17:42:07,persegiMerah,277,183,136,127,180,7,182,4,2,3,True,0.1637360820709864
2025-01-08 17:42:07,Merah,277,183,tensor(136.1776),tensor(127.5102),149,25,146,28,3,3,True,0.000499725341796875
2025-01-08 17:42:07,Fail to pick,277,183,0,0,0,0,0,0,0,0,False,0
2025-01-08 17:42:07,persegiMerah,278,195,132,125,198,43,193,44,5,1,True,0.4892835363297794
2025-01-08 17:42:07,persegiMerah,247,166,125,122,56,41,54,45,2,4,False,0.32819379735369847
2025-01-08 17:42:15,persegiMerah,238,208,136,145,76,47,79,43,3,4,False,0.47781271538559245
2025-01-08 17:42:15,Merah,238,208,tensor(136.8301),tensor(145.2623),142,22,146,17,4,5,True,0.0
2025-01-08 17:42:15,persegiMerah,224,199,135,144,166,42,164,45,2,3,True,0.4395744084212273
2025-01-08 17:42:16,persegiMerah,222,203,134,140,96,84,96,80,0,4,True,0.16054243224893044
2025-01-08 17:42:16,Merah,222,203,tensor(134.6248),tensor(140.6812),143,20,146,19,3,1,True,0.0004992485046386719
2025-01-08 17:42:16,Fail to pick,222,203,0,0,0,0,0,0,0,0,False,0
2025-01-08 17:42:16,persegiMerah,223,200,138,147,136,19,133,20,3,1,True,0.22451418594255856
2025-01-08 17:42:16,Fail to pick,223,200,0,0,0,0,0,0,0,0,False,0
2025-01-08 17:42:16,persegiMerah,220,205,133,142,121,35,119,34,2,1,True,0.3818076253449244
2025-01-08 17:42:16,Fail to pick,220,205,0,0,0,0,0,0,0,0,False,0
2025-01-08 17:42:16,persegiMerah,235,201,131,137,96,89,92,91,4,2,True,0.10326609019642596
2025-01-08 17:42:16,persegiMerah,226,197,135,135,88,46,83,50,5,4,False,0.14397643869191812
2025-01-08 17:42:16,Fail to pick,226,197,0,0,0,0,0,0,0,0,False,0
2025-01-08 17:42:16,persegiMerah,249,219,139,142,187,34,190,33,3,1,True,0.32860283931880885
2025-01-08 17:42:16,persegiMerah,221,193,131,133,67,54,70,49,3,5,True,0.25816522017784793
2025-01-08 17:42:17,persegiMerah,220,201,129,131,40,5,42,7,2,2,True,0.41779106170808955
2025-01-08 17:42:17,Fail to pick,220,201,0,0,0,0,0,0,0,0,False,0
2025-01-08 17:42:17,persegiMerah,224,191,133,132,101,28,98,28,3,0,True,0.3345810790130558
2025-01-08 17:42:17,persegiMerah,213,200,128,131,59,18,56,13,3,5,True,0.2066385163405264
2025-01-08 17:42:17,persegiMerah,211,198,131,131,18,27,15,31,3,4,True,0.4508052602545026
2025-01-08 17:42:17,Merah,211,198,tensor(131.3482),tensor(131.2087),145,19,145,15,0,4,True,0.0005085468292236328
2025-01-08 17:42:17,Fail to pick,211,198,0,0,0,0,0,0,0,0,False,0
2025-01-08 17:42:17,persegiMerah,214,190,122,127,198,17,195,13,3,4,True,0.2683698307273384
2025-01-08 17:42:17,Fail to pick,214,190,0,0,0,0,0,0,0,0,False,0
2025-01-08 17:42:17,persegiMerah,226,205,130,130,130,19,130,17,0,2,True,0.497260326813989
2025-01-08 17:42:17,persegiMerah,218,198,129,128,132,32,128,29,4,3,True,0.23500608327295347
2025-01-08 17:42:17,Fail to pick,218,198,0,0,0,0,0,0,0,0,False,0
2025-01-08 17:42:17,persegiMerah,219,199,128,127,92,16,95,12,3,4,True,0.38685349420714343
2025-01-08 17:42:17,Fail to pick,219,199,0,0,0,0,0,0,0,0,False,0
2025-01-08 17:42:17,persegiMerah,217,193,128,125,182,64,185,59,3,5,True,0.2320159037014256
2025-01-08 17:42:17,Fail to pick,217,193,0,0,0,0,0,0,0,0,False,0
2025-01-08 17:42:18,persegiMerah,227,206,130,127,56,27,55,26,1,1,True,0.21378024633556653
2025-01-08 17:42:18,persegiMerah,211,198,124,125,120,10,118,8,2,2,True,0.15795882634231675
2025-01-08 17:42:18,persegiMerah,215,189,124,126,2,81,4,76,2,5,True,0.42884340283987243
2025-01-08 17:42:18,Fail to pick,215,189,0,0,0,0,0,0,0,0,False,0
2025-01-08 17:42:18,persegiMerah,221,203,135,130,173,5,172,5,1,0,True,0.4784605822892445
2025-01-08 17:42:18,persegiMerah,235,193,133,127,75,76,74,74,1,2,True,0.37658794002900764
2025-01-08 17:42:18,Merah,235,193,tensor(133.2635),tensor(127.5547),146,21,147,16,1,5,True,0.0
2025-01-08 17:42:18,persegiMerah,218,195,132,129,107,2,103,-2,4,4,True,0.10123380374603115
2025-01-08 17:42:18,persegiMerah,171,157,123,130,21,58,19,54,2,4,True,0.2324571003212706
2025-01-08 17:42:18,persegiMerah,223,190,141,125,100,22,103,22,3,0,True,0.23571774645129856
2025-01-08 17:42:18,persegiMerah,218,202,133,130,77,1,73,4,4,3,True,0.4574586200552314
2025-01-08 17:42:19,persegiMerah,209,195,135,126,156,84,158,80,2,4,True,0.12169848449467482
2025-01-08 17:42:19,Fail to pick,209,195,0,0,0,0,0,0,0,0,False,0
2025-01-08 17:42:19,persegiMerah,207,193,133,126,86,38,84,34,2,4,True,0.2374178440617406
2025-01-08 17:42:19,Fail to pick,207,193,0,0,0,0,0,0,0,0,False,0
2025-01-08 17:42:24,persegiMerah,359,111,120,125,15,12,13,10,2,2,True,0.1540807267888854
2025-01-08 17:42:24,Merah,359,111,tensor(120.4491),tensor(125.8365),169,33,173,34,4,1,True,0.0004990100860595703
2025-01-08 17:42:25,persegiMerah,371,114,123,123,87,69,82,71,5,2,True,0.43867288883246225
2025-01-08 17:42:26,persegiMerah,374,108,118,124,178,30,173,25,5,5,True,0.3428575012149848
2025-01-08 17:42:26,Merah,374,108,tensor(118.8574),tensor(124.6627),170,34,167,29,3,5,True,0.0004982948303222656
2025-01-08 17:42:26,Fail to pick,374,108,0,0,0,0,0,0,0,0,False,0
2025-01-08 17:42:27,persegiMerah,384,136,122,129,156,88,160,90,4,2,True,0.1385008316234187
2025-01-08 17:42:28,persegiKuning,372,116,117,125,85,14,87,17,2,3,True,0.29190111154976606
2025-01-08 17:42:28,Kuning,372,116,tensor(117.1208),tensor(125.1631),167,34,169,36,2,2,True,0.0
2025-01-08 17:42:28,persegiKuning,357,114,107,122,171,78,171,77,0,1,True,0.485055212286967
2025-01-08 17:42:29,persegiMerah,292,136,117,129,2,28,4,27,2,1,True,0.3112783037049297
2025-01-08 17:42:29,Merah,292,136,tensor(117.3870),tensor(129.5239),162,27,157,27,5,0,True,0.0
2025-01-08 17:42:29,persegiMerah,291,135,118,130,138,65,135,63,3,2,True,0.4294965579828316
2025-01-08 17:42:29,Fail to pick,291,135,0,0,0,0,0,0,0,0,False,0
2025-01-08 17:42:29,persegiKuning,320,125,110,128,151,81,146,77,5,4,True,0.17986550125524234
2025-01-08 17:42:29,persegiKuning,353,148,120,129,15,49,10,50,5,1,False,0.28997348711522763
2025-01-08 17:42:30,persegiKuning,372,142,114,129,172,57,172,52,0,5,True,0.1333571233216907
2025-01-08 17:42:30,persegiKuning,340,152,118,132,186,14,186,16,0,2,True,0.3820318542887773
2025-01-08 17:42:30,persegiKuning,353,116,101,117,141,51,136,53,5,2,True,0.3311508691893338
2025-01-08 17:42:30,Kuning,353,116,tensor(101.8137),tensor(117.5603),167,32,170,31,3,1,True,0.0
2025-01-08 17:42:35,persegiMerah,205,266,130,133,112,64,107,65,5,1,True,0.4318162837130374
2025-01-08 17:42:35,Merah,205,266,tensor(130.7833),tensor(133.4213),126,18,129,13,3,5,True,0.0004994869232177734
2025-01-08 17:42:35,persegiMerah,211,258,135,135,15,25,11,22,4,3,True,0.15613083719500873
2025-01-08 17:42:35,Fail to pick,211,258,0,0,0,0,0,0,0,0,False,0
2025-01-08 17:42:35,persegiMerah,205,264,132,134,33,5,35,4,2,1,True,0.16379949878185857
2025-01-08 17:42:35,Fail to pick,205,264,0,0,0,0,0,0,0,0,False,0
2025-01-08 17:42:36,persegiMerah,216,261,139,133,188,80,185,82,3,2,True,0.10430577994498683
2025-01-08 17:42:36,persegiMerah,218,260,135,131,193,57,196,58,3,1,True,0.4656383128796824
2025-01-08 17:42:36,Fail to pick,218,260,0,0,0,0,0,0,0,0,False,0
2025-01-08 17:42:36,persegiMerah,182,307,149,132,44,89,44,87,0,2,True,0.33281859762975086
2025-01-08 17:42:36,persegiMerah,206,267,132,133,89,80,93,84,4,4,False,0.12334128507767353
2025-01-08 17:42:36,persegiMerah,203,265,129,131,185,26,185,24,0,2,True,0.41710013221288855
2025-01-08 17:42:36,Fail to pick,203,265,0,0,0,0,0,0,0,0,False,0
2025-01-08 17:42:36,persegiMerah,202,266,131,131,141,26,138,23,3,3,True,0.15545531290553294
2025-01-08 17:42:36,Fail to pick,202,266,0,0,0,0,0,0,0,0,False,0
2025-01-08 17:42:36,persegiMerah,207,258,134,130,16,64,17,65,1,1,True,0.18377063489967657
2025-01-08 17:42:36,Merah,207,258,tensor(134.1835),tensor(130.6019),128,19,131,23,3,4,True,0.00049591064453125
2025-01-08 17:42:36,Fail to pick,207,258,0,0,0,0,0,0,0,0,False,0
2025-01-08 17:42:36,persegiMerah,214,258,134,135,171,47,167,51,4,4,True,0.11649032449347115
2025-01-08 17:42:36,Fail to pick,214,258,0,0,0,0,0,0,0,0,False,0
2025-01-08 17:42:36,persegiMerah,205,265,132,133,51,61,48,64,3,3,True,0.4126971755771619
2025-01-08 17:42:36,Fail to pick,205,265,0,0,0,0,0,0,0,0,False,0
2025-01-08 17:42:37,persegiMerah,225,280,138,132,108,91,111,90,3,1,True,0.12764275973817543
2025-01-08 17:42:37,persegiMerah,213,264,131,132,67,56,69,51,2,5,True,0.1550017558897269
2025-01-08 17:42:37,persegiMerah,206,265,134,135,179,93,182,93,3,0,True,0.4102982770430993
2025-01-08 17:42:37,Fail to pick,206,265,0,0,0,0,0,0,0,0,False,0
2025-01-08 17:42:37,persegiMerah,198,265,131,134,159,48,159,51,0,3,True,0.4725053960355111
2025-01-08 17:42:37,Fail to pick,198,265,0,0,0,0,0,0,0,0,False,0
2025-01-08 17:42:37,persegiMerah,212,263,130,134,192,33,192,29,0,4,True,0.22064199790822606
2025-01-08 17:42:37,persegiMerah,193,266,130,135,112,3,111,3,1,0,True,0.40972434391600376
2025-01-08 17:42:37,persegiMerah,212,260,134,135,102,78,97,76,5,2,True,0.17531024971407888
2025-01-08 17:42:37,persegiMerah,196,264,127,134,2,64,3,59,1,5,True,0.16049196021909673
2025-01-08 17:42:37,Merah,196,264,tensor(127.9956),tensor(134.2546),126,18,123,21,3,3,True,0.0004992485046386719
2025-01-08 17:42:37,persegiMerah,203,261,132,133,103,2,102,0,1,2,True,0.16090852801938224
2025-01-08 17:42:37,Fail to pick,203,261,0,0,0,0,0,0,0,0,False,0
2025-01-08 17:42:37,persegiMerah,213,256,133,131,172,46,167,46,5,0,True,0.4597947038330573
2025-01-08 17:42:38,persegiMerah,201,265,132,133,10,10,6,8,4,2,True,0.45333863159620136
2025-01-08 17:42:38,persegiMerah,204,265,135,134,137,77,141,73,4,4,True,0.11054431807105934
2025-01-08 17:42:38,Fail to pick,204,265,0,0,0,0,0,0,0,0,False,0
2025-01-08 17:42:38,persegiMerah,215,268,137,133,165,91,169,95,4,4,True,0.18742534738205927
2025-01-08 17:42:38,persegiMerah,201,266,131,132,116,38,115,37,1,1,False,0.11876682467807896
2025-01-08 17:42:38,persegiMerah,200,269,131,133,74,16,71,12,3,4,True,0.30123278662737973
2025-01-08 17:42:38,Fail to pick,200,269,0,0,0,0,0,0,0,0,False,0
2025-01-08 17:42:38,persegiMerah,203,263,135,133,172,69,168,68,4,1,True,0.43895579285354835
2025-01-08 17:42:38,Fail to pick,203,263,0,0,0,0,0,0,0,0,False,0
2025-01-08 17:42:38,persegiMerah,222,264,139,135,4,78,6,80,2,2,True,0.4847341107409455
2025-01-08 17:42:38,persegiMerah,212,268,138,132,145,5,142,4,3,1,True,0.2306307733842885
2025-01-08 17:42:38,Merah,212,268,tensor(138.4817),tensor(132.9750),125,19,129,19,4,0,True,0.0
2025-01-08 17:42:38,persegiMerah,201,267,131,137,178,74,178,69,0,5,True,0.443876893033207
2025-01-08 17:42:39,persegiMerah,214,264,142,136,196,44,194,45,2,1,True,0.22501222566463808
2025-01-08 17:42:39,persegiMerah,204,267,132,132,3,6,-1,9,4,3,True,0.15330059556277142
2025-01-08 17:42:39,persegiMerah,220,274,138,130,63,34,64,35,1,1,True,0.47960167743137405
2025-01-08 17:42:39,persegiMerah,209,271,136,133,188,89,187,88,1,1,True,0.22651550637312
2025-01-08 17:42:39,persegiMerah,219,277,142,130,5,6,0,7,5,1,True,0.21004875601452244
2025-01-08 17:42:39,persegiMerah,205,268,135,130,180,35,175,33,5,2,True,0.413708357785604
2025-01-08 17:42:39,persegiMerah,211,267,137,132,68,22,71,22,3,0,True,0.490909247442758
2025-01-08 17:42:39,Fail to pick,211,267,0,0,0,0,0,0,0,0,False,0
2025-01-08 17:42:39,persegiMerah,212,256,134,136,97,36,100,32,3,4,True,0.22092359448866114
2025-01-08 17:42:39,Merah,212,256,tensor(134.6810),tensor(136.6219),128,19,123,19,5,0,True,0.0005002021789550781
2025-01-08 17:42:40,persegiMerah,206,266,132,133,64,20,67,15,3,5,True,0.17552217484862856
2025-01-08 17:42:40,persegiMerah,206,265,135,134,73,55,73,53,0,2,True,0.16294344706991995
2025-01-08 17:42:40,Fail to pick,206,265,0,0,0,0,0,0,0,0,False,0
2025-01-08 17:42:40,persegiMerah,206,272,135,131,15,39,13,42,2,3,True,0.22300971019299218
2025-01-08 17:42:40,Fail to pick,206,272,0,0,0,0,0,0,0,0,False,0
2025-01-08 17:42:40,persegiMerah,210,266,137,133,193,76,191,76,2,0,True,0.4203171802106348
2025-01-08 17:42:40,Fail to pick,210,266,0,0,0,0,0,0,0,0,False,0
2025-01-08 17:42:40,persegiMerah,208,264,135,132,148,47,143,49,5,2,True,0.23792737006973497
2025-01-08 17:42:40,Fail to pick,208,264,0,0,0,0,0,0,0,0,False,0
2025-01-08 17:42:40,persegiMerah,203,266,134,134,197,20,194,16,3,4,False,0.21130071620398008
2025-01-08 17:42:40,Fail to pick,203,266,0,0,0,0,0,0,0,0,False,0
2025-01-08 17:42:40,persegiMerah,204,265,136,133,17,33,15,28,2,5,True,0.2719548145130875
2025-01-08 17:42:40,Fail to pick,204,265,0,0,0,0,0,0,0,0,False,0
2025-01-08 17:42:40,persegiMerah,222,274,138,132,173,10,169,6,4,4,True,0.10340241935292274
2025-01-08 17:42:40,persegiMerah,204,264,135,134,56,72,55,69,1,3,True,0.12383777938553933
2025-01-08 17:42:41,persegiMerah,203,275,139,136,46,41,48,43,2,2,True,0.14713427491966993
2025-01-08 17:42:41,Merah,203,275,tensor(139.0047),tensor(136.1954),123,18,124,16,1,2,True,0.0
2025-01-08 17:42:41,persegiMerah,202,265,135,133,126,83,130,79,4,4,True,0.19774796599445504
2025-01-08 17:42:41,persegiMerah,222,262,141,133,71,52,69,54,2,2,True,0.4430772347165618
2025-01-08 17:42:41,persegiMerah,212,260,136,133,18,76,17,74,1,2,True,0.10717174285847393
2025-01-08 17:42:41,persegiMerah,211,264,137,132,77,59,75,63,2,4,True,0.2397070196355785
2025-01-08 17:42:41,Fail to pick,211,264,0,0,0,0,0,0,0,0,False,0
2025-01-08 17:42:41,persegiMerah,211,264,138,135,185,65,182,65,3,0,True,0.20021184847099183
2025-01-08 17:42:41,Fail to pick,211,264,0,0,0,0,0,0,0,0,False,0
2025-01-08 17:42:41,persegiMerah,213,276,141,130,69,93,69,90,0,3,True,0.12047755785087243
2025-01-08 17:42:41,persegiMerah,199,271,137,135,3,81,0,76,3,5,True,0.16343155948593382
2025-01-08 17:42:41,persegiMerah,221,267,141,133,48,87,47,82,1,5,True,0.3737753560972057
2025-01-08 17:42:42,persegiMerah,221,278,139,132,67,84,67,82,0,2,True,0.4840695587585053
2025-01-08 17:42:42,persegiMerah,214,271,146,134,98,57,100,56,2,1,True,0.4320685590504433
2025-01-08 17:42:42,Merah,214,271,tensor(146.1734),tensor(134.9359),124,19,124,20,0,1,True,0.0005860328674316406
2025-01-08 17:42:42,Fail to pick,214,271,0,0,0,0,0,0,0,0,False,0
2025-01-08 17:42:42,persegiMerah,212,267,143,131,30,38,32,40,2,2,True,0.3902178577470038
2025-01-08 17:42:42,Fail to pick,212,267,0,0,0,0,0,0,0,0,False,0
2025-01-08 17:42:42,persegiMerah,206,268,133,132,197,20,195,16,2,4,False,0.18089114090465222
2025-01-08 17:42:42,Fail to pick,206,268,0,0,0,0,0,0,0,0,False,0
2025-01-08 17:42:52,persegiMerah,843,535,127,115,95,6,94,8,1,2,True,0.16960445273008623
2025-01-08 17:42:52,Merah,843,535,tensor(127.5851),tensor(115.3885),51,78,51,74,0,4,True,0.0004985332489013672
2025-01-08 17:42:52,persegiMerah,838,537,125,114,32,64,31,62,1,2,True,0.2298765306292765
2025-01-08 17:42:52,Fail to pick,838,537,0,0,0,0,0,0,0,0,False,0
2025-01-08 17:42:53,persegiMerah,831,533,126,118,96,25,94,20,2,5,True,0.34468637383444034
2025-01-08 17:42:53,Fail to pick,831,533,0,0,0,0,0,0,0,0,False,0
2025-01-08 17:42:53,persegiMerah,841,535,123,110,191,54,194,58,3,4,True,0.3707538434107235
2025-01-08 17:42:53,persegiMerah,826,536,126,112,83,28,84,32,1,4,True,0.29852592045784676
2025-01-08 17:42:54,persegiMerah,847,546,133,113,76,91,73,90,3,1,True,0.27837757828018284
2025-01-08 17:42:54,persegiMerah,860,545,127,114,177,25,181,28,4,3,True,0.13611920620435744
2025-01-08 17:42:54,Merah,860,545,tensor(127.9818),tensor(114.4324),48,79,48,77,0,2,True,0.0005052089691162109
2025-01-08 17:42:56,persegiMerah,842,535,125,111,195,20,196,23,1,3,True,0.460282598594699
2025-01-08 17:42:56,Merah,842,535,tensor(125.5449),tensor(111.4959),51,77,51,76,0,1,True,0.0
2025-01-08 17:42:56,persegiMerah,836,536,122,114,120,90,118,85,2,5,False,0.11732731652172923
2025-01-08 17:42:56,Fail to pick,836,536,0,0,0,0,0,0,0,0,False,0
2025-01-08 17:42:57,persegiMerah,841,535,124,113,76,80,78,79,2,1,True,0.15086264305592756
2025-01-08 17:42:57,Fail to pick,841,535,0,0,0,0,0,0,0,0,False,0
2025-01-08 17:42:57,persegiMerah,845,533,125,117,117,18,118,19,1,1,True,0.45981300512979906
2025-01-08 17:42:57,Merah,845,533,tensor(125.6161),tensor(117.7484),51,78,51,73,0,5,True,0.0
2025-01-08 17:42:57,Fail to pick,845,533,0,0,0,0,0,0,0,0,False,0
2025-01-08 17:42:58,persegiMerah,837,532,120,112,15,92,16,91,1,1,True,0.1736653545954695
2025-01-08 17:42:58,Fail to pick,837,532,0,0,0,0,0,0,0,0,False,0
2025-01-08 17:42:58,persegiMerah,842,528,127,118,87,83,87,86,0,3,True,0.1192980150256679
2025-01-08 17:42:58,Merah,842,528,tensor(127.5751),tensor(118.6214),53,77,54,75,1,2,True,0.0004994869232177734
2025-01-08 17:42:58,Fail to pick,842,528,0,0,0,0,0,0,0,0,False,0
2025-01-08 17:42:59,persegiMerah,842,531,128,116,8,51,3,47,5,4,True,0.3945365889639657
2025-01-08 17:42:59,Fail to pick,842,531,0,0,0,0,0,0,0,0,False,0
2025-01-08 17:42:59,persegiMerah,834,538,123,117,59,86,63,82,4,4,True,0.20619576813562956
2025-01-08 17:42:59,Fail to pick,834,538,0,0,0,0,0,0,0,0,False,0
2025-01-08 17:43:01,persegiBiru,739,311,124,126,139,26,135,30,4,4,True,0.46009272061643836
2025-01-08 17:43:01,Biru,739,311,tensor(124.7679),tensor(126.4145),113,68,115,65,2,3,True,0.0
2025-01-08 17:43:01,persegiBiru,728,315,120,125,136,40,139,41,3,1,True,0.283404319628935
2025-01-08 17:43:01,persegiBiru,726,314,117,128,112,79,107,83,5,4,False,0.30987764958034736
2025-01-08 17:43:01,Fail to pick,726,314,0,0,0,0,0,0,0,0,False,0
2025-01-08 17:43:01,persegiBiru,732,303,125,126,181,81,176,79,5,2,True,0.47131395992194325
2025-01-08 17:43:02,persegiBiru,728,310,122,130,154,91,152,92,2,1,True,0.30392661334965
2025-01-08 17:43:02,Biru,728,310,tensor(122.2455),tensor(130.4122),113,67,113,64,0,3,True,0.0
2025-01-08 17:43:02,Fail to pick,728,310,0,0,0,0,0,0,0,0,False,0
2025-01-08 17:43:02,persegiBiru,728,306,126,126,87,95,83,96,4,1,True,0.40733737620068877
2025-01-08 17:43:02,Fail to pick,728,306,0,0,0,0,0,0,0,0,False,0
2025-01-08 17:43:03,persegiBiru,725,299,121,122,158,32,160,30,2,2,True,0.26824888722994067
2025-01-08 17:43:03,Fail to pick,725,299,0,0,0,0,0,0,0,0,False,0
2025-01-08 17:43:03,persegiBiru,714,300,118,120,193,27,197,25,4,2,True,0.4842800555046364
2025-01-08 17:43:03,Biru,714,300,tensor(118.1145),tensor(120.5824),116,66,112,68,4,2,True,0.0
2025-01-08 17:43:05,persegiBiru,725,298,124,122,176,61,175,58,1,3,True,0.2522189713798884
2025-01-08 17:43:07,persegiBiru,776,329,122,118,8,40,12,43,4,3,True,0.34403067402096116
2025-01-08 17:43:07,Biru,776,329,tensor(122.8317),tensor(118.1929),108,71,106,75,2,4,True,0.0004990100860595703
2025-01-08 17:43:07,persegiBiru,736,318,131,121,153,97,152,94,1,3,True,0.11677498467933037
2025-01-08 17:43:07,persegiMerah,753,320,124,120,94,40,98,39,4,1,True,0.2732217378084938
2025-01-08 17:43:08,persegiBiru,721,304,123,118,181,30,182,25,1,5,True,0.2840906023384364
2025-01-08 17:43:08,Biru,721,304,tensor(123.2526),tensor(118.6893),115,66,117,67,2,1,True,0.0
2025-01-08 17:43:08,persegiBiru,752,328,122,118,88,76,90,72,2,4,True,0.19463024507692236
2025-01-08 17:43:08,persegiBiru,728,304,120,120,87,61,82,60,5,1,True,0.3441505004585581
2025-01-08 17:43:09,persegiBiru,701,300,117,119,69,24,64,19,5,5,True,0.44735515203356757
2025-01-08 17:43:09,Biru,701,300,tensor(117.9631),tensor(119.1737),116,64,115,66,1,2,True,0.0
2025-01-08 17:43:09,persegiMerah,742,317,124,117,132,59,130,59,2,0,True,0.2132106656046232
2025-01-08 17:43:09,persegiMerah,750,321,123,117,79,93,78,97,1,4,True,0.20021192203749327
2025-01-08 17:43:09,Fail to pick,750,321,0,0,0,0,0,0,0,0,False,0
2025-01-08 17:43:10,persegiBiru,726,300,124,118,198,75,195,74,3,1,True,0.4980554101027377
2025-01-08 17:43:10,persegiBiru,722,303,122,114,30,47,30,45,0,2,True,0.38902113724389487
2025-01-08 17:43:10,Fail to pick,722,303,0,0,0,0,0,0,0,0,False,0
2025-01-08 17:43:10,persegiBiru,726,300,122,118,128,10,123,10,5,0,True,0.277429611977314
2025-01-08 17:43:10,Biru,726,300,tensor(122.5032),tensor(118.0635),116,67,120,62,4,5,True,0.0
2025-01-08 17:43:10,Fail to pick,726,300,0,0,0,0,0,0,0,0,False,0
2025-01-08 17:43:11,persegiBiru,728,299,122,114,59,20,63,18,4,2,True,0.25461047325724373
2025-01-08 17:43:11,Fail to pick,728,299,0,0,0,0,0,0,0,0,False,0
2025-01-08 17:43:14,persegiMerah,196,264,122,108,16,50,12,49,4,1,True,0.41656203775694234
2025-01-08 17:43:14,Merah,196,264,tensor(122.5009),tensor(108.2614),126,18,129,18,3,0,True,0.0004990100860595703
2025-01-08 17:43:14,persegiMerah,276,163,131,119,162,13,161,13,1,0,True,0.2558572311279302
2025-01-08 17:43:14,persegiMerah,260,132,132,125,171,66,175,68,4,2,True,0.19609871833014456
2025-01-08 17:43:14,persegiMerah,283,147,133,122,14,8,14,3,0,5,True,0.3911895089608427
2025-01-08 17:43:14,persegiMerah,287,145,141,126,34,17,38,14,4,3,True,0.30916776702352755
2025-01-08 17:43:14,Fail to pick,287,145,0,0,0,0,0,0,0,0,False,0
2025-01-08 17:43:14,persegiMerah,259,132,135,124,109,82,111,86,2,4,True,0.4491515777284497
2025-01-08 17:43:15,persegiMerah,263,129,135,125,103,96,101,97,2,1,True,0.420443434334411
2025-01-08 17:43:15,Fail to pick,263,129,0,0,0,0,0,0,0,0,False,0
2025-01-08 17:43:15,persegiMerah,279,140,143,122,16,24,15,19,1,5,True,0.4437818435884765
2025-01-08 17:43:15,persegiMerah,252,127,134,115,150,5,145,9,5,4,True,0.4513484449500835
2025-01-08 17:43:15,persegiMerah,261,130,133,122,11,60,6,56,5,4,False,0.1448765519161976
2025-01-08 17:43:15,Fail to pick,261,130,0,0,0,0,0,0,0,0,False,0
2025-01-08 17:43:15,persegiMerah,279,144,140,123,131,53,134,52,3,1,False,0.2824239642172034
2025-01-08 17:43:15,Merah,279,144,tensor(140.3447),tensor(123.8484),160,25,156,23,4,2,True,0.0004992485046386719
2025-01-08 17:43:15,persegiMerah,259,129,132,126,45,13,44,12,1,1,True,0.4809126392496803
2025-01-08 17:43:15,persegiMerah,262,131,132,123,109,89,107,90,2,1,True,0.18613374744288702
2025-01-08 17:43:15,Fail to pick,262,131,0,0,0,0,0,0,0,0,False,0
2025-01-08 17:43:15,persegiMerah,262,131,138,124,110,50,112,53,2,3,True,0.2442791632309525
2025-01-08 17:43:15,Fail to pick,262,131,0,0,0,0,0,0,0,0,False,0
2025-01-08 17:43:16,persegiMerah,259,132,136,124,101,89,99,88,2,1,True,0.3461065649396584
2025-01-08 17:43:16,Fail to pick,259,132,0,0,0,0,0,0,0,0,False,0
2025-01-08 17:43:16,persegiMerah,262,128,135,124,187,72,189,74,2,2,True,0.454891543814852
2025-01-08 17:43:16,Fail to pick,262,128,0,0,0,0,0,0,0,0,False,0
2025-01-08 17:43:16,persegiMerah,253,132,138,120,147,94,146,92,1,2,False,0.2082725069228832
2025-01-08 17:43:16,Fail to pick,253,132,0,0,0,0,0,0,0,0,False,0
2025-01-08 17:43:16,persegiMerah,258,132,134,125,44,86,46,84,2,2,True,0.22358546189327022
2025-01-08 17:43:16,Fail to pick,258,132,0,0,0,0,0,0,0,0,False,0
2025-01-08 17:43:16,persegiMerah,286,141,135,122,199,40,203,43,4,3,True,0.1942648993149986
2025-01-08 17:43:16,Merah,286,141,tensor(135.3625),tensor(122.1734),160,26,163,29,3,3,True,0.0004985332489013672
2025-01-08 17:43:16,persegiMerah,257,130,131,126,67,57,66,58,1,1,True,0.3411989389797974
2025-01-08 17:43:22,persegiMerah,256,173,127,119,75,76,73,76,2,0,True,0.3373807059880603
2025-01-08 17:43:22,Merah,256,173,tensor(127.9615),tensor(119.3614),151,23,153,23,2,0,True,0.0004994869232177734
2025-01-08 17:43:22,persegiMerah,272,196,133,115,91,85,91,88,0,3,True,0.1414166420816757
2025-01-08 17:43:22,persegiMerah,268,193,132,118,187,91,185,86,2,5,False,0.24969325158105177
2025-01-08 17:43:22,Fail to pick,268,193,0,0,0,0,0,0,0,0,False,0
2025-01-08 17:43:22,persegiMerah,272,199,136,115,198,59,195,61,3,2,True,0.13768785560140967
2025-01-08 17:43:22,Fail to pick,272,199,0,0,0,0,0,0,0,0,False,0
2025-01-08 17:43:22,persegiMerah,247,183,128,116,149,54,148,57,1,3,True,0.2622458371273144
2025-01-08 17:43:22,persegiMerah,263,192,133,117,71,94,67,89,4,5,True,0.4246812662095879
2025-01-08 17:43:22,persegiMerah,245,181,130,118,106,16,107,17,1,1,True,0.1551463582548338
2025-01-08 17:43:23,persegiMerah,245,180,128,119,68,82,72,83,4,1,True,0.1269571502873375
2025-01-08 17:43:23,Fail to pick,245,180,0,0,0,0,0,0,0,0,False,0
2025-01-08 17:43:23,persegiMerah,247,184,130,121,21,23,23,25,2,2,True,0.43527335849204407
2025-01-08 17:43:23,Fail to pick,247,184,0,0,0,0,0,0,0,0,False,0
2025-01-08 17:43:23,persegiMerah,273,201,132,118,54,82,51,79,3,3,True,0.2163309181791978
2025-01-08 17:43:23,persegiMerah,241,184,126,122,123,31,119,31,4,0,True,0.4132675884719572
2025-01-08 17:43:23,Merah,241,184,tensor(126.7176),tensor(122.6564),148,22,148,23,0,1,True,0.0
2025-01-08 17:43:23,persegiMerah,244,178,127,117,100,13,103,11,3,2,True,0.1486677231244427
2025-01-08 17:43:23,Fail to pick,244,178,0,0,0,0,0,0,0,0,False,0
2025-01-08 17:43:23,persegiMerah,271,199,133,116,166,88,167,88,1,0,True,0.28234473338739663
2025-01-08 17:43:23,persegiMerah,258,194,131,117,120,53,123,51,3,2,True,0.3883001017539175
2025-01-08 17:43:23,persegiMerah,272,195,131,115,10,79,13,80,3,1,True,0.262369281967205
2025-01-08 17:43:23,persegiMerah,248,178,130,116,116,10,116,9,0,1,True,0.14081895300587777
2025-01-08 17:43:24,persegiMerah,247,178,128,117,103,28,104,23,1,5,False,0.17403061455260138
2025-01-08 17:43:24,Fail to pick,247,178,0,0,0,0,0,0,0,0,False,0
2025-01-08 17:43:24,persegiMerah,261,191,128,119,49,95,47,99,2,4,True,0.2394744186844594
2025-01-08 17:43:24,persegiMerah,249,179,130,115,108,69,111,71,3,2,True,0.17348694724129665
2025-01-08 17:43:24,persegiMerah,245,181,131,123,127,23,125,25,2,2,True,0.4410409671743677
2025-01-08 17:43:24,Fail to pick,245,181,0,0,0,0,0,0,0,0,False,0
2025-01-08 17:43:24,persegiMerah,245,178,126,115,64,21,68,24,4,3,True,0.10719585810167379
2025-01-08 17:43:24,Fail to pick,245,178,0,0,0,0,0,0,0,0,False,0
2025-01-08 17:43:24,persegiMerah,244,178,125,118,167,94,170,96,3,2,True,0.2116109366915765
2025-01-08 17:43:24,Merah,244,178,tensor(125.2392),tensor(118.2750),150,22,150,22,0,0,True,0.0
2025-01-08 17:43:24,Fail to pick,244,178,0,0,0,0,0,0,0,0,False,0
2025-01-08 17:43:24,persegiMerah,244,178,125,118,159,62,156,62,3,0,True,0.3628057362669912
2025-01-08 17:43:24,Fail to pick,244,178,0,0,0,0,0,0,0,0,False,0
2025-01-08 17:43:24,persegiMerah,266,198,127,117,149,12,144,15,5,3,False,0.44235386729880166
2025-01-08 17:43:24,persegiMerah,244,178,124,119,158,94,158,98,0,4,True,0.31683107200143834
2025-01-08 17:43:25,persegiMerah,261,191,130,121,91,67,92,68,1,1,True,0.3218212399664751
2025-01-08 17:43:25,persegiMerah,267,191,126,120,106,48,106,51,0,3,True,0.481423868462582
2025-01-08 17:43:25,Fail to pick,267,191,0,0,0,0,0,0,0,0,False,0
2025-01-08 17:43:31,persegiMerah,245,204,141,130,43,39,45,39,2,0,True,0.3525672727268414
2025-01-08 17:43:31,Merah,245,204,tensor(141.9566),tensor(130.0164),143,22,141,19,2,3,True,0.0
2025-01-08 17:43:31,persegiMerah,245,208,142,133,141,91,143,86,2,5,True,0.21918054693712286
2025-01-08 17:43:31,Fail to pick,245,208,0,0,0,0,0,0,0,0,False,0
2025-01-08 17:43:32,persegiMerah,236,203,136,131,17,44,21,48,4,4,False,0.32073136203572405
2025-01-08 17:43:32,Fail to pick,236,203,0,0,0,0,0,0,0,0,False,0
2025-01-08 17:43:32,persegiMerah,221,191,138,135,173,42,174,43,1,1,True,0.43347756378647995
2025-01-08 17:43:32,persegiMerah,234,205,136,130,53,2,48,-3,5,5,False,0.41937360433565785
2025-01-08 17:43:32,persegiMerah,222,191,133,129,188,86,185,83,3,3,True,0.23072385574711213
2025-01-08 17:43:32,persegiMerah,221,195,134,132,197,67,200,69,3,2,True,0.4676847091031012
2025-01-08 17:43:32,Fail to pick,221,195,0,0,0,0,0,0,0,0,False,0
2025-01-08 17:43:32,persegiMerah,224,216,118,119,151,7,150,10,1,3,True,0.3733915450035987
2025-01-08 17:43:32,persegiMerah,239,202,132,136,112,88,107,85,5,3,True,0.1367410458014911
2025-01-08 17:43:34,persegiMerah,356,191,129,122,19,58,15,58,4,0,True,0.33560356099577643
2025-01-08 17:43:34,Merah,356,191,tensor(129.4472),tensor(122.5791),146,32,148,34,2,2,True,0.0004992485046386719
2025-01-08 17:43:34,persegiMerah,334,170,124,115,122,26,118,26,4,0,True,0.4145408402479084
2025-01-08 17:43:34,persegiMerah,355,186,135,125,101,77,103,73,2,4,True,0.3110248269238517
2025-01-08 17:43:34,persegiMerah,343,171,124,122,154,78,158,82,4,4,True,0.4908163220487908
2025-01-08 17:43:34,persegiMerah,349,185,121,120,39,65,41,67,2,2,True,0.4700865943352256
2025-01-08 17:43:35,persegiMerah,329,171,122,117,60,3,57,-2,3,5,True,0.41242964334007415
2025-01-08 17:43:35,persegiMerah,347,175,122,121,23,36,27,39,4,3,True,0.3625233294725074
2025-01-08 17:43:35,persegiMerah,341,177,125,119,196,72,192,73,4,1,True,0.17808975491904985
2025-01-08 17:43:35,Fail to pick,341,177,0,0,0,0,0,0,0,0,False,0
2025-01-08 17:43:35,persegiMerah,340,177,129,120,110,99,112,99,2,0,True,0.2500692089436978
2025-01-08 17:43:35,Merah,340,177,tensor(129.2128),tensor(120.3001),150,31,149,33,1,2,True,0.0004987716674804688
2025-01-08 17:43:35,Fail to pick,340,177,0,0,0,0,0,0,0,0,False,0
2025-01-08 17:43:35,persegiMerah,356,185,131,123,193,46,190,46,3,0,True,0.462835481067146
2025-01-08 17:43:35,persegiMerah,349,176,124,122,154,62,158,60,4,2,True,0.279697300068975
2025-01-08 17:43:35,Fail to pick,349,176,0,0,0,0,0,0,0,0,False,0
2025-01-08 17:43:35,persegiMerah,340,173,125,121,110,83,109,82,1,1,True,0.2955164019177071
2025-01-08 17:43:35,Fail to pick,340,173,0,0,0,0,0,0,0,0,False,0
2025-01-08 17:43:36,persegiMerah,361,182,124,123,121,5,120,1,1,4,False,0.2161813521369847
2025-01-08 17:43:36,persegiMerah,355,188,129,125,62,55,59,50,3,5,True,0.12353377675691793
2025-01-08 17:43:36,Fail to pick,355,188,0,0,0,0,0,0,0,0,False,0
2025-01-08 17:43:36,persegiMerah,363,187,128,122,78,69,81,68,3,1,True,0.40007201152002225
2025-01-08 17:43:36,Fail to pick,363,187,0,0,0,0,0,0,0,0,False,0
2025-01-08 17:43:36,persegiMerah,344,179,117,116,115,53,119,49,4,4,True,0.29003629604542314
2025-01-08 17:43:36,Merah,344,179,tensor(117.4555),tensor(116.5393),150,31,148,34,2,3,True,0.0
2025-01-08 17:43:36,persegiMerah,357,186,127,121,39,61,38,62,1,1,True,0.47968681063615337
2025-01-08 17:43:36,persegiMerah,357,184,125,125,68,2,72,1,4,1,True,0.4708235288594963
2025-01-08 17:43:36,Fail to pick,357,184,0,0,0,0,0,0,0,0,False,0
2025-01-08 17:43:37,persegiMerah,346,174,121,120,29,30,31,32,2,2,True,0.4584290022838484
2025-01-08 17:43:37,persegiMerah,360,184,126,123,30,56,34,53,4,3,True,0.42019268322995396
2025-01-08 17:43:37,persegiMerah,360,186,127,124,148,30,152,25,4,5,True,0.34652245243682267
2025-01-08 17:43:37,Fail to pick,360,186,0,0,0,0,0,0,0,0,False,0
2025-01-08 17:43:37,persegiMerah,341,175,118,116,100,87,102,85,2,2,True,0.2703846224338733
2025-01-08 17:43:37,persegiMerah,343,176,126,121,109,43,108,45,1,2,True,0.4271976725517542
2025-01-08 17:43:37,Merah,343,176,tensor(126.3576),tensor(121.8182),151,31,153,30,2,1,True,0.0
2025-01-08 17:43:37,Fail to pick,343,176,0,0,0,0,0,0,0,0,False,0
2025-01-08 17:43:37,persegiMerah,338,173,120,121,106,39,109,41,3,2,True,0.4383245570877854
2025-01-08 17:43:37,Fail to pick,338,173,0,0,0,0,0,0,0,0,False,0
2025-01-08 17:43:37,persegiMerah,343,171,116,122,148,30,145,27,3,3,True,0.26415033208503896
2025-01-08 17:43:37,Fail to pick,343,171,0,0,0,0,0,0,0,0,False,0
2025-01-08 17:43:38,persegiMerah,359,184,127,123,55,80,54,76,1,4,True,0.4553919235038967
2025-01-08 17:43:38,persegiMerah,362,185,129,122,69,74,72,75,3,1,True,0.17921137971249912
2025-01-08 17:43:38,Fail to pick,362,185,0,0,0,0,0,0,0,0,False,0
2025-01-08 17:43:38,persegiMerah,333,169,125,118,141,88,140,86,1,2,True,0.32724036113426325
2025-01-08 17:43:38,persegiMerah,356,182,129,124,178,68,174,66,4,2,True,0.46041358549499145
2025-01-08 17:43:38,persegiMerah,358,186,129,124,155,44,156,45,1,1,True,0.23772546403174416
2025-01-08 17:43:38,Fail to pick,358,186,0,0,0,0,0,0,0,0,False,0
2025-01-08 17:43:38,persegiBiru,356,186,128,122,139,69,140,72,1,3,True,0.4697755053694722
2025-01-08 17:43:38,Fail to pick,356,186,0,0,0,0,0,0,0,0,False,0
2025-01-08 17:43:38,persegiMerah,342,171,125,125,147,83,151,85,4,2,False,0.3744500582265121
2025-01-08 17:43:38,Merah,342,171,tensor(125.3625),tensor(125.4228),152,31,153,35,1,4,True,0.0005059242248535156
2025-01-08 17:43:38,persegiMerah,348,174,124,123,28,95,29,95,1,0,True,0.2088355663689112
2025-01-08 17:43:38,Fail to pick,348,174,0,0,0,0,0,0,0,0,False,0
2025-01-08 17:43:39,persegiMerah,355,182,129,125,132,16,130,16,2,0,True,0.48157492242571986
2025-01-08 17:43:39,Fail to pick,355,182,0,0,0,0,0,0,0,0,False,0
2025-01-08 17:43:39,persegiMerah,357,182,126,122,114,11,113,11,1,0,True,0.2804427133137073
2025-01-08 17:43:39,Fail to pick,357,182,0,0,0,0,0,0,0,0,False,0
2025-01-08 17:43:43,persegiMerah,392,184,151,137,176,4,175,5,1,1,True,0.21066729101728257
2025-01-08 17:43:43,Merah,392,184,tensor(151.1205),tensor(137.6362),148,36,147,39,1,3,True,0.0
2025-01-08 17:43:43,persegiMerah,396,186,157,139,63,79,61,83,2,4,True,0.35112960410663996
2025-01-08 17:43:43,Fail to pick,396,186,0,0,0,0,0,0,0,0,False,0
2025-01-08 17:43:43,persegiMerah,375,168,154,137,146,28,146,24,0,4,True,0.11826168501232225
2025-01-08 17:43:43,persegiMerah,372,167,158,137,191,15,191,19,0,4,True,0.4616409564895817
2025-01-08 17:43:43,Fail to pick,372,167,0,0,0,0,0,0,0,0,False,0
2025-01-08 17:43:45,persegiBiru,272,408,129,109,118,57,121,55,3,2,True,0.23897166645127085
2025-01-08 17:43:45,Biru,272,408,tensor(129.7443),tensor(109.8065),86,25,81,28,5,3,True,0.0
2025-01-08 17:43:45,persegiBiru,276,406,127,111,91,59,94,55,3,4,True,0.4663233998981159
2025-01-08 17:43:45,Fail to pick,276,406,0,0,0,0,0,0,0,0,False,0
2025-01-08 17:43:46,persegiBiru,282,413,131,110,115,92,118,90,3,2,True,0.3231588912621278
2025-01-08 17:43:46,Fail to pick,282,413,0,0,0,0,0,0,0,0,False,0
2025-01-08 17:43:46,persegiBiru,278,408,130,109,65,40,69,42,4,2,True,0.32253952651098905
2025-01-08 17:43:46,Fail to pick,278,408,0,0,0,0,0,0,0,0,False,0
2025-01-08 17:43:46,persegiBiru,287,414,130,106,94,94,94,92,0,2,False,0.46578229369639057
2025-01-08 17:43:46,Fail to pick,287,414,0,0,0,0,0,0,0,0,False,0
2025-01-08 17:43:46,persegiBiru,291,414,131,109,187,15,186,10,1,5,False,0.3785386906660547
2025-01-08 17:43:46,Fail to pick,291,414,0,0,0,0,0,0,0,0,False,0
2025-01-08 17:43:46,persegiBiru,274,408,130,114,60,68,64,64,4,4,True,0.44518120590271726
2025-01-08 17:43:46,persegiBiru,275,394,129,112,124,16,125,19,1,3,True,0.1654706979940967
2025-01-08 17:43:46,persegiBiru,278,409,132,114,33,65,32,63,1,2,True,0.29882079271650885
2025-01-08 17:43:46,persegiBiru,289,416,132,110,147,57,149,52,2,5,True,0.48867827750917425
2025-01-08 17:43:46,persegiBiru,295,413,132,112,78,22,77,17,1,5,True,0.4769378586616093
2025-01-08 17:43:46,Biru,295,413,tensor(132.7648),tensor(112.8553),85,27,80,22,5,5,True,0.000499725341796875
2025-01-08 17:43:46,Fail to pick,295,413,0,0,0,0,0,0,0,0,False,0
2025-01-08 17:43:47,persegiBiru,295,418,132,110,62,61,65,58,3,3,True,0.23750532692708962
2025-01-08 17:43:47,Fail to pick,295,418,0,0,0,0,0,0,0,0,False,0
2025-01-08 17:43:47,persegiBiru,296,417,133,110,30,35,29,30,1,5,True,0.17451283012447294
2025-01-08 17:43:47,Fail to pick,296,417,0,0,0,0,0,0,0,0,False,0
2025-01-08 17:43:47,persegiBiru,295,416,128,112,130,36,126,36,4,0,False,0.36583292210770946
2025-01-08 17:43:47,Fail to pick,295,416,0,0,0,0,0,0,0,0,False,0
2025-01-08 17:43:47,persegiBiru,278,413,130,110,162,86,166,88,4,2,True,0.4601040319722687
2025-01-08 17:43:47,persegiBiru,286,410,132,110,5,15,0,15,5,0,True,0.4018288454146809
2025-01-08 17:43:47,Fail to pick,286,410,0,0,0,0,0,0,0,0,False,0
2025-01-08 17:43:47,persegiBiru,287,417,132,108,45,7,48,9,3,2,True,0.4013180405535579
2025-01-08 17:43:47,Fail to pick,287,417,0,0,0,0,0,0,0,0,False,0
2025-01-08 17:43:47,persegiBiru,300,416,131,108,186,83,189,78,3,5,True,0.20293114331511106
2025-01-08 17:43:47,persegiBiru,286,404,132,115,70,31,66,27,4,4,True,0.30704786308209997
2025-01-08 17:43:47,persegiBiru,295,413,133,113,133,36,137,39,4,3,True,0.24318838028144799
2025-01-08 17:43:47,Fail to pick,295,413,0,0,0,0,0,0,0,0,False,0
2025-01-08 17:43:47,persegiBiru,281,408,127,115,113,71,110,74,3,3,False,0.40763861362457765
2025-01-08 17:43:47,Biru,281,408,tensor(127.8567),tensor(115.3543),86,26,87,30,1,4,True,0.0
2025-01-08 17:43:48,persegiBiru,276,407,125,115,79,84,77,81,2,3,True,0.4321823887762606
2025-01-08 17:43:48,Fail to pick,276,407,0,0,0,0,0,0,0,0,False,0
2025-01-08 17:43:48,persegiBiru,292,415,126,110,186,79,189,79,3,0,True,0.30806409926580514
2025-01-08 17:43:48,persegiBiru,297,417,128,111,104,85,102,86,2,1,True,0.24900091014567072
2025-01-08 17:43:48,Fail to pick,297,417,0,0,0,0,0,0,0,0,False,0
2025-01-08 17:43:48,persegiBiru,289,416,126,110,28,4,28,8,0,4,True,0.24328350633608237
2025-01-08 17:43:48,Fail to pick,289,416,0,0,0,0,0,0,0,0,False,0
2025-01-08 17:43:48,persegiBiru,284,401,129,111,90,15,94,19,4,4,True,0.26534805679491424
2025-01-08 17:43:48,persegiBiru,277,407,124,114,149,18,148,19,1,1,True,0.17341764408764782
2025-01-08 17:43:48,Fail to pick,277,407,0,0,0,0,0,0,0,0,False,0
2025-01-08 17:43:48,persegiBiru,297,417,129,111,137,57,134,59,3,2,True,0.33688959167041865
2025-01-08 17:43:48,persegiBiru,283,400,128,111,55,9,58,10,3,1,True,0.361816674415929
2025-01-08 17:43:48,persegiBiru,274,406,126,110,105,39,103,38,2,1,True,0.11102818667917483
2025-01-08 17:43:48,Fail to pick,274,406,0,0,0,0,0,0,0,0,False,0
2025-01-08 17:43:49,persegiBiru,293,415,124,108,7,24,10,28,3,4,True,0.21267218614998287
2025-01-08 17:43:49,Biru,293,415,tensor(124.2579),tensor(108.9839),84,27,83,28,1,1,True,0.0
2025-01-08 17:43:49,persegiBiru,271,410,125,110,57,93,54,97,3,4,True,0.4500106173952242
2025-01-08 17:43:49,persegiBiru,270,399,126,112,52,35,49,35,3,0,True,0.2153293022048434
2025-01-08 17:43:49,persegiBiru,268,406,121,108,162,47,157,49,5,2,True,0.48446321009408055
2025-01-08 17:43:49,Fail to pick,268,406,0,0,0,0,0,0,0,0,False,0
2025-01-08 17:43:49,persegiBiru,275,407,125,110,134,97,137,95,3,2,True,0.22370512769989903
2025-01-08 17:43:49,Fail to pick,275,407,0,0,0,0,0,0,0,0,False,0
2025-01-08 17:43:49,persegiBiru,272,403,124,109,75,29,70,27,5,2,True,0.49246857244382614
2025-01-08 17:43:49,Fail to pick,272,403,0,0,0,0,0,0,0,0,False,0
2025-01-08 17:43:49,persegiBiru,268,404,122,112,11,49,13,45,2,4,True,0.13725315645557068
2025-01-08 17:43:49,Fail to pick,268,404,0,0,0,0,0,0,0,0,False,0
2025-01-08 17:43:49,persegiBiru,283,397,125,108,189,48,185,49,4,1,True,0.39911045190351613
2025-01-08 17:43:49,persegiBiru,289,415,125,107,155,52,155,48,0,4,True,0.1677181874020932
2025-01-08 17:43:50,persegiBiru,275,404,125,113,15,51,15,48,0,3,True,0.2216913347108821
2025-01-08 17:43:50,Biru,275,404,tensor(125.1560),tensor(113.1765),87,25,86,26,1,1,True,0.0
2025-01-08 17:43:50,persegiBiru,268,404,123,111,18,5,15,1,3,4,True,0.27843830850023915
2025-01-08 17:43:50,Fail to pick,268,404,0,0,0,0,0,0,0,0,False,0
2025-01-08 17:43:50,persegiBiru,282,399,129,110,82,21,85,22,3,1,True,0.34266594707266657
2025-01-08 17:43:50,persegiBiru,267,405,123,111,25,17,23,20,2,3,True,0.3540655685960984
2025-01-08 17:43:50,persegiBiru,284,415,126,108,33,66,31,70,2,4,True,0.31774290210108025
2025-01-08 17:43:50,persegiBiru,290,416,124,109,39,67,40,66,1,1,True,0.24805772799612702
2025-01-08 17:43:50,Fail to pick,290,416,0,0,0,0,0,0,0,0,False,0
2025-01-08 17:43:50,persegiBiru,290,419,122,107,162,14,159,15,3,1,True,0.22370045430574767
2025-01-08 17:43:50,Fail to pick,290,419,0,0,0,0,0,0,0,0,False,0
2025-01-08 17:43:54,persegiBiru,274,412,125,107,7,56,9,60,2,4,False,0.19559719718346813
2025-01-08 17:43:54,Biru,274,412,tensor(125.1217),tensor(107.2120),85,25,81,22,4,3,True,0.0004992485046386719
2025-01-08 17:43:54,persegiBiru,293,417,127,107,106,55,103,55,3,0,True,0.3164377588254832
2025-01-08 17:43:54,persegiBiru,275,408,123,110,138,10,142,13,4,3,True,0.10547838825833887
2025-01-08 17:43:54,persegiBiru,276,409,123,110,15,90,19,94,4,4,False,0.4486425366973802
2025-01-08 17:43:55,Fail to pick,276,409,0,0,0,0,0,0,0,0,False,0
2025-01-08 17:43:55,persegiBiru,294,417,124,108,32,5,28,0,4,5,True,0.22866034390016776
2025-01-08 17:43:55,persegiBiru,290,418,128,109,104,65,105,65,1,0,True,0.30450907232447993
2025-01-08 17:43:55,Fail to pick,290,418,0,0,0,0,0,0,0,0,False,0
2025-01-08 17:43:55,persegiBiru,276,409,124,109,119,70,123,71,4,1,False,0.4793851276302957
2025-01-08 17:43:55,persegiBiru,286,414,129,111,99,76,94,79,5,3,True,0.4803617392246421
2025-01-08 17:43:55,persegiBiru,289,409,128,111,60,40,60,40,0,0,True,0.2349648992729108
2025-01-08 17:43:55,Fail to pick,289,409,0,0,0,0,0,0,0,0,False,0
2025-01-08 17:43:55,persegiBiru,277,407,128,112,3,70,0,65,3,5,True,0.46171029205938774
2025-01-08 17:43:55,persegiBiru,276,407,128,114,41,85,41,83,0,2,True,0.1865644407129543
2025-01-08 17:43:55,Biru,276,407,tensor(128.2173),tensor(114.0811),86,25,83,23,3,2,True,0.0004982948303222656
2025-01-08 17:43:55,Fail to pick,276,407,0,0,0,0,0,0,0,0,False,0
2025-01-08 17:43:55,persegiBiru,274,407,125,112,195,59,197,62,2,3,False,0.12002517786888918
2025-01-08 17:43:55,Fail to pick,274,407,0,0,0,0,0,0,0,0,False,0
2025-01-08 17:43:55,persegiBiru,282,411,127,109,127,4,125,8,2,4,True,0.13460457462949502
2025-01-08 17:43:55,Fail to pick,282,411,0,0,0,0,0,0,0,0,False,0
2025-01-08 17:43:56,persegiBiru,285,415,129,109,178,90,177,87,1,3,True,0.27821164608530974
2025-01-08 17:43:56,Fail to pick,285,415,0,0,0,0,0,0,0,0,False,0
2025-01-08 17:43:56,persegiBiru,284,412,128,110,102,47,99,48,3,1,True,0.23060919788265283
2025-01-08 17:43:56,Fail to pick,284,412,0,0,0,0,0,0,0,0,False,0
2025-01-08 17:43:56,persegiBiru,272,409,126,112,68,32,71,31,3,1,True,0.4773505215950006
2025-01-08 17:43:56,persegiBiru,287,415,129,109,182,21,182,22,0,1,True,0.27211558467998953
2025-01-08 17:43:56,persegiBiru,297,417,130,107,34,84,32,86,2,2,True,0.21499171860852054
2025-01-08 17:43:56,persegiBiru,289,416,132,110,85,98,89,97,4,1,False,0.4460698460945569
2025-01-08 17:43:56,Fail to pick,289,416,0,0,0,0,0,0,0,0,False,0
2025-01-08 17:43:56,persegiBiru,278,409,127,112,95,47,90,43,5,4,True,0.446565340632042
2025-01-08 17:43:56,persegiBiru,277,408,127,111,48,61,51,57,3,4,False,0.30943784176008077
2025-01-08 17:43:56,Fail to pick,277,408,0,0,0,0,0,0,0,0,False,0
2025-01-08 17:43:56,persegiBiru,281,406,128,112,91,50,94,49,3,1,True,0.28990871045490885
2025-01-08 17:43:56,Biru,281,406,tensor(128.6066),tensor(112.2217),87,26,87,21,0,5,True,0.0
2025-01-08 17:43:56,Fail to pick,281,406,0,0,0,0,0,0,0,0,False,0
2025-01-08 17:43:56,persegiBiru,272,408,128,112,148,66,146,66,2,0,True,0.2284032959794626
2025-01-08 17:43:56,Fail to pick,272,408,0,0,0,0,0,0,0,0,False,0
2025-01-08 17:43:57,persegiBiru,278,407,128,112,126,97,122,94,4,3,True,0.4809127050170797
2025-01-08 17:43:57,Fail to pick,278,407,0,0,0,0,0,0,0,0,False,0
2025-01-08 17:43:57,persegiBiru,281,415,129,112,161,45,162,43,1,2,True,0.19062435613437959
2025-01-08 17:43:57,Fail to pick,281,415,0,0,0,0,0,0,0,0,False,0
2025-01-08 17:43:57,persegiBiru,286,413,130,110,12,23,7,19,5,4,True,0.24199925964322425
2025-01-08 17:43:57,Fail to pick,286,413,0,0,0,0,0,0,0,0,False,0
2025-01-08 17:43:57,persegiBiru,276,408,128,114,95,8,97,6,2,2,True,0.3792057668443999
2025-01-08 17:43:57,persegiBiru,290,413,127,111,118,52,118,51,0,1,False,0.2538294840366827
2025-01-08 17:43:57,persegiBiru,290,418,127,109,138,96,135,93,3,3,True,0.11612853911802619
2025-01-08 17:43:57,Fail to pick,290,418,0,0,0,0,0,0,0,0,False,0
2025-01-08 17:43:57,persegiBiru,285,403,129,112,144,50,144,47,0,3,True,0.26418897473586167
2025-01-08 17:43:57,persegiBiru,284,405,131,112,175,94,176,96,1,2,False,0.34504377940563813
2025-01-08 17:43:57,Fail to pick,284,405,0,0,0,0,0,0,0,0,False,0
2025-01-08 17:43:57,persegiBiru,294,417,128,108,171,46,169,41,2,5,False,0.366359488503612
2025-01-08 17:43:57,Biru,294,417,tensor(128.6906),tensor(108.3654),84,27,88,31,4,4,True,0.0004992485046386719
2025-01-08 17:43:58,persegiBiru,279,406,129,113,23,33,19,30,4,3,True,0.32530798016128293
2025-01-08 17:43:58,persegiBiru,282,403,128,113,14,56,9,52,5,4,True,0.48126792917086014
2025-01-08 17:43:58,Fail to pick,282,403,0,0,0,0,0,0,0,0,False,0
2025-01-08 17:43:58,persegiBiru,280,405,131,109,124,56,127,55,3,1,True,0.30855904615965746
2025-01-08 17:43:58,Fail to pick,280,405,0,0,0,0,0,0,0,0,False,0
2025-01-08 17:43:58,persegiBiru,277,404,130,110,131,53,132,51,1,2,True,0.34805882919175707
2025-01-08 17:43:58,Fail to pick,277,404,0,0,0,0,0,0,0,0,False,0
2025-01-08 17:43:58,persegiBiru,277,409,131,110,3,98,5,100,2,2,True,0.45825385135313423
2025-01-08 17:43:58,Fail to pick,277,409,0,0,0,0,0,0,0,0,False,0
2025-01-08 17:43:58,persegiBiru,274,409,129,110,52,53,50,57,2,4,True,0.4002409205844374
2025-01-08 17:43:58,Fail to pick,274,409,0,0,0,0,0,0,0,0,False,0
2025-01-08 17:43:58,persegiBiru,278,409,131,110,102,23,106,21,4,2,True,0.49285779447554856
2025-01-08 17:43:58,Fail to pick,278,409,0,0,0,0,0,0,0,0,False,0
2025-01-08 17:43:58,persegiBiru,290,416,133,107,29,23,32,26,3,3,False,0.2348406663432086
2025-01-08 17:43:58,persegiBiru,289,416,133,108,14,64,9,64,5,0,True,0.14019413501555042
2025-01-08 17:43:58,Biru,289,416,tensor(133.4191),tensor(108.8051),84,26,79,27,5,1,True,0.0
2025-01-08 17:43:58,Fail to pick,289,416,0,0,0,0,0,0,0,0,False,0
2025-01-08 17:43:59,persegiBiru,279,409,131,113,115,52,119,50,4,2,True,0.4998295502486432
2025-01-08 17:43:59,persegiBiru,291,417,135,110,91,76,89,77,2,1,True,0.18546127961867798
2025-01-08 17:43:59,persegiBiru,284,415,132,110,30,2,29,2,1,0,True,0.40216062398188546
2025-01-08 17:43:59,Fail to pick,284,415,0,0,0,0,0,0,0,0,False,0
2025-01-08 17:43:59,persegiBiru,290,417,131,109,155,28,155,23,0,5,True,0.1735385315059427
2025-01-08 17:43:59,Fail to pick,290,417,0,0,0,0,0,0,0,0,False,0
2025-01-08 17:43:59,persegiBiru,294,413,136,112,88,87,85,90,3,3,True,0.17274558404841792
2025-01-08 17:43:59,Fail to pick,294,413,0,0,0,0,0,0,0,0,False,0
2025-01-08 17:43:59,persegiBiru,292,417,135,109,193,34,192,33,1,1,True,0.10924686902289081
2025-01-08 17:43:59,Fail to pick,292,417,0,0,0,0,0,0,0,0,False,0
2025-01-08 17:43:59,persegiBiru,277,411,133,113,143,19,142,19,1,0,False,0.20133082987572687
2025-01-08 17:43:59,persegiBiru,277,393,129,111,13,42,16,43,3,1,True,0.184592971079893
2025-01-08 17:43:59,persegiBiru,284,410,132,113,73,22,71,19,2,3,True,0.3583034604978159
2025-01-08 17:43:59,persegiBiru,288,415,132,111,21,84,22,87,1,3,True,0.4880081131524844
2025-01-08 17:43:59,Biru,288,415,tensor(132.1002),tensor(111.3971),84,26,88,24,4,2,True,0.0
2025-01-08 17:43:59,Fail to pick,288,415,0,0,0,0,0,0,0,0,False,0
2025-01-08 17:44:00,persegiBiru,298,417,132,112,87,94,86,89,1,5,True,0.10128478770025758
2025-01-08 17:44:00,persegiBiru,299,418,134,110,65,31,62,26,3,5,True,0.17770029336832854
2025-01-08 17:44:00,Fail to pick,299,418,0,0,0,0,0,0,0,0,False,0
2025-01-08 17:44:00,persegiBiru,284,417,131,111,10,34,7,33,3,1,True,0.45989304924813457
2025-01-08 17:44:00,persegiBiru,280,409,132,113,166,88,162,87,4,1,True,0.25033877308057106
2025-01-08 17:44:00,Fail to pick,280,409,0,0,0,0,0,0,0,0,False,0
2025-01-08 17:44:00,persegiBiru,298,421,135,109,3,16,2,17,1,1,True,0.29211286708498674
2025-01-08 17:44:00,persegiBiru,288,412,133,109,99,73,98,70,1,3,True,0.19769461844121683
2025-01-08 17:44:00,persegiBiru,282,411,133,114,63,93,63,88,0,5,True,0.483384403741837
2025-01-08 17:44:00,Fail to pick,282,411,0,0,0,0,0,0,0,0,False,0
2025-01-08 17:44:00,persegiBiru,297,415,133,109,117,27,116,24,1,3,True,0.31108669666006383
2025-01-08 17:44:00,persegiBiru,297,417,133,109,82,64,79,63,3,1,True,0.28237134919367024
2025-01-08 17:44:00,Fail to pick,297,417,0,0,0,0,0,0,0,0,False,0
2025-01-08 17:44:01,persegiBiru,279,409,130,114,44,37,41,34,3,3,False,0.3737626061800339
2025-01-08 17:44:01,Biru,279,409,tensor(130.4400),tensor(114.9405),86,25,90,22,4,3,True,0.0
2025-01-08 17:44:01,persegiBiru,282,412,131,113,151,0,153,0,2,0,True,0.48566169543219495
2025-01-08 17:44:01,Fail to pick,282,412,0,0,0,0,0,0,0,0,False,0
2025-01-08 17:44:01,persegiBiru,296,417,134,109,155,83,154,78,1,5,True,0.4498442322996311
2025-01-08 17:44:01,persegiBiru,279,409,133,115,140,23,136,27,4,4,True,0.10501584939432047
2025-01-08 17:44:01,persegiBiru,297,418,134,107,172,34,173,30,1,4,False,0.10473385951866253
2025-01-08 17:44:01,persegiBiru,285,405,133,112,71,65,69,64,2,1,True,0.3530394633078894
2025-01-08 17:44:01,persegiBiru,290,417,132,108,172,16,172,19,0,3,True,0.32521019739002066
2025-01-08 17:44:01,persegiBiru,285,410,134,112,117,93,117,88,0,5,True,0.1428885869754166
2025-01-08 17:44:01,Fail to pick,285,410,0,0,0,0,0,0,0,0,False,0
2025-01-08 17:44:01,persegiBiru,285,407,131,113,67,21,71,19,4,2,True,0.34087967482654713
2025-01-08 17:44:01,Fail to pick,285,407,0,0,0,0,0,0,0,0,False,0
2025-01-08 17:44:06,persegiBiru,342,417,126,107,57,84,52,80,5,4,True,0.3296098499121636
2025-01-08 17:44:06,Biru,342,417,tensor(126.0320),tensor(107.7393),84,31,81,27,3,4,True,0.0004992485046386719
2025-01-08 17:44:06,persegiBiru,368,424,130,103,188,91,184,93,4,2,True,0.11435449550101402
2025-01-08 17:44:06,persegiBiru,347,416,125,106,188,9,184,7,4,2,True,0.31165218991725935
2025-01-08 17:44:06,persegiBiru,348,415,129,107,71,35,73,31,2,4,False,0.22655067135436885
2025-01-08 17:44:06,Fail to pick,348,415,0,0,0,0,0,0,0,0,False,0
2025-01-08 17:44:06,persegiBiru,367,428,131,107,163,26,164,24,1,2,True,0.1255455352727639
2025-01-08 17:44:06,persegiBiru,345,408,126,107,152,60,153,64,1,4,True,0.3728968199940592
2025-01-08 17:44:07,persegiBiru,364,420,132,110,52,25,52,24,0,1,True,0.4462142046646099
2025-01-08 17:44:07,persegiBiru,360,425,129,107,24,29,21,24,3,5,True,0.13341973384225866
2025-01-08 17:44:07,Fail to pick,360,425,0,0,0,0,0,0,0,0,False,0
2025-01-08 17:44:07,persegiBiru,353,422,126,106,18,95,22,98,4,3,True,0.3775786584526145
2025-01-08 17:44:07,Fail to pick,353,422,0,0,0,0,0,0,0,0,False,0
2025-01-08 17:44:07,persegiBiru,358,418,128,111,55,46,58,48,3,2,True,0.42610963679260294
2025-01-08 17:44:07,Fail to pick,358,418,0,0,0,0,0,0,0,0,False,0
2025-01-08 17:44:07,persegiBiru,361,421,126,110,196,92,197,95,1,3,True,0.17910947826232015
2025-01-08 17:44:07,Biru,361,421,tensor(126.2274),tensor(110.3992),83,33,86,35,3,2,True,0.0
2025-01-08 17:44:07,Fail to pick,361,421,0,0,0,0,0,0,0,0,False,0
2025-01-08 17:44:07,persegiBiru,358,415,126,109,164,8,166,4,2,4,True,0.2190117409675222
2025-01-08 17:44:07,Fail to pick,358,415,0,0,0,0,0,0,0,0,False,0
2025-01-08 17:44:07,persegiBiru,374,424,125,109,168,18,163,16,5,2,True,0.23140472448211732
2025-01-08 17:44:07,persegiBiru,350,419,123,110,106,78,103,82,3,4,True,0.4224721223839182
2025-01-08 17:44:07,persegiBiru,353,419,122,109,150,81,150,85,0,4,True,0.22857177153668964
2025-01-08 17:44:07,Fail to pick,353,419,0,0,0,0,0,0,0,0,False,0
2025-01-08 17:44:07,persegiBiru,352,419,122,111,2,92,1,91,1,1,True,0.17750847632097702
2025-01-08 17:44:07,Fail to pick,352,419,0,0,0,0,0,0,0,0,False,0
2025-01-08 17:44:08,persegiBiru,350,413,123,112,94,13,90,15,4,2,False,0.15612472455823725
2025-01-08 17:44:08,Fail to pick,350,413,0,0,0,0,0,0,0,0,False,0
2025-01-08 17:44:08,persegiBiru,364,445,125,114,105,12,105,12,0,0,False,0.4439615286630304
2025-01-08 17:44:08,persegiBiru,350,419,122,113,166,63,170,66,4,3,True,0.3522813124744596
2025-01-08 17:44:08,persegiBiru,339,416,124,111,124,3,128,-1,4,4,True,0.14862401088989075
2025-01-08 17:44:08,Biru,339,416,tensor(124.4417),tensor(111.0450),84,31,86,31,2,0,True,0.0
2025-01-08 17:44:08,persegiBiru,354,414,125,108,20,70,17,65,3,5,True,0.15479011438555396
2025-01-08 17:44:08,persegiBiru,347,411,124,112,140,10,143,8,3,2,True,0.32905011891819014
2025-01-08 17:44:08,Fail to pick,347,411,0,0,0,0,0,0,0,0,False,0
2025-01-08 17:44:08,persegiBiru,354,414,124,109,32,73,31,77,1,4,True,0.4424840045959768
2025-01-08 17:44:08,Fail to pick,354,414,0,0,0,0,0,0,0,0,False,0
2025-01-08 17:44:08,persegiBiru,357,420,125,109,114,67,111,68,3,1,True,0.42374224101370217
2025-01-08 17:44:08,Fail to pick,357,420,0,0,0,0,0,0,0,0,False,0
2025-01-08 17:44:09,persegiBiru,373,431,127,110,6,35,10,31,4,4,True,0.4841433234175089
2025-01-08 17:44:09,persegiBiru,343,414,121,113,79,66,79,63,0,3,True,0.18924097611805807
2025-01-08 17:44:09,persegiBiru,350,412,124,111,34,21,35,23,1,2,True,0.43807097548664853
2025-01-08 17:44:09,Fail to pick,350,412,0,0,0,0,0,0,0,0,False,0
2025-01-08 17:44:09,persegiBiru,353,420,127,110,173,47,176,49,3,2,True,0.3153793135807668
2025-01-08 17:44:09,Fail to pick,353,420,0,0,0,0,0,0,0,0,False,0
2025-01-08 17:44:09,persegiBiru,350,412,125,110,129,65,132,66,3,1,True,0.20554115772681814
2025-01-08 17:44:09,Biru,350,412,tensor(125.3111),tensor(110.0426),85,32,80,36,5,4,True,0.00047397613525390625
2025-01-08 17:44:09,Fail to pick,350,412,0,0,0,0,0,0,0,0,False,0
2025-01-08 17:44:09,persegiBiru,353,414,126,109,34,15,38,10,4,5,False,0.4415573229489861
2025-01-08 17:44:09,Fail to pick,353,414,0,0,0,0,0,0,0,0,False,0
2025-01-08 17:44:09,persegiBiru,365,428,127,111,109,20,112,20,3,0,True,0.11590438818826483
2025-01-08 17:44:09,persegiBiru,348,415,123,110,195,96,193,99,2,3,True,0.23052660503946584
2025-01-08 17:44:10,persegiBiru,355,423,126,108,96,0,100,-4,4,4,True,0.2631724098761728
2025-01-08 17:44:10,Fail to pick,355,423,0,0,0,0,0,0,0,0,False,0
2025-01-08 17:44:10,persegiBiru,353,419,128,109,186,0,188,-3,2,3,True,0.37550182681460664
2025-01-08 17:44:10,Fail to pick,353,419,0,0,0,0,0,0,0,0,False,0
2025-01-08 17:44:10,persegiBiru,359,411,127,110,41,59,45,56,4,3,True,0.37208414568429815
2025-01-08 17:44:10,Fail to pick,359,411,0,0,0,0,0,0,0,0,False,0
2025-01-08 17:44:10,persegiBiru,366,423,131,109,18,18,13,16,5,2,True,0.40275681793451357
2025-01-08 17:44:10,persegiBiru,354,414,126,111,110,32,108,36,2,4,True,0.45651264040597317
2025-01-08 17:44:10,persegiBiru,348,417,123,110,169,84,172,83,3,1,True,0.2398960651867216
2025-01-08 17:44:10,Fail to pick,348,417,0,0,0,0,0,0,0,0,False,0
2025-01-08 17:44:10,persegiBiru,350,419,124,111,81,80,76,75,5,5,True,0.42953137854287193
2025-01-08 17:44:10,Biru,350,419,tensor(124.9337),tensor(111.3788),83,32,86,33,3,1,True,0.0004987716674804688
2025-01-08 17:44:10,Fail to pick,350,419,0,0,0,0,0,0,0,0,False,0
2025-01-08 17:44:10,persegiBiru,360,414,127,110,63,13,62,14,1,1,True,0.1397381909438838
2025-01-08 17:44:10,persegiBiru,358,411,127,112,127,6,127,2,0,4,True,0.3110726091141228
2025-01-08 17:44:10,Fail to pick,358,411,0,0,0,0,0,0,0,0,False,0
2025-01-08 17:44:11,persegiBiru,379,430,129,111,44,34,48,30,4,4,True,0.3758925622354744
2025-01-08 17:44:11,persegiBiru,353,416,125,112,5,70,2,70,3,0,False,0.3446016816103404
2025-01-08 17:44:11,persegiBiru,353,417,127,110,173,33,175,31,2,2,True,0.3132774144034194
2025-01-08 17:44:11,Fail to pick,353,417,0,0,0,0,0,0,0,0,False,0
2025-01-08 17:44:11,persegiBiru,351,414,125,110,66,82,66,78,0,4,True,0.32566534792752866
2025-01-08 17:44:11,Fail to pick,351,414,0,0,0,0,0,0,0,0,False,0
2025-01-08 17:44:11,persegiBiru,375,429,126,108,17,71,16,69,1,2,True,0.3162383079447433
2025-01-08 17:44:11,persegiBiru,364,422,128,110,161,46,159,50,2,4,False,0.3719955349959535
2025-01-08 17:44:11,persegiBiru,360,413,127,110,158,26,159,26,1,0,True,0.393155073309443
2025-01-08 17:44:11,Biru,360,413,tensor(127.6410),tensor(110.2774),85,33,87,28,2,5,True,0.0004980564117431641
2025-01-08 17:44:11,Fail to pick,360,413,0,0,0,0,0,0,0,0,False,0
2025-01-08 17:44:11,persegiBiru,356,426,126,109,46,27,41,26,5,1,True,0.1773022297889818
2025-01-08 17:44:11,persegiBiru,355,423,127,110,41,70,37,71,4,1,True,0.2985221110065065
2025-01-08 17:44:11,Fail to pick,355,423,0,0,0,0,0,0,0,0,False,0
2025-01-08 17:44:12,persegiBiru,369,427,127,108,118,15,121,11,3,4,True,0.2341346713913157
2025-01-08 17:44:12,persegiBiru,348,419,123,112,186,62,190,59,4,3,False,0.36859077085032954
2025-01-08 17:44:12,persegiBiru,353,412,126,110,182,50,181,46,1,4,True,0.114767994880423
2025-01-08 17:44:12,Fail to pick,353,412,0,0,0,0,0,0,0,0,False,0
2025-01-08 17:44:12,persegiBiru,358,416,126,110,111,95,110,92,1,3,True,0.31243738605446547
2025-01-08 17:44:12,Fail to pick,358,416,0,0,0,0,0,0,0,0,False,0
2025-01-08 17:44:16,persegiBiru,487,351,123,111,5,83,6,83,1,0,True,0.36495060366358323
2025-01-08 17:44:16,Biru,487,351,tensor(123.8087),tensor(111.7476),102,45,105,43,3,2,True,0.000499725341796875
2025-01-08 17:44:17,persegiBiru,466,339,119,110,115,12,113,15,2,3,True,0.15816037374471723
2025-01-08 17:44:17,persegiBiru,472,345,120,113,123,33,121,35,2,2,True,0.46760578130876096
2025-01-08 17:44:17,Fail to pick,472,345,0,0,0,0,0,0,0,0,False,0
2025-01-08 17:44:17,persegiBiru,484,356,123,111,99,72,96,76,3,4,True,0.3975727987457003
2025-01-08 17:44:17,persegiBiru,466,337,120,113,10,35,13,36,3,1,True,0.18200547057494956
2025-01-08 17:44:19,persegiBiru,345,351,127,121,113,65,116,61,3,4,True,0.1462418429059798
2025-01-08 17:44:19,Biru,345,351,tensor(127.0622),tensor(121.5918),102,31,104,35,2,4,True,0.0005071163177490234
2025-01-08 17:44:19,persegiBiru,367,366,129,117,199,93,197,88,2,5,True,0.16853869790204773
2025-01-08 17:44:19,persegiBiru,360,364,126,118,88,47,88,44,0,3,False,0.3381401935372027
2025-01-08 17:44:19,Fail to pick,360,364,0,0,0,0,0,0,0,0,False,0
2025-01-08 17:44:19,persegiBiru,354,359,130,120,0,25,-1,23,1,2,True,0.44630439689574986
2025-01-08 17:44:19,Fail to pick,354,359,0,0,0,0,0,0,0,0,False,0
2025-01-08 17:44:19,persegiBiru,345,351,125,121,181,67,182,64,1,3,False,0.2853356508280529
2025-01-08 17:44:19,Fail to pick,345,351,0,0,0,0,0,0,0,0,False,0
2025-01-08 17:44:19,persegiBiru,343,351,128,119,36,45,34,46,2,1,True,0.27924733298494353
2025-01-08 17:44:19,Fail to pick,343,351,0,0,0,0,0,0,0,0,False,0
2025-01-08 17:44:19,persegiBiru,343,350,127,119,22,13,20,9,2,4,False,0.30281280236689223
2025-01-08 17:44:19,Fail to pick,343,350,0,0,0,0,0,0,0,0,False,0
2025-01-08 17:44:19,persegiBiru,359,360,128,122,159,44,157,41,2,3,True,0.21868565366183146
2025-01-08 17:44:19,persegiBiru,359,356,129,120,137,92,138,90,1,2,True,0.15550665685622012
2025-01-08 17:44:19,Fail to pick,359,356,0,0,0,0,0,0,0,0,False,0
2025-01-08 17:44:19,persegiBiru,368,363,132,118,194,4,198,7,4,3,True,0.46247878639660567
2025-01-08 17:44:19,Fail to pick,368,363,0,0,0,0,0,0,0,0,False,0
2025-01-08 17:44:20,persegiBiru,340,354,128,120,107,91,104,90,3,1,True,0.10532213158645223
2025-01-08 17:44:20,Biru,340,354,tensor(128.8788),tensor(120.9420),101,31,105,34,4,3,True,0.0
2025-01-08 17:44:20,persegiBiru,347,351,123,116,123,15,125,15,2,0,True,0.2601603473944936
2025-01-08 17:44:20,Fail to pick,347,351,0,0,0,0,0,0,0,0,False,0
2025-01-08 17:44:20,persegiBiru,340,351,127,121,90,10,88,8,2,2,True,0.33381735742294216
2025-01-08 17:44:20,Fail to pick,340,351,0,0,0,0,0,0,0,0,False,0
2025-01-08 17:44:20,persegiBiru,338,351,127,121,127,4,130,3,3,1,True,0.14079186921177872
2025-01-08 17:44:20,Fail to pick,338,351,0,0,0,0,0,0,0,0,False,0
2025-01-08 17:44:20,persegiBiru,345,360,127,120,191,36,187,36,4,0,True,0.47060065239330584
2025-01-08 17:44:20,Fail to pick,345,360,0,0,0,0,0,0,0,0,False,0
2025-01-08 17:44:20,persegiBiru,351,364,128,118,189,87,189,89,0,2,True,0.2180899543385884
2025-01-08 17:44:20,Fail to pick,351,364,0,0,0,0,0,0,0,0,False,0
2025-01-08 17:44:20,persegiBiru,357,362,133,120,6,48,2,49,4,1,True,0.4522191948735279
2025-01-08 17:44:20,Fail to pick,357,362,0,0,0,0,0,0,0,0,False,0
2025-01-08 17:44:20,persegiBiru,351,363,126,119,95,48,94,47,1,1,True,0.29354370112493955
2025-01-08 17:44:20,Fail to pick,351,363,0,0,0,0,0,0,0,0,False,0
2025-01-08 17:44:20,persegiBiru,339,351,127,120,36,22,31,17,5,5,False,0.20420017387915387
2025-01-08 17:44:21,persegiBiru,358,362,130,120,131,66,134,62,3,4,True,0.2427166213164266
2025-01-08 17:44:21,persegiBiru,349,344,124,113,191,96,186,95,5,1,True,0.2590246802640606
2025-01-08 17:44:21,Biru,349,344,tensor(124.4193),tensor(113.6895),104,32,105,31,1,1,True,0.0
2025-01-08 17:44:21,persegiBiru,345,350,125,123,72,75,76,79,4,4,True,0.12034795520546822
2025-01-08 17:44:21,Fail to pick,345,350,0,0,0,0,0,0,0,0,False,0
2025-01-08 17:44:21,persegiBiru,334,374,122,124,38,6,40,9,2,3,True,0.4646149151262787
2025-01-08 17:44:21,persegiBiru,308,398,134,120,61,88,61,83,0,5,True,0.4269206758898074
2025-01-08 17:44:21,persegiBiru,305,372,128,123,196,10,199,10,3,0,True,0.2616177046470035
2025-01-08 17:44:21,persegiBiru,329,384,128,119,4,9,6,6,2,3,True,0.36092430245737483
2025-01-08 17:44:21,persegiBiru,336,386,135,117,11,14,8,18,3,4,True,0.3209486320111008
2025-01-08 17:44:21,Fail to pick,336,386,0,0,0,0,0,0,0,0,False,0
2025-01-08 17:44:21,persegiBiru,291,378,126,124,153,28,153,32,0,4,True,0.19196244451708458
2025-01-08 17:44:21,persegiBiru,349,342,122,115,120,54,118,56,2,2,True,0.47311437574518544
2025-01-08 17:44:22,persegiBiru,289,379,128,123,199,57,195,59,4,2,True,0.16108570320490767
2025-01-08 17:44:22,persegiBiru,354,366,126,118,4,19,4,23,0,4,True,0.40548794969723345
2025-01-08 17:44:22,Biru,354,366,tensor(126.9081),tensor(118.0083),98,32,102,33,4,1,True,0.0004994869232177734
2025-01-08 17:44:22,persegiBiru,271,379,130,121,186,83,185,78,1,5,True,0.25280679397730255
2025-01-08 17:44:22,persegiBiru,301,393,134,116,186,53,182,53,4,0,False,0.12461836108326252
2025-01-08 17:44:22,persegiBiru,320,350,120,121,140,40,141,40,1,0,True,0.2096338979016383
2025-01-08 17:44:22,persegiBiru,337,348,123,114,103,12,104,8,1,4,True,0.4389869612787598
2025-01-08 17:44:22,persegiBiru,362,384,127,113,139,59,137,56,2,3,True,0.29713707189172933
2025-01-08 17:44:22,persegiBiru,375,366,127,113,159,67,158,68,1,1,False,0.10700105444725186
2025-01-08 17:44:22,persegiBiru,339,345,127,115,24,96,25,91,1,5,True,0.4263037506348889
2025-01-08 17:44:23,persegiBiru,327,334,126,123,15,30,15,25,0,5,True,0.14722589225744645
2025-01-08 17:44:23,Biru,327,334,tensor(126.2359),tensor(123.6259),107,30,104,28,3,2,True,0.000499725341796875
2025-01-08 17:44:42,persegiHijau,901,387,114,120,158,9,156,4,2,5,True,0.2322809169317695
2025-01-08 17:44:42,Hijau,901,387,tensor(114.9648),tensor(120.7423),92,83,89,78,3,5,True,0.0
2025-01-08 17:44:42,persegiHijau,881,376,111,119,107,37,110,40,3,3,True,0.40689359748586074
2025-01-08 17:44:43,persegiHijau,874,365,111,122,156,23,154,20,2,3,True,0.48126511863216426
2025-01-08 17:44:43,persegiHijau,890,374,112,120,147,49,147,45,0,4,False,0.39124356910305835
2025-01-08 17:44:43,persegiHijau,890,369,115,120,36,46,31,48,5,2,False,0.22286699036233368
2025-01-08 17:44:43,Fail to pick,890,369,0,0,0,0,0,0,0,0,False,0
2025-01-08 17:44:43,persegiHijau,887,370,109,116,60,73,61,71,1,2,True,0.33525658779600814
2025-01-08 17:44:43,Fail to pick,887,370,0,0,0,0,0,0,0,0,False,0
2025-01-08 17:44:43,persegiHijau,909,377,112,119,189,5,185,5,4,0,True,0.3504357799728798
2025-01-08 17:44:43,persegiHijau,889,366,116,121,35,24,36,22,1,2,True,0.2564770926168561
2025-01-08 17:44:43,persegiHijau,895,379,109,118,24,91,27,88,3,3,True,0.4485450858643588
2025-01-08 17:44:43,persegiHijau,886,369,111,117,107,71,102,70,5,1,True,0.37858339425109444
2025-01-08 17:44:43,Hijau,886,369,tensor(111.4559),tensor(117.4426),97,82,93,84,4,2,True,0.0
2025-01-08 17:44:43,persegiHijau,907,372,112,119,165,72,167,71,2,1,True,0.329311134082217
2025-01-08 17:44:44,persegiHijau,885,361,111,121,95,28,97,25,2,3,True,0.34064815992623576
2025-01-08 17:44:44,persegiHijau,895,363,116,120,47,9,44,7,3,2,True,0.3319499705263854
2025-01-08 17:44:44,persegiHijau,877,371,107,114,109,37,110,37,1,0,True,0.4574063533857363
2025-01-08 17:44:44,persegiHijau,903,376,117,120,52,21,52,24,0,3,True,0.35667266901454553
2025-01-08 17:44:44,persegiHijau,891,365,114,119,186,48,182,44,4,4,True,0.1364161344810395
2025-01-08 17:44:44,persegiHijau,861,347,112,119,124,94,128,98,4,4,False,0.23701138869792807
2025-01-08 17:44:44,persegiHijau,892,366,114,119,77,64,73,63,4,1,True,0.47563245149715194
2025-01-08 17:44:44,persegiHijau,893,358,116,122,10,81,14,80,4,1,True,0.16802787794503882
2025-01-08 17:44:44,Fail to pick,893,358,0,0,0,0,0,0,0,0,False,0
2025-01-08 17:44:44,persegiHijau,899,375,117,119,35,55,38,54,3,1,True,0.3515480549040776
2025-01-08 17:44:44,Hijau,899,375,tensor(117.6734),tensor(119.0894),95,83,91,85,4,2,True,0.0
2025-01-08 17:44:45,persegiHijau,893,360,118,120,146,2,148,1,2,1,False,0.2692580013780275
2025-01-08 17:44:45,persegiHijau,879,366,110,118,10,76,9,75,1,1,False,0.43415284735083837
2025-01-08 17:44:45,persegiHijau,900,377,116,119,10,24,6,25,4,1,True,0.1941376603868854
2025-01-08 17:44:45,persegiHijau,886,364,111,118,80,73,78,71,2,2,True,0.30329445683396294
2025-01-08 17:44:45,persegiHijau,893,364,115,117,27,73,30,75,3,2,True,0.4567759425976836
2025-01-08 17:44:45,Fail to pick,893,364,0,0,0,0,0,0,0,0,False,0
2025-01-08 17:44:45,persegiHijau,886,368,113,117,80,23,78,25,2,2,True,0.22167093216131897
2025-01-08 17:44:45,Fail to pick,886,368,0,0,0,0,0,0,0,0,False,0
2025-01-08 17:44:45,persegiHijau,887,367,112,118,173,14,172,11,1,3,True,0.11956645138317934
2025-01-08 17:44:45,Fail to pick,887,367,0,0,0,0,0,0,0,0,False,0
2025-01-08 17:44:45,persegiHijau,864,362,109,119,80,97,80,97,0,0,True,0.4708014062648582
2025-01-08 17:44:45,persegiHijau,892,368,113,119,158,44,155,48,3,4,True,0.2957923676997745
2025-01-08 17:44:46,persegiHijau,874,370,109,117,158,95,157,99,1,4,True,0.1048368867506432
2025-01-08 17:44:46,Hijau,874,370,tensor(109.2405),tensor(117.5006),97,80,92,81,5,1,True,0.0005071163177490234
2025-01-08 17:44:46,persegiHijau,906,375,112,119,11,87,6,83,5,4,True,0.2099116545763372
2025-01-08 17:44:46,persegiHijau,887,369,111,117,11,75,14,79,3,4,True,0.12136651017667406
2025-01-08 17:44:46,persegiHijau,888,367,115,119,140,40,140,41,0,1,True,0.28591115317356086
2025-01-08 17:44:46,Fail to pick,888,367,0,0,0,0,0,0,0,0,False,0
2025-01-08 17:44:46,persegiHijau,878,368,107,115,9,8,13,11,4,3,True,0.47772417121175603
2025-01-08 17:44:46,persegiHijau,903,373,114,119,175,20,174,17,1,3,True,0.10572393448951334
2025-01-08 17:44:46,persegiHijau,904,374,115,120,4,19,7,21,3,2,True,0.4175090299608296
2025-01-08 17:44:46,Fail to pick,904,374,0,0,0,0,0,0,0,0,False,0
2025-01-08 17:44:46,persegiHijau,901,377,113,117,174,76,176,71,2,5,True,0.28635146227243347
2025-01-08 17:44:46,Fail to pick,901,377,0,0,0,0,0,0,0,0,False,0
2025-01-08 17:44:46,persegiHijau,900,377,110,117,198,3,193,3,5,0,False,0.40643499210040146
2025-01-08 17:44:46,Fail to pick,900,377,0,0,0,0,0,0,0,0,False,0
2025-01-08 17:44:46,persegiHijau,868,364,109,117,17,96,12,92,5,4,True,0.1803406019695989
2025-01-08 17:44:47,persegiHijau,885,358,112,119,40,4,41,7,1,3,True,0.4760570347644012
2025-01-08 17:44:47,persegiHijau,891,366,113,119,41,49,41,45,0,4,True,0.10144530972735222
2025-01-08 17:44:47,Hijau,891,366,tensor(113.9330),tensor(119.7540),98,82,98,79,0,3,True,0.0
2025-01-08 17:44:47,Fail to pick,891,366,0,0,0,0,0,0,0,0,False,0
2025-01-08 17:44:47,persegiHijau,866,360,110,118,57,70,57,69,0,1,True,0.23097984319557377
2025-01-08 17:44:47,persegiHijau,899,378,117,119,52,7,52,3,0,4,True,0.25889362043936404
2025-01-08 17:44:47,persegiHijau,891,364,113,121,158,68,160,65,2,3,True,0.11192387275996696
2025-01-08 17:44:47,persegiHijau,899,366,118,120,147,65,144,68,3,3,True,0.3256351548770752
2025-01-08 17:44:47,Fail to pick,899,366,0,0,0,0,0,0,0,0,False,0
2025-01-08 17:44:47,persegiHijau,896,362,116,119,107,81,104,77,3,4,True,0.30259771302882943
2025-01-08 17:44:47,Fail to pick,896,362,0,0,0,0,0,0,0,0,False,0
2025-01-08 17:44:47,persegiHijau,904,376,117,120,7,0,3,-3,4,3,True,0.312423642400796
2025-01-08 17:44:47,persegiHijau,912,377,114,118,191,67,188,71,3,4,True,0.2141137741815307
2025-01-08 17:44:47,Fail to pick,912,377,0,0,0,0,0,0,0,0,False,0
2025-01-08 17:44:48,persegiHijau,919,572,135,119,139,24,136,23,3,1,True,0.2539978827181639
2025-01-08 17:44:48,Hijau,919,572,tensor(135.4005),tensor(119.9072),41,85,44,82,3,3,True,0.0
2025-01-08 17:44:49,persegiHijau,896,568,131,123,136,70,140,68,4,2,True,0.26633197509860046
2025-01-08 17:44:49,persegiHijau,902,566,135,125,64,41,60,43,4,2,False,0.4562158196103402
2025-01-08 17:44:49,Fail to pick,902,566,0,0,0,0,0,0,0,0,False,0
2025-01-08 17:44:49,persegiHijau,890,570,130,122,134,10,133,11,1,1,False,0.4289975867452148
2025-01-08 17:44:49,persegiHijau,893,567,127,125,191,23,191,20,0,3,True,0.18944010426977537
2025-01-08 17:44:49,Fail to pick,893,567,0,0,0,0,0,0,0,0,False,0
2025-01-08 17:44:49,persegiHijau,899,569,133,124,83,51,86,49,3,2,True,0.48974430393613366
2025-01-08 17:44:49,Fail to pick,899,569,0,0,0,0,0,0,0,0,False,0
2025-01-08 17:44:49,persegiHijau,900,570,132,122,152,47,152,51,0,4,True,0.24791316879619327
2025-01-08 17:44:49,Fail to pick,900,570,0,0,0,0,0,0,0,0,False,0
2025-01-08 17:44:49,persegiHijau,903,570,137,123,197,88,195,85,2,3,True,0.26751942067238854
2025-01-08 17:44:49,Fail to pick,903,570,0,0,0,0,0,0,0,0,False,0
2025-01-08 17:44:49,persegiHijau,898,568,134,124,49,21,52,16,3,5,True,0.16504881705472746
2025-01-08 17:44:49,Fail to pick,898,568,0,0,0,0,0,0,0,0,False,0
2025-01-08 17:44:50,persegiHijau,896,569,137,124,104,37,101,40,3,3,True,0.1128457078392609
2025-01-08 17:44:50,Hijau,896,569,tensor(137.7282),tensor(124.0630),41,82,37,81,4,1,True,0.0
2025-01-08 17:44:50,Fail to pick,896,569,0,0,0,0,0,0,0,0,False,0
2025-01-08 17:44:50,persegiHijau,894,569,135,123,138,22,136,17,2,5,True,0.23753974966966693
2025-01-08 17:44:50,Fail to pick,894,569,0,0,0,0,0,0,0,0,False,0
2025-01-08 17:44:50,persegiHijau,898,567,137,125,159,90,162,89,3,1,True,0.4904089969528298
2025-01-08 17:44:50,Fail to pick,898,567,0,0,0,0,0,0,0,0,False,0
2025-01-08 17:44:50,persegiHijau,868,549,133,130,113,1,112,-2,1,3,True,0.4492994997110277
2025-01-08 17:44:50,persegiHijau,893,568,134,124,4,88,6,84,2,4,True,0.34939734849184123
2025-01-08 17:44:50,persegiHijau,891,570,134,125,59,2,61,1,2,1,True,0.4947841081227853
2025-01-08 17:44:50,Fail to pick,891,570,0,0,0,0,0,0,0,0,False,0
2025-01-08 17:44:50,persegiHijau,903,571,136,123,123,92,124,90,1,2,True,0.3837441484454226
2025-01-08 17:44:50,persegiHijau,896,566,133,125,128,31,130,30,2,1,True,0.4843924806369958
2025-01-08 17:44:50,Fail to pick,896,566,0,0,0,0,0,0,0,0,False,0
2025-01-08 17:44:50,persegiHijau,906,573,133,121,142,22,137,17,5,5,True,0.41272516145629834
2025-01-08 17:44:50,persegiHijau,892,568,126,123,180,86,180,81,0,5,True,0.27195970391690083
2025-01-08 17:44:51,persegiHijau,903,573,138,126,105,96,100,100,5,4,True,0.35692523380252683
2025-01-08 17:44:51,Hijau,903,573,tensor(138.1870),tensor(126.1641),40,83,44,79,4,4,True,0.0
2025-01-08 17:44:51,persegiHijau,893,559,127,132,9,51,6,47,3,4,True,0.37589808321572815
2025-01-08 17:44:51,persegiHijau,894,564,127,128,93,50,90,50,3,0,True,0.4220964923531537
2025-01-08 17:44:51,Fail to pick,894,564,0,0,0,0,0,0,0,0,False,0
2025-01-08 17:44:51,persegiHijau,909,568,131,125,167,52,169,50,2,2,True,0.364729585270004
2025-01-08 17:44:51,persegiHijau,891,563,126,125,90,65,88,61,2,4,True,0.48168353242289297
2025-01-08 17:44:51,persegiHijau,891,568,128,123,185,99,181,103,4,4,True,0.3899213294897246
2025-01-08 17:44:51,Fail to pick,891,568,0,0,0,0,0,0,0,0,False,0
2025-01-08 17:44:51,persegiHijau,894,570,134,124,126,95,123,96,3,1,True,0.14462562505654902
2025-01-08 17:44:51,Fail to pick,894,570,0,0,0,0,0,0,0,0,False,0
2025-01-08 17:44:51,persegiHijau,899,567,137,125,161,25,162,20,1,5,False,0.3596847695443378
2025-01-08 17:44:51,Fail to pick,899,567,0,0,0,0,0,0,0,0,False,0
2025-01-08 17:44:52,persegiHijau,899,570,131,124,9,82,6,78,3,4,True,0.25973191274880314
2025-01-08 17:44:52,Fail to pick,899,570,0,0,0,0,0,0,0,0,False,0
2025-01-08 17:44:52,persegiHijau,899,566,131,126,60,72,61,67,1,5,True,0.28901016883481306
2025-01-08 17:44:52,Hijau,899,566,tensor(131.7319),tensor(126.7137),42,83,45,78,3,5,True,0.0
2025-01-08 17:44:52,Fail to pick,899,566,0,0,0,0,0,0,0,0,False,0
2025-01-08 17:44:52,persegiHijau,892,569,136,124,197,92,198,96,1,4,True,0.23988846003403302
2025-01-08 17:44:52,Fail to pick,892,569,0,0,0,0,0,0,0,0,False,0
2025-01-08 17:44:52,persegiHijau,896,567,138,125,96,0,97,0,1,0,True,0.2543770440314813
2025-01-08 17:44:52,Fail to pick,896,567,0,0,0,0,0,0,0,0,False,0
2025-01-08 17:44:52,persegiHijau,898,568,134,123,174,93,176,88,2,5,False,0.30061451707241027
2025-01-08 17:44:52,Fail to pick,898,568,0,0,0,0,0,0,0,0,False,0
2025-01-08 17:44:52,persegiHijau,899,568,136,125,57,32,58,35,1,3,True,0.4980006648107824
2025-01-08 17:44:52,Fail to pick,899,568,0,0,0,0,0,0,0,0,False,0
2025-01-08 17:44:52,persegiHijau,882,562,128,128,87,78,87,73,0,5,True,0.36223216392983937
2025-01-08 17:44:52,persegiHijau,897,568,132,125,13,40,17,41,4,1,False,0.4898015659569509
2025-01-08 17:44:52,persegiHijau,901,575,135,124,149,57,148,53,1,4,True,0.1206586838012088
2025-01-08 17:44:52,Fail to pick,901,575,0,0,0,0,0,0,0,0,False,0
2025-01-08 17:44:52,persegiHijau,903,572,135,123,180,68,175,66,5,2,True,0.12042209896260961
2025-01-08 17:44:52,Fail to pick,903,572,0,0,0,0,0,0,0,0,False,0
2025-01-08 17:44:53,persegiHijau,895,568,134,124,143,88,138,87,5,1,True,0.47988911421212266
2025-01-08 17:44:53,Fail to pick,895,568,0,0,0,0,0,0,0,0,False,0
2025-01-08 17:44:53,persegiHijau,892,568,132,124,78,12,75,11,3,1,True,0.3503994463042085
2025-01-08 17:44:53,Hijau,892,568,tensor(132.9901),tensor(124.5300),42,82,37,85,5,3,True,0.0
2025-01-08 17:44:53,Fail to pick,892,568,0,0,0,0,0,0,0,0,False,0
2025-01-08 17:44:53,persegiHijau,895,566,132,122,39,2,37,4,2,2,True,0.17305288995709328
2025-01-08 17:44:53,Fail to pick,895,566,0,0,0,0,0,0,0,0,False,0
2025-01-08 17:44:53,persegiHijau,897,566,132,124,146,8,142,11,4,3,True,0.19208785775896542
2025-01-08 17:44:53,Fail to pick,897,566,0,0,0,0,0,0,0,0,False,0
2025-01-08 17:44:53,persegiHijau,898,567,131,125,74,5,76,2,2,3,False,0.32360879800520037
2025-01-08 17:44:53,Fail to pick,898,567,0,0,0,0,0,0,0,0,False,0
2025-01-08 17:44:53,persegiHijau,900,572,136,122,105,19,100,16,5,3,True,0.49764098645676613
2025-01-08 17:44:53,Fail to pick,900,572,0,0,0,0,0,0,0,0,False,0
2025-01-08 17:44:53,persegiHijau,897,568,134,125,24,14,25,18,1,4,True,0.38239371775321807
2025-01-08 17:44:53,Fail to pick,897,568,0,0,0,0,0,0,0,0,False,0
2025-01-08 17:44:53,persegiHijau,893,567,132,123,109,76,112,71,3,5,True,0.2315966288410244
2025-01-08 17:44:53,Fail to pick,893,567,0,0,0,0,0,0,0,0,False,0
2025-01-08 17:44:53,persegiHijau,895,566,136,124,162,20,159,19,3,1,True,0.3812440684366154
2025-01-08 17:44:53,Fail to pick,895,566,0,0,0,0,0,0,0,0,False,0
2025-01-08 17:44:54,persegiHijau,895,567,135,124,89,64,91,59,2,5,True,0.459544013915566
2025-01-08 17:44:54,Fail to pick,895,567,0,0,0,0,0,0,0,0,False,0
2025-01-08 17:44:54,persegiHijau,891,569,127,122,107,45,111,40,4,5,True,0.365986723812741
2025-01-08 17:44:54,Fail to pick,891,569,0,0,0,0,0,0,0,0,False,0
2025-01-08 17:44:54,persegiHijau,887,569,131,124,24,59,22,63,2,4,True,0.28157020977414604
2025-01-08 17:44:54,Hijau,887,569,tensor(131.0323),tensor(124.5400),41,82,36,84,5,2,True,0.0004792213439941406
2025-01-08 17:44:54,Fail to pick,887,569,0,0,0,0,0,0,0,0,False,0
2025-01-08 17:44:54,persegiHijau,895,566,126,126,31,35,31,35,0,0,True,0.43429382334326416
2025-01-08 17:44:54,Fail to pick,895,566,0,0,0,0,0,0,0,0,False,0
2025-01-08 17:44:54,persegiHijau,897,564,139,127,17,22,12,23,5,1,True,0.4405241832685264
2025-01-08 17:44:54,Fail to pick,897,564,0,0,0,0,0,0,0,0,False,0
2025-01-08 17:44:54,persegiHijau,897,572,135,125,137,62,140,59,3,3,True,0.16644591477023585
2025-01-08 17:44:54,Fail to pick,897,572,0,0,0,0,0,0,0,0,False,0
2025-01-08 17:44:54,persegiHijau,899,575,136,126,89,45,91,46,2,1,True,0.33455124874401304
2025-01-08 17:44:54,Fail to pick,899,575,0,0,0,0,0,0,0,0,False,0
2025-01-08 17:44:54,persegiHijau,898,569,138,125,184,83,184,80,0,3,True,0.2407310929347684
2025-01-08 17:44:54,Fail to pick,898,569,0,0,0,0,0,0,0,0,False,0
2025-01-08 17:44:55,persegiHijau,897,571,136,124,139,78,143,81,4,3,True,0.18572934308600983
2025-01-08 17:44:55,Fail to pick,897,571,0,0,0,0,0,0,0,0,False,0
2025-01-08 17:44:55,persegiHijau,908,569,137,124,149,21,151,18,2,3,True,0.32664036694664234
2025-01-08 17:44:55,persegiHijau,884,576,132,128,153,9,151,11,2,2,True,0.10685522957913239
2025-01-08 17:44:55,persegiHijau,891,574,128,121,71,47,68,51,3,4,True,0.17009814814816626
2025-01-08 17:44:55,Fail to pick,891,574,0,0,0,0,0,0,0,0,False,0
2025-01-08 17:47:22,persegiHijau,352,478,132,132,132,63,128,62,4,1,True,0.2604387206446811
2025-01-08 17:47:22,Hijau,352,478,tensor(132.9302),tensor(132.8325),67,32,65,30,2,2,True,0.0005002021789550781
2025-01-08 17:47:23,persegiHijau,347,481,124,133,23,22,22,25,1,3,True,0.42299599643994246
2025-01-08 17:47:23,Fail to pick,347,481,0,0,0,0,0,0,0,0,False,0
2025-01-08 17:47:23,persegiHijau,361,480,131,134,45,88,46,92,1,4,True,0.30315005210919616
2025-01-08 17:47:23,persegiHijau,359,474,129,132,85,28,83,23,2,5,True,0.11089787643363423
2025-01-08 17:47:23,Fail to pick,359,474,0,0,0,0,0,0,0,0,False,0
2025-01-08 17:47:23,persegiHijau,347,484,125,132,28,23,29,21,1,2,True,0.11846923935188257
2025-01-08 17:47:23,persegiHijau,347,482,124,130,98,74,100,75,2,1,True,0.10257337525257873
2025-01-08 17:47:23,Fail to pick,347,482,0,0,0,0,0,0,0,0,False,0
2025-01-08 17:47:23,persegiHijau,358,481,129,133,62,28,65,25,3,3,True,0.20733662485957782
2025-01-08 17:47:23,persegiHijau,344,474,130,135,3,85,-1,80,4,5,False,0.3122514669883372
2025-01-08 17:47:23,persegiHijau,334,487,125,132,23,89,27,87,4,2,True,0.1324824518478953
2025-01-08 17:47:23,persegiHijau,364,480,130,134,26,55,26,52,0,3,True,0.13562606687292195
2025-01-08 17:47:23,Hijau,364,480,tensor(130.3890),tensor(134.0745),66,33,67,35,1,2,True,0.0
2025-01-08 17:47:24,persegiHijau,349,484,126,136,79,96,78,96,1,0,True,0.27919544089981385
2025-01-08 17:47:24,persegiHijau,302,493,130,132,60,62,63,66,3,4,True,0.45012752143861234
2025-01-08 17:47:24,persegiHijau,280,461,119,140,177,33,174,29,3,4,True,0.3564751989166447
2025-01-08 17:47:24,persegiHijau,326,481,126,133,182,2,181,2,1,0,True,0.48764035503617287
2025-01-08 17:47:24,persegiHijau,287,467,118,136,80,37,84,40,4,3,True,0.3337228505207923
2025-01-08 17:47:24,persegiHijau,351,482,129,132,188,28,184,26,4,2,True,0.4265053433032401
2025-01-08 17:47:24,persegiHijau,332,484,127,137,29,59,29,62,0,3,True,0.11645591852529753
2025-01-08 17:47:24,persegiHijau,348,483,128,131,40,74,38,73,2,1,True,0.2778277136402151
2025-01-08 17:47:25,persegiHijau,329,483,126,133,33,82,32,78,1,4,True,0.21115958940562451
2025-01-08 17:47:25,Hijau,329,483,tensor(126.9038),tensor(133.2266),65,30,69,29,4,1,True,0.0
2025-01-08 17:47:25,persegiHijau,350,483,124,131,63,57,64,52,1,5,True,0.12065997444577392
2025-01-08 17:47:29,persegiHijau,429,434,147,144,73,95,74,93,1,2,True,0.18283684064354128
2025-01-08 17:47:29,Hijau,429,434,tensor(147.3691),tensor(144.8688),79,39,80,43,1,4,True,0.0
2025-01-08 17:47:29,persegiHijau,455,423,144,140,120,3,117,0,3,3,True,0.21903570668291997
2025-01-08 17:47:29,persegiHijau,406,443,144,139,71,34,72,35,1,1,False,0.18818572142151344
2025-01-08 17:47:29,persegiHijau,381,442,150,147,199,76,201,76,2,0,True,0.30580767592226277
2025-01-08 17:47:29,persegiHijau,385,440,145,142,105,44,104,40,1,4,True,0.3526774854682537
2025-01-08 17:47:29,Fail to pick,385,440,0,0,0,0,0,0,0,0,False,0
2025-01-08 17:47:29,persegiHijau,424,417,144,147,77,65,73,60,4,5,True,0.1778189062664215
2025-01-08 17:47:33,persegiHijau,461,458,142,150,60,38,56,40,4,2,True,0.3183797836272242
2025-01-08 17:47:33,Hijau,461,458,tensor(142.2810),tensor(150.4445),72,42,74,40,2,2,True,0.0
2025-01-08 17:47:33,persegiHijau,448,456,143,153,2,18,-1,16,3,2,True,0.26645274262445173
2025-01-08 17:47:34,persegiHijau,350,363,124,136,122,34,117,36,5,2,True,0.2770438264749171
2025-01-08 17:47:34,Hijau,350,363,tensor(124.4418),tensor(136.8012),99,32,100,30,1,2,True,0.0004985332489013672
2025-01-08 17:47:34,persegiHijau,343,361,118,139,61,75,56,71,5,4,True,0.32161330234889485
2025-01-08 17:47:34,Fail to pick,343,361,0,0,0,0,0,0,0,0,False,0
2025-01-08 17:47:34,persegiHijau,308,378,126,140,87,23,89,27,2,4,True,0.18696262239055086
2025-01-08 17:47:34,persegiHijau,371,356,126,130,156,33,154,28,2,5,True,0.396815727594494
2025-01-08 17:47:35,persegiHijau,349,378,126,138,120,21,117,22,3,1,True,0.3154315184807641
2025-01-08 17:47:35,persegiHijau,331,378,130,136,128,0,123,-5,5,5,True,0.2619883320032672
2025-01-08 17:47:35,persegiHijau,339,381,129,133,110,2,111,0,1,2,True,0.4829323163807935
2025-01-08 17:47:35,Fail to pick,339,381,0,0,0,0,0,0,0,0,False,0
2025-01-08 17:47:35,persegiHijau,348,373,122,134,182,75,178,77,4,2,True,0.33231322734892027
2025-01-08 17:47:35,Fail to pick,348,373,0,0,0,0,0,0,0,0,False,0
2025-01-08 17:47:35,persegiHijau,337,385,130,135,92,73,89,69,3,4,True,0.24907385245019778
2025-01-08 17:47:35,persegiHijau,365,358,131,129,23,29,25,29,2,0,True,0.19440136568131902
2025-01-08 17:47:35,persegiHijau,345,369,127,130,106,47,103,51,3,4,True,0.31095583128298243
2025-01-08 17:47:35,Hijau,345,369,tensor(127.2895),tensor(130.6469),97,31,97,27,0,4,True,0.0
2025-01-08 17:47:35,persegiHijau,369,358,129,129,180,30,179,25,1,5,True,0.19580338928239716
2025-01-08 17:47:54,persegiHijau,793,460,121,120,8,98,10,93,2,5,True,0.2633359259776704
2025-01-08 17:47:54,Hijau,793,460,tensor(121.2627),tensor(120.2454),72,73,73,70,1,3,True,0.0
2025-01-08 17:47:55,persegiHijau,781,462,120,121,118,32,113,35,5,3,True,0.22376385125121045
2025-01-08 17:47:55,persegiHijau,791,464,120,118,185,77,182,81,3,4,False,0.27478021724842333
2025-01-08 17:47:55,persegiHijau,803,459,120,125,8,97,3,99,5,2,True,0.33640906637123325
2025-01-08 17:47:55,persegiHijau,795,462,121,121,1,44,-4,40,5,4,True,0.3003657073119722
2025-01-08 17:47:55,Fail to pick,795,462,0,0,0,0,0,0,0,0,False,0
2025-01-08 17:47:55,persegiHijau,794,468,120,120,81,42,76,38,5,4,True,0.13603541936860897
2025-01-08 17:47:55,Fail to pick,794,468,0,0,0,0,0,0,0,0,False,0
2025-01-08 17:47:56,persegiHijau,796,464,119,122,124,13,124,9,0,4,True,0.21036196290105755
2025-01-08 17:47:56,Hijau,796,464,tensor(119.9088),tensor(122.3596),71,73,68,77,3,4,True,0.0
2025-01-08 17:47:56,Fail to pick,796,464,0,0,0,0,0,0,0,0,False,0
2025-01-08 17:47:56,persegiHijau,792,468,118,120,42,62,37,64,5,2,True,0.4604017376391004
2025-01-08 17:47:56,Fail to pick,792,468,0,0,0,0,0,0,0,0,False,0
2025-01-08 17:47:56,persegiHijau,807,468,119,119,49,72,45,73,4,1,True,0.21869103568189022
2025-01-08 17:47:56,persegiHijau,795,476,120,117,83,33,87,29,4,4,True,0.4788408495391746
2025-01-08 17:47:56,persegiHijau,795,467,127,120,87,22,86,21,1,1,True,0.3346971044258764
2025-01-08 17:47:56,Fail to pick,795,467,0,0,0,0,0,0,0,0,False,0
2025-01-08 17:47:56,persegiHijau,805,468,123,119,60,74,64,76,4,2,True,0.44767258671938037
2025-01-08 17:47:56,persegiHijau,825,460,117,124,83,67,83,67,0,0,True,0.33047484169806074
2025-01-08 17:48:08,persegiHijau,845,141,123,130,91,36,93,35,2,1,True,0.1685376871952883
2025-01-08 17:48:08,persegiHijau,828,133,115,129,150,42,147,43,3,1,False,0.24509160330406532
2025-01-08 17:48:08,Hijau,828,133,tensor(115.9796),tensor(129.6966),163,76,165,73,2,3,True,0.0
2025-01-08 17:48:08,persegiHijau,847,179,132,141,41,60,36,59,5,1,True,0.35734618971109466
2025-01-08 17:48:08,persegiHijau,834,128,120,129,111,53,114,56,3,3,True,0.1553391979052593
2025-01-08 17:48:08,persegiHijau,825,137,115,126,119,12,117,14,2,2,False,0.2508400661435022
2025-01-08 17:48:08,Fail to pick,825,137,0,0,0,0,0,0,0,0,False,0
2025-01-08 17:48:09,persegiHijau,796,153,135,143,43,6,43,6,0,0,False,0.4064101316019677
2025-01-08 17:48:09,persegiHijau,843,178,134,138,48,82,46,78,2,4,True,0.48346864473629647
2025-01-08 17:48:09,persegiHijau,853,178,130,138,40,35,39,38,1,3,True,0.34011710505487314
2025-01-08 17:48:09,persegiHijau,824,162,129,134,50,23,45,26,5,3,True,0.2595222850842831
2025-01-08 17:48:09,Hijau,824,162,tensor(129.7250),tensor(134.6166),155,76,153,75,2,1,True,0.0005004405975341797
2025-01-08 17:48:09,persegiHijau,855,171,129,134,151,57,146,59,5,2,True,0.4117835514354543
2025-01-08 17:48:09,persegiHijau,872,152,118,131,138,70,135,73,3,3,True,0.4692441929033515
2025-01-08 17:48:09,persegiHijau,847,131,118,128,123,82,118,78,5,4,True,0.2973591361487168
2025-01-08 17:48:10,persegiHijau,797,166,133,134,131,29,129,27,2,2,True,0.11196405761299277
2025-01-08 17:48:10,persegiHijau,848,173,128,130,4,15,7,15,3,0,True,0.46663392714909946
2025-01-08 17:48:10,persegiHijau,848,139,121,126,185,19,183,18,2,1,True,0.3498419663445907
2025-01-08 17:48:10,persegiHijau,846,135,119,129,70,56,73,57,3,1,True,0.2974599766598152
2025-01-08 17:48:10,Fail to pick,846,135,0,0,0,0,0,0,0,0,False,0
2025-01-08 17:48:10,persegiHijau,844,131,122,132,177,44,181,44,4,0,False,0.10598214375110629
2025-01-08 17:48:10,Fail to pick,844,131,0,0,0,0,0,0,0,0,False,0
2025-01-08 17:48:10,persegiHijau,846,179,133,137,34,89,35,85,1,4,True,0.4407004907523545
2025-01-08 17:48:10,persegiHijau,836,170,124,134,50,86,50,82,0,4,True,0.17827217743965723
2025-01-08 17:48:10,Hijau,836,170,tensor(124.6633),tensor(134.0210),152,77,148,73,4,4,True,0.0004992485046386719
2025-01-08 17:48:10,persegiHijau,848,147,114,125,62,51,62,47,0,4,True,0.30801174375027107
2025-01-08 17:48:10,persegiHijau,845,149,114,128,117,37,118,35,1,2,True,0.3317548946417906
2025-01-08 17:48:10,Fail to pick,845,149,0,0,0,0,0,0,0,0,False,0
2025-01-08 17:48:11,persegiHijau,842,148,114,128,127,44,124,43,3,1,True,0.3813785773697409
2025-01-08 17:48:11,Fail to pick,842,148,0,0,0,0,0,0,0,0,False,0
2025-01-08 17:48:11,persegiHijau,847,145,117,125,100,51,102,46,2,5,True,0.4923479679392322
2025-01-08 17:48:11,Fail to pick,847,145,0,0,0,0,0,0,0,0,False,0
2025-01-08 17:48:11,persegiHijau,860,151,115,121,38,9,39,4,1,5,True,0.38962604014622615
2025-01-08 17:48:19,persegiHijau,775,374,127,129,183,47,183,51,0,4,True,0.23685210782316415
2025-01-08 17:48:19,Hijau,775,374,tensor(127.0328),tensor(129.6792),96,71,99,72,3,1,True,0.0004968643188476562
2025-01-08 17:48:20,persegiHijau,774,290,122,128,115,72,116,70,1,2,True,0.3336562835443109
2025-01-08 17:48:20,persegiHijau,771,289,120,131,155,49,156,52,1,3,True,0.17133101948825497
2025-01-08 17:48:20,Fail to pick,771,289,0,0,0,0,0,0,0,0,False,0
2025-01-08 17:48:20,persegiHijau,776,292,116,129,67,89,64,90,3,1,False,0.4395900331303386
2025-01-08 17:48:20,Fail to pick,776,292,0,0,0,0,0,0,0,0,False,0
2025-01-08 17:48:20,persegiHijau,777,299,115,127,105,15,102,13,3,2,True,0.10102928531694717
2025-01-08 17:48:20,Fail to pick,777,299,0,0,0,0,0,0,0,0,False,0
2025-01-08 17:48:20,persegiHijau,742,340,129,134,28,29,29,26,1,3,True,0.4036614157228703
2025-01-08 17:48:20,persegiHijau,779,291,117,131,60,61,61,57,1,4,True,0.14899580132704804
2025-01-08 17:48:20,persegiHijau,773,340,127,135,159,30,161,26,2,4,True,0.4644780418132797
2025-01-08 17:48:20,persegiHijau,767,347,126,131,105,50,109,49,4,1,True,0.32372990525033535
2025-01-08 17:48:20,Fail to pick,767,347,0,0,0,0,0,0,0,0,False,0
2025-01-08 17:48:20,persegiHijau,769,298,116,122,15,23,16,24,1,1,True,0.33730474813940536
2025-01-08 17:48:20,persegiHijau,741,319,123,132,134,51,132,55,2,4,True,0.16082184079249964
2025-01-08 17:48:20,Hijau,741,319,tensor(123.5211),tensor(132.5384),111,68,115,72,4,4,True,0.0004999637603759766
2025-01-08 17:48:21,persegiHijau,784,298,118,122,150,35,149,38,1,3,True,0.48019607745286685
2025-01-08 17:48:21,persegiHijau,778,293,114,128,129,94,125,95,4,1,True,0.3116593059890569
2025-01-08 17:48:21,Fail to pick,778,293,0,0,0,0,0,0,0,0,False,0
2025-01-08 17:48:21,persegiHijau,772,296,115,124,106,61,107,61,1,0,True,0.3914793679465246
2025-01-08 17:48:21,Fail to pick,772,296,0,0,0,0,0,0,0,0,False,0
2025-01-08 17:48:21,persegiHijau,784,310,112,121,133,45,128,45,5,0,True,0.13565334097604886
2025-01-08 17:48:21,persegiHijau,775,290,115,127,36,65,31,68,5,3,True,0.2103428769294165
2025-01-08 17:48:21,persegiHijau,730,329,122,127,1,49,-2,47,3,2,True,0.14286154452327784
2025-01-08 17:48:21,persegiHijau,778,300,114,120,107,31,102,34,5,3,True,0.17483630502383235
2025-01-08 17:48:21,persegiHijau,791,339,124,122,41,4,43,8,2,4,True,0.4645661384608629
2025-01-08 17:48:21,persegiHijau,763,284,124,123,189,68,185,70,4,2,True,0.23610030451584652
2025-01-08 17:48:21,persegiHijau,763,293,117,125,115,60,114,61,1,1,False,0.16078783912708774
2025-01-08 17:48:21,Fail to pick,763,293,0,0,0,0,0,0,0,0,False,0
2025-01-08 17:48:22,persegiHijau,760,297,112,119,143,17,145,18,2,1,True,0.2961035074154258
2025-01-08 17:48:22,Hijau,760,297,tensor(112.9590),tensor(119.8916),117,70,116,72,1,2,True,0.0
2025-01-08 17:48:22,Fail to pick,760,297,0,0,0,0,0,0,0,0,False,0
2025-01-08 17:48:22,persegiHijau,765,285,120,121,17,91,15,91,2,0,True,0.4720623860002616
2025-01-08 17:48:22,persegiHijau,775,291,116,120,66,62,64,61,2,1,True,0.38535237027720415
2025-01-08 17:48:22,persegiHijau,778,302,114,117,54,65,58,68,4,3,True,0.1048881659359723
2025-01-08 17:48:22,persegiHijau,768,295,120,120,184,99,183,98,1,1,True,0.39944012520892536
2025-01-08 17:48:23,persegiHijau,738,285,113,116,176,2,174,-2,2,4,True,0.1573545680909465
2025-01-08 17:48:23,Hijau,738,285,tensor(113.7625),tensor(116.2698),120,68,119,68,1,0,True,0.0
2025-01-08 17:48:23,persegiHijau,774,299,116,121,113,0,109,3,4,3,True,0.11220500280308619
2025-01-08 17:48:23,persegiHijau,790,313,119,118,1,52,1,56,0,4,True,0.3806784904149776
2025-01-08 17:48:23,persegiHijau,776,302,116,120,13,14,13,11,0,3,False,0.4152755335663638
2025-01-08 17:48:23,persegiHijau,777,299,116,120,73,86,77,85,4,1,True,0.28574025399658215
2025-01-08 17:48:23,Fail to pick,777,299,0,0,0,0,0,0,0,0,False,0
2025-01-08 17:48:23,persegiHijau,759,300,113,116,13,93,12,94,1,1,False,0.40518672888610563
2025-01-08 17:48:23,persegiHijau,740,297,114,119,149,3,144,7,5,4,True,0.19226042135191404
2025-01-08 17:48:38,persegiHijau,779,18,102,37,181,18,180,14,1,4,True,0.28107470113392785
2025-01-08 17:48:38,Hijau,779,18,tensor(102.9408),tensor(37.4409),195,72,195,69,0,3,True,0.0
2025-01-08 17:48:39,persegiHijau,785,19,100,38,121,40,121,43,0,3,True,0.325241188761218
2025-01-08 17:48:39,Hijau,785,19,tensor(100.9676),tensor(38.6828),194,72,198,74,4,2,True,0.0
2025-01-08 17:48:39,Fail to pick,785,19,0,0,0,0,0,0,0,0,False,0
2025-01-08 17:48:39,persegiHijau,779,19,102,38,53,6,53,8,0,2,True,0.22186711846194518
2025-01-08 17:48:39,Fail to pick,779,19,0,0,0,0,0,0,0,0,False,0
2025-01-08 17:48:39,persegiHijau,783,24,106,49,93,31,94,30,1,1,True,0.23929286096803445
2025-01-08 17:48:39,Fail to pick,783,24,0,0,0,0,0,0,0,0,False,0
2025-01-08 17:48:39,persegiHijau,786,20,103,40,91,68,90,67,1,1,True,0.35490322845865474
2025-01-08 17:48:39,Fail to pick,786,20,0,0,0,0,0,0,0,0,False,0
2025-01-08 17:48:40,persegiHijau,744,14,96,28,165,56,166,58,1,2,True,0.2635458241961388
2025-01-08 17:48:40,persegiHijau,746,12,99,25,34,53,29,49,5,4,True,0.36555320469995334
2025-01-08 17:48:40,Fail to pick,746,12,0,0,0,0,0,0,0,0,False,0
2025-01-08 17:48:40,persegiHijau,797,30,110,60,112,40,111,42,1,2,True,0.39372500313779535
2025-01-08 17:48:40,persegiHijau,718,25,99,50,97,2,100,6,3,4,True,0.3894103670987027
2025-01-08 17:48:40,Hijau,718,25,tensor(99.4583),tensor(50.3403),193,66,197,61,4,5,True,0.0
2025-01-08 17:48:40,persegiHijau,787,27,109,54,101,29,103,33,2,4,True,0.283027345421454
2025-01-08 17:48:40,persegiHijau,795,21,105,43,13,48,10,43,3,5,True,0.15146258965391401
2025-01-08 17:48:40,Fail to pick,795,21,0,0,0,0,0,0,0,0,False,0
2025-01-08 17:48:41,persegiHijau,797,26,109,53,199,13,197,14,2,1,True,0.387504907664347
2025-01-08 17:48:41,Fail to pick,797,26,0,0,0,0,0,0,0,0,False,0
2025-01-08 17:48:41,persegiHijau,782,24,106,49,68,16,68,11,0,5,True,0.1253309981415797
2025-01-08 17:48:41,persegiHijau,789,24,104,49,196,12,198,11,2,1,True,0.11825866228749048
2025-01-08 17:48:41,Fail to pick,789,24,0,0,0,0,0,0,0,0,False,0
2025-01-08 17:48:41,persegiHijau,789,24,104,48,37,27,33,28,4,1,True,0.2808233746387758
2025-01-08 17:48:41,Fail to pick,789,24,0,0,0,0,0,0,0,0,False,0
2025-01-08 17:48:41,persegiHijau,783,19,102,39,119,29,120,26,1,3,True,0.21235657273157243
2025-01-08 17:48:41,Fail to pick,783,19,0,0,0,0,0,0,0,0,False,0
2025-01-08 17:48:41,persegiHijau,786,25,108,50,51,14,53,16,2,2,True,0.28083565092585633
2025-01-08 17:48:41,Hijau,786,25,tensor(108.5702),tensor(50.4251),193,72,190,69,3,3,True,0.0
2025-01-08 17:48:41,Fail to pick,786,25,0,0,0,0,0,0,0,0,False,0
2025-01-08 17:48:41,persegiHijau,793,24,110,49,30,54,28,52,2,2,True,0.14218163309114198
2025-01-08 17:48:41,Fail to pick,793,24,0,0,0,0,0,0,0,0,False,0
2025-01-08 17:48:41,persegiHijau,789,23,106,47,55,16,59,19,4,3,True,0.29110579196316233
2025-01-08 17:48:41,Fail to pick,789,23,0,0,0,0,0,0,0,0,False,0
2025-01-08 17:48:42,persegiHijau,788,23,108,47,135,51,134,48,1,3,True,0.3967270664280581
2025-01-08 17:48:42,Fail to pick,788,23,0,0,0,0,0,0,0,0,False,0
2025-01-08 17:48:42,persegiHijau,793,24,101,49,65,75,64,72,1,3,True,0.40746961739981324
2025-01-08 17:48:42,Fail to pick,793,24,0,0,0,0,0,0,0,0,False,0
2025-01-08 17:48:42,persegiHijau,789,24,105,48,53,37,52,35,1,2,True,0.22257319246151566
2025-01-08 17:48:42,Fail to pick,789,24,0,0,0,0,0,0,0,0,False,0
2025-01-08 17:48:49,persegiHijau,849,395,127,115,129,43,130,47,1,4,True,0.3106688183739559
2025-01-08 17:48:49,Hijau,849,395,tensor(127.6489),tensor(115.9357),90,78,88,79,2,1,True,0.0
2025-01-08 17:48:49,persegiHijau,842,393,130,117,54,64,54,60,0,4,True,0.18002798599177094
2025-01-08 17:48:49,Fail to pick,842,393,0,0,0,0,0,0,0,0,False,0
2025-01-08 17:48:49,persegiHijau,875,410,125,114,180,47,178,46,2,1,True,0.2608567683382792
2025-01-08 17:48:49,persegiHijau,883,416,123,111,27,97,25,95,2,2,True,0.11677454558650231
2025-01-08 17:48:49,Fail to pick,883,416,0,0,0,0,0,0,0,0,False,0
2025-01-08 17:48:49,persegiHijau,872,422,126,112,156,57,154,59,2,2,True,0.39029041824962074
2025-01-08 17:48:49,persegiHijau,863,388,117,116,192,51,187,55,5,4,True,0.2628135690760978
2025-01-08 17:48:50,persegiHijau,841,385,127,122,126,87,124,84,2,3,True,0.44837471852272415
2025-01-08 17:48:50,persegiHijau,841,385,127,122,134,67,137,63,3,4,True,0.4973739393168132
2025-01-08 17:48:50,Hijau,841,385,tensor(127.8098),tensor(122.0123),93,77,92,77,1,0,True,0.0
2025-01-08 17:48:50,Fail to pick,841,385,0,0,0,0,0,0,0,0,False,0
2025-01-08 17:48:50,persegiHijau,844,392,127,118,39,84,35,81,4,3,True,0.3843865310412501
2025-01-08 17:48:50,Fail to pick,844,392,0,0,0,0,0,0,0,0,False,0
2025-01-08 17:48:50,persegiHijau,836,388,123,117,16,94,15,93,1,1,True,0.1283213481745393
2025-01-08 17:48:50,Fail to pick,836,388,0,0,0,0,0,0,0,0,False,0
2025-01-08 17:48:50,persegiHijau,835,390,120,117,11,80,7,78,4,2,True,0.4775020674097984
2025-01-08 17:48:50,Fail to pick,835,390,0,0,0,0,0,0,0,0,False,0
2025-01-08 17:48:50,persegiHijau,860,412,120,115,179,25,181,28,2,3,False,0.15513340421308064
2025-01-08 17:48:51,persegiHijau,856,410,122,117,6,36,10,33,4,3,True,0.14288289673188104
2025-01-08 17:48:51,Fail to pick,856,410,0,0,0,0,0,0,0,0,False,0
2025-01-08 17:48:51,persegiHijau,835,388,122,118,183,22,185,26,2,4,True,0.11208542374348887
2025-01-08 17:48:51,persegiHijau,839,387,122,118,32,10,29,6,3,4,True,0.3434895524037963
2025-01-08 17:48:51,Fail to pick,839,387,0,0,0,0,0,0,0,0,False,0
2025-01-08 17:48:51,persegiHijau,837,385,124,119,62,57,60,60,2,3,True,0.12357751739371255
2025-01-08 17:48:51,Fail to pick,837,385,0,0,0,0,0,0,0,0,False,0
2025-01-08 17:48:51,persegiHijau,833,394,116,116,91,36,90,31,1,5,True,0.46290128458583435
2025-01-08 17:48:51,Fail to pick,833,394,0,0,0,0,0,0,0,0,False,0
2025-01-08 17:48:51,persegiHijau,839,393,125,118,118,40,119,38,1,2,True,0.17800640613931318
2025-01-08 17:48:51,Hijau,839,393,tensor(125.3514),tensor(118.9406),90,77,92,73,2,4,True,0.0004994869232177734
2025-01-08 17:48:51,Fail to pick,839,393,0,0,0,0,0,0,0,0,False,0
2025-01-08 17:48:51,persegiHijau,838,393,114,117,70,74,68,78,2,4,True,0.2514179481871942
2025-01-08 17:48:51,Fail to pick,838,393,0,0,0,0,0,0,0,0,False,0
2025-01-08 17:48:51,persegiHijau,843,386,126,119,14,0,12,4,2,4,True,0.3515482759538352
2025-01-08 17:48:51,Fail to pick,843,386,0,0,0,0,0,0,0,0,False,0
2025-01-08 17:48:52,persegiHijau,862,411,126,115,60,39,55,34,5,5,True,0.30223409185324623
2025-01-08 17:48:52,persegiHijau,837,383,126,120,22,3,18,2,4,1,False,0.3667943854748996
2025-01-08 17:48:52,persegiHijau,836,388,122,119,73,79,76,81,3,2,True,0.22730595201311066
2025-01-08 17:48:52,Fail to pick,836,388,0,0,0,0,0,0,0,0,False,0
2025-01-08 17:48:52,persegiHijau,840,389,123,122,94,85,94,85,0,0,True,0.3015949587200893
2025-01-08 17:48:52,Fail to pick,840,389,0,0,0,0,0,0,0,0,False,0
2025-01-08 17:48:52,persegiHijau,847,390,122,119,37,98,33,98,4,0,True,0.2147605494815665
2025-01-08 17:48:52,Fail to pick,847,390,0,0,0,0,0,0,0,0,False,0
2025-01-08 17:48:52,persegiHijau,867,411,120,115,143,4,143,1,0,3,True,0.22568845760302128
2025-01-08 17:48:52,persegiHijau,841,388,127,118,82,97,78,92,4,5,True,0.16290826184969626
2025-01-08 17:48:52,persegiHijau,841,391,122,118,92,22,88,19,4,3,True,0.44813773784315314
2025-01-08 17:48:52,Hijau,841,391,tensor(122.5560),tensor(118.6058),91,77,86,79,5,2,True,0.0
2025-01-08 17:48:52,Fail to pick,841,391,0,0,0,0,0,0,0,0,False,0
2025-01-08 17:48:52,persegiHijau,841,392,126,117,32,75,30,78,2,3,True,0.27248580567846237
2025-01-08 17:48:52,Fail to pick,841,392,0,0,0,0,0,0,0,0,False,0
2025-01-08 17:48:52,persegiHijau,833,396,119,118,164,2,159,4,5,2,False,0.46617322721978705
2025-01-08 17:48:52,Fail to pick,833,396,0,0,0,0,0,0,0,0,False,0
2025-01-08 17:48:53,persegiHijau,838,390,122,118,49,41,52,40,3,1,True,0.4104459699452704
2025-01-08 17:48:53,Fail to pick,838,390,0,0,0,0,0,0,0,0,False,0
2025-01-08 17:48:53,persegiHijau,833,396,116,116,181,0,178,-2,3,2,True,0.3786240811059526
2025-01-08 17:48:53,Fail to pick,833,396,0,0,0,0,0,0,0,0,False,0
2025-01-08 17:48:53,persegiHijau,836,395,120,117,92,34,95,35,3,1,True,0.46052765221436054
2025-01-08 17:48:53,Fail to pick,836,395,0,0,0,0,0,0,0,0,False,0
2025-01-08 17:48:53,persegiHijau,857,406,124,120,142,9,145,5,3,4,True,0.2858520855472151
2025-01-08 17:48:53,persegiHijau,867,412,121,115,73,81,77,77,4,4,True,0.48609985592906046
2025-01-08 17:48:53,persegiHijau,837,397,114,117,123,88,126,88,3,0,False,0.1674773082628787
2025-01-08 17:48:53,persegiHijau,835,395,121,119,112,65,112,60,0,5,True,0.35266074067977204
2025-01-08 17:48:53,Fail to pick,835,395,0,0,0,0,0,0,0,0,False,0
2025-01-08 17:48:53,persegiHijau,844,391,124,118,158,23,158,22,0,1,False,0.40543789566279276
2025-01-08 17:48:53,Hijau,844,391,tensor(124.4751),tensor(118.1241),91,78,91,73,0,5,True,0.0
2025-01-08 17:48:53,Fail to pick,844,391,0,0,0,0,0,0,0,0,False,0
2025-01-08 17:48:53,persegiHijau,844,401,122,118,140,84,135,81,5,3,True,0.3594079874280358
2025-01-08 17:48:54,persegiHijau,866,415,119,117,193,91,194,93,1,2,True,0.40724152230991706
2025-01-08 17:48:54,persegiHijau,844,397,122,118,145,41,144,45,1,4,True,0.4294627011753487
2025-01-08 17:48:54,persegiHijau,861,423,125,114,120,63,122,63,2,0,True,0.17032773954718022
2025-01-08 17:48:54,persegiHijau,863,411,127,115,131,51,133,53,2,2,True,0.1119497152057364
2025-01-08 17:48:54,persegiHijau,838,407,125,119,91,93,95,88,4,5,True,0.25117184857336394
2025-01-08 17:48:54,Hijau,838,407,tensor(125.8459),tensor(119.5587),86,77,85,72,1,5,True,0.0
2025-01-08 17:48:55,persegiHijau,863,415,124,114,54,77,55,78,1,1,True,0.3653919408029679
2025-01-08 17:48:55,persegiHijau,854,403,122,116,169,78,170,73,1,5,False,0.2201063842483181
2025-01-08 17:48:55,persegiHijau,868,415,125,115,182,3,180,7,2,4,True,0.2329350893672698
2025-01-08 17:48:55,persegiHijau,868,419,121,113,199,22,196,23,3,1,True,0.22488621757240512
2025-01-08 17:48:55,Fail to pick,868,419,0,0,0,0,0,0,0,0,False,0
2025-01-08 17:48:55,persegiHijau,857,400,117,120,138,23,142,27,4,4,True,0.13477768851739835
2025-01-08 17:49:12,persegiBiru,887,451,119,106,117,60,118,58,1,2,False,0.48042140909387043
2025-01-08 17:49:12,Biru,887,451,tensor(119.0366),tensor(106.6496),74,82,73,84,1,2,True,0.0004973411560058594
2025-01-08 17:49:12,persegiBiru,881,446,122,108,118,9,120,4,2,5,True,0.2518819274271674
2025-01-08 17:49:12,Fail to pick,881,446,0,0,0,0,0,0,0,0,False,0
2025-01-08 17:49:12,persegiBiru,883,444,124,109,166,6,167,6,1,0,True,0.39392425704971323
2025-01-08 17:49:12,Fail to pick,883,444,0,0,0,0,0,0,0,0,False,0
2025-01-08 17:49:12,persegiBiru,883,445,125,108,70,18,68,14,2,4,True,0.2888599032553688
2025-01-08 17:49:12,Fail to pick,883,445,0,0,0,0,0,0,0,0,False,0
2025-01-08 17:49:13,persegiBiru,914,458,121,106,116,39,116,35,0,4,True,0.16909568291314617
2025-01-08 17:49:13,Biru,914,458,tensor(121.1749),tensor(106.5436),72,84,70,85,2,1,True,0.0
2025-01-08 17:49:13,persegiBiru,899,465,123,104,111,76,111,79,0,3,True,0.19254478997919328
2025-01-08 17:49:13,persegiBiru,876,455,121,104,184,98,184,94,0,4,True,0.33756568998525976
2025-01-08 17:49:13,persegiBiru,895,466,124,102,199,88,203,92,4,4,True,0.47730700930626546
2025-01-08 17:49:13,persegiBiru,877,457,126,104,81,96,79,100,2,4,True,0.39726319908191865
2025-01-08 17:49:14,persegiBiru,917,460,122,106,176,29,179,26,3,3,True,0.10130057385913123
2025-01-08 17:49:23,persegiMerah,254,287,123,124,58,81,53,79,5,2,True,0.1690926574938425
2025-01-08 17:49:23,Merah,254,287,tensor(123.5731),tensor(124.3027),120,23,116,20,4,3,True,0.0004990100860595703
2025-01-08 17:49:23,persegiMerah,256,285,125,118,113,94,113,98,0,4,True,0.46236257340312037
2025-01-08 17:49:23,Fail to pick,256,285,0,0,0,0,0,0,0,0,False,0
2025-01-08 17:49:23,persegiMerah,237,268,120,120,138,44,142,48,4,4,True,0.3078463418798535
2025-01-08 17:49:23,persegiMerah,257,282,124,116,55,78,55,79,0,1,True,0.2970074530008543
2025-01-08 17:49:23,persegiMerah,234,268,116,113,39,30,40,26,1,4,True,0.15799284787950693
2025-01-08 17:49:23,persegiMerah,255,280,121,117,26,86,21,85,5,1,True,0.37317163830508504
2025-01-08 17:49:23,persegiMerah,237,263,116,113,145,65,140,67,5,2,True,0.18156209824964906
2025-01-08 17:49:24,persegiMerah,225,270,114,118,58,20,62,16,4,4,True,0.1663324749386833
2025-01-08 17:49:24,persegiMerah,252,278,120,117,83,80,82,81,1,1,True,0.4313815703554368
2025-01-08 17:49:24,Merah,252,278,tensor(120.0086),tensor(117.2657),122,23,122,20,0,3,True,0.0004928112030029297
2025-01-08 17:49:24,persegiMerah,249,282,120,114,50,91,50,88,0,3,True,0.1911477385147652
2025-01-08 17:49:24,Fail to pick,249,282,0,0,0,0,0,0,0,0,False,0
2025-01-08 17:49:24,persegiMerah,236,272,115,114,38,45,34,46,4,1,True,0.3071073193807312
2025-01-08 17:49:24,persegiMerah,257,283,121,118,118,29,122,26,4,3,True,0.24704357157204704
2025-01-08 17:49:24,persegiMerah,233,266,118,117,179,39,183,36,4,3,True,0.18286172154054833
2025-01-08 17:49:24,persegiMerah,234,266,114,113,20,38,20,33,0,5,True,0.3677095660397781
2025-01-08 17:49:24,Fail to pick,234,266,0,0,0,0,0,0,0,0,False,0
2025-01-08 17:49:24,persegiMerah,234,270,118,118,43,30,43,29,0,1,True,0.26460573031099865
2025-01-08 17:49:24,Fail to pick,234,270,0,0,0,0,0,0,0,0,False,0
2025-01-08 17:49:24,persegiMerah,235,265,117,117,109,36,110,31,1,5,True,0.37943305502778946
2025-01-08 17:49:24,Fail to pick,235,265,0,0,0,0,0,0,0,0,False,0
2025-01-08 17:49:25,persegiMerah,230,270,118,116,18,16,22,18,4,2,True,0.2678629207794183
2025-01-08 17:49:25,Fail to pick,230,270,0,0,0,0,0,0,0,0,False,0
2025-01-08 17:49:25,persegiMerah,235,264,117,115,149,9,146,6,3,3,True,0.1779930325914168
2025-01-08 17:49:25,Fail to pick,235,264,0,0,0,0,0,0,0,0,False,0
2025-01-08 17:49:25,persegiMerah,251,279,123,115,187,56,189,60,2,4,False,0.35647729915608395
2025-01-08 17:49:25,Merah,251,279,tensor(123.3195),tensor(115.8610),122,23,121,20,1,3,True,0.0004994869232177734
2025-01-08 17:49:25,persegiMerah,254,286,123,117,174,57,176,60,2,3,True,0.32745737901651345
2025-01-08 17:49:25,Fail to pick,254,286,0,0,0,0,0,0,0,0,False,0
2025-01-08 17:49:36,persegiMerah,216,427,115,115,35,19,32,22,3,3,True,0.34095564521853405
2025-01-08 17:49:36,Merah,216,427,tensor(115.5949),tensor(115.3482),81,20,76,20,5,0,True,0.0
2025-01-08 17:49:36,persegiMerah,221,432,121,118,102,65,102,68,0,3,True,0.308613665040408
2025-01-08 17:49:36,Fail to pick,221,432,0,0,0,0,0,0,0,0,False,0
2025-01-08 17:49:36,persegiMerah,221,431,121,120,193,46,191,50,2,4,True,0.30874105322523593
2025-01-08 17:49:36,Fail to pick,221,431,0,0,0,0,0,0,0,0,False,0
2025-01-08 17:49:36,persegiMerah,222,429,120,119,181,88,176,92,5,4,True,0.28459453756927244
2025-01-08 17:49:36,Fail to pick,222,429,0,0,0,0,0,0,0,0,False,0
2025-01-08 17:49:36,persegiMerah,224,430,121,117,29,5,31,4,2,1,True,0.30706834031028796
2025-01-08 17:49:36,Fail to pick,224,430,0,0,0,0,0,0,0,0,False,0
2025-01-08 17:49:36,persegiMerah,216,433,119,119,157,94,158,89,1,5,True,0.2951662711943755
2025-01-08 17:49:36,Fail to pick,216,433,0,0,0,0,0,0,0,0,False,0
2025-01-08 17:49:37,persegiMerah,215,433,119,119,119,15,122,16,3,1,True,0.26214038303796083
2025-01-08 17:49:37,Fail to pick,215,433,0,0,0,0,0,0,0,0,False,0
2025-01-08 17:49:37,persegiMerah,231,429,128,113,101,16,99,13,2,3,True,0.19971772108767658
2025-01-08 17:49:37,persegiMerah,218,434,122,117,156,35,156,33,0,2,True,0.4898064138627817
2025-01-08 17:49:37,persegiMerah,225,431,124,117,166,13,163,17,3,4,True,0.33636654147754674
2025-01-08 17:49:37,Merah,225,431,tensor(124.3091),tensor(117.1638),80,20,76,21,4,1,True,0.0
2025-01-08 17:49:37,Fail to pick,225,431,0,0,0,0,0,0,0,0,False,0
2025-01-08 17:49:37,persegiMerah,215,436,121,116,3,54,5,50,2,4,True,0.21656789618192845
2025-01-08 17:49:37,persegiMerah,213,434,118,117,4,13,7,9,3,4,True,0.4145913862537104
2025-01-08 17:49:37,Fail to pick,213,434,0,0,0,0,0,0,0,0,False,0
2025-01-08 17:49:37,persegiMerah,219,431,118,117,74,96,69,94,5,2,True,0.40186399943088047
2025-01-08 17:49:37,Fail to pick,219,431,0,0,0,0,0,0,0,0,False,0
2025-01-08 17:49:37,persegiMerah,221,435,119,115,66,4,64,1,2,3,False,0.16432571843314409
2025-01-08 17:49:37,Fail to pick,221,435,0,0,0,0,0,0,0,0,False,0
2025-01-08 17:49:37,persegiMerah,219,434,121,118,164,35,166,35,2,0,True,0.2751740989380217
2025-01-08 17:49:37,Fail to pick,219,434,0,0,0,0,0,0,0,0,False,0
2025-01-08 17:49:37,persegiMerah,212,434,118,115,19,78,22,80,3,2,True,0.2267014332863882
2025-01-08 17:49:37,Fail to pick,212,434,0,0,0,0,0,0,0,0,False,0
2025-01-08 17:49:38,persegiMerah,222,431,123,115,92,89,94,91,2,2,True,0.2681102424046458
2025-01-08 17:49:38,persegiMerah,221,433,123,117,113,54,116,49,3,5,True,0.2348536842042731
2025-01-08 17:49:38,Fail to pick,221,433,0,0,0,0,0,0,0,0,False,0
2025-01-08 17:49:42,persegiMerah,294,432,126,119,17,28,19,23,2,5,False,0.17468675082058352
2025-01-08 17:49:42,Merah,294,432,tensor(126.9078),tensor(119.0872),80,27,78,31,2,4,True,0.0
2025-01-08 17:49:43,persegiMerah,316,449,133,118,130,30,126,34,4,4,True,0.18240977000134073
2025-01-08 17:49:43,persegiMerah,288,434,129,117,164,77,168,80,4,3,True,0.33785020863171683
2025-01-08 17:49:45,persegiMerah,242,230,117,116,115,65,115,67,0,2,True,0.2725381821675894
2025-01-08 17:49:45,Merah,242,230,tensor(117.9832),tensor(116.3668),136,22,138,23,2,1,True,0.0
2025-01-08 17:49:45,persegiMerah,238,223,117,114,35,55,32,57,3,2,True,0.21618032473277002
2025-01-08 17:49:45,Fail to pick,238,223,0,0,0,0,0,0,0,0,False,0
2025-01-08 17:49:45,persegiMerah,237,223,115,114,30,20,31,20,1,0,True,0.49131430634314266
2025-01-08 17:49:45,Fail to pick,237,223,0,0,0,0,0,0,0,0,False,0
2025-01-08 17:49:46,persegiMerah,238,222,116,114,42,31,46,26,4,5,True,0.15068716683490188
2025-01-08 17:49:46,Fail to pick,238,222,0,0,0,0,0,0,0,0,False,0
2025-01-08 17:49:46,persegiMerah,238,224,117,113,110,76,110,79,0,3,True,0.24309204718152305
2025-01-08 17:49:46,Fail to pick,238,224,0,0,0,0,0,0,0,0,False,0
2025-01-08 17:49:46,persegiMerah,230,221,115,114,12,76,14,80,2,4,True,0.2518646768061038
2025-01-08 17:49:46,Merah,230,221,tensor(115.0716),tensor(114.5524),138,21,137,19,1,2,True,0.0
2025-01-08 17:49:46,Fail to pick,230,221,0,0,0,0,0,0,0,0,False,0
2025-01-08 17:49:46,persegiMerah,229,223,114,113,44,15,46,19,2,4,True,0.4097891652486553
2025-01-08 17:49:46,Fail to pick,229,223,0,0,0,0,0,0,0,0,False,0
2025-01-08 17:49:47,persegiBiru,255,244,119,115,197,11,201,13,4,2,True,0.3455710092896787
2025-01-08 17:49:47,persegiMerah,256,244,121,116,165,91,164,87,1,4,True,0.27530230522848664
2025-01-08 17:49:47,Fail to pick,256,244,0,0,0,0,0,0,0,0,False,0
2025-01-08 17:49:47,persegiMerah,258,240,122,115,91,38,90,37,1,1,True,0.18526921708859626
2025-01-08 17:49:47,Merah,258,240,tensor(122.7601),tensor(115.5635),133,23,133,21,0,2,True,0.0
2025-01-08 17:49:47,Fail to pick,258,240,0,0,0,0,0,0,0,0,False,0
2025-01-08 17:49:48,persegiMerah,229,221,113,115,104,53,100,53,4,0,True,0.2244663739579461
2025-01-08 17:49:53,persegiMerah,243,223,117,119,161,42,156,43,5,1,True,0.2649618309273758
2025-01-08 17:49:53,Merah,243,223,tensor(117.6951),tensor(119.4001),138,22,134,21,4,1,True,0.0
2025-01-08 17:49:53,persegiMerah,239,222,116,116,85,11,84,13,1,2,True,0.4327945165445414
2025-01-08 17:49:53,Fail to pick,239,222,0,0,0,0,0,0,0,0,False,0
2025-01-08 17:49:53,persegiMerah,248,225,119,117,178,64,181,64,3,0,True,0.28002668806923203
2025-01-08 17:49:53,Fail to pick,248,225,0,0,0,0,0,0,0,0,False,0
2025-01-08 17:49:54,persegiMerah,239,221,118,116,67,44,71,44,4,0,True,0.45767389586736384
2025-01-08 17:49:54,Fail to pick,239,221,0,0,0,0,0,0,0,0,False,0
2025-01-08 17:49:54,persegiMerah,244,224,118,117,17,42,18,40,1,2,True,0.25969807194545
2025-01-08 17:49:54,Fail to pick,244,224,0,0,0,0,0,0,0,0,False,0
2025-01-08 17:49:54,persegiMerah,240,223,117,119,11,27,10,31,1,4,True,0.1636237612767062
2025-01-08 17:49:54,Fail to pick,240,223,0,0,0,0,0,0,0,0,False,0
2025-01-08 17:49:54,persegiMerah,239,221,115,120,60,57,56,52,4,5,True,0.38341505431884626
2025-01-08 17:49:54,Merah,239,221,tensor(115.9051),tensor(120.0950),138,22,136,20,2,2,True,0.0
2025-01-08 17:49:54,Fail to pick,239,221,0,0,0,0,0,0,0,0,False,0
2025-01-08 17:49:54,persegiMerah,240,224,115,116,87,86,91,90,4,4,True,0.4449067516034193
2025-01-08 17:49:54,Fail to pick,240,224,0,0,0,0,0,0,0,0,False,0
2025-01-08 17:49:55,persegiMerah,237,224,116,117,124,92,121,88,3,4,True,0.14916386929574688
2025-01-08 17:49:55,Fail to pick,237,224,0,0,0,0,0,0,0,0,False,0
2025-01-08 17:49:55,persegiMerah,242,221,119,117,134,80,138,80,4,0,True,0.15342366832149357
2025-01-08 17:49:55,Fail to pick,242,221,0,0,0,0,0,0,0,0,False,0
2025-01-08 17:49:55,persegiMerah,242,222,116,117,185,40,181,42,4,2,True,0.4358698390490118
2025-01-08 17:49:55,Fail to pick,242,222,0,0,0,0,0,0,0,0,False,0
2025-01-08 17:49:55,persegiMerah,241,224,120,120,112,69,116,69,4,0,True,0.14352609708998532
2025-01-08 17:49:55,Fail to pick,241,224,0,0,0,0,0,0,0,0,False,0
2025-01-08 17:49:55,persegiMerah,234,220,117,118,13,75,15,77,2,2,True,0.4349726009624272
2025-01-08 17:49:55,Fail to pick,234,220,0,0,0,0,0,0,0,0,False,0
2025-01-08 17:49:55,persegiMerah,256,240,124,122,48,44,44,43,4,1,True,0.40493622999287204
2025-01-08 17:49:55,Merah,256,240,tensor(124.4099),tensor(122.2806),133,23,132,26,1,3,True,0.0004966259002685547
2025-01-08 17:49:55,persegiMerah,242,223,119,117,21,7,19,8,2,1,False,0.33528089927772786
2025-01-08 17:49:56,persegiMerah,237,224,117,115,185,49,182,52,3,3,True,0.13262708755319916
2025-01-08 17:49:56,Fail to pick,237,224,0,0,0,0,0,0,0,0,False,0
2025-01-08 17:49:56,persegiMerah,230,223,118,116,131,7,128,5,3,2,True,0.11078081766779527
2025-01-08 17:49:56,Fail to pick,230,223,0,0,0,0,0,0,0,0,False,0
2025-01-08 17:49:56,persegiMerah,236,224,120,119,66,54,70,55,4,1,False,0.46642917491318325
2025-01-08 17:49:56,Fail to pick,236,224,0,0,0,0,0,0,0,0,False,0
2025-01-08 17:49:56,persegiMerah,238,224,118,116,176,43,174,42,2,1,False,0.18977952950603819
2025-01-08 17:49:56,Fail to pick,238,224,0,0,0,0,0,0,0,0,False,0
2025-01-08 17:49:56,persegiMerah,239,220,118,116,112,89,110,85,2,4,True,0.3790920309758594
2025-01-08 17:49:56,Fail to pick,239,220,0,0,0,0,0,0,0,0,False,0
2025-01-08 17:49:56,persegiMerah,243,223,119,117,116,79,117,83,1,4,True,0.2552537545838094
2025-01-08 17:49:56,Fail to pick,243,223,0,0,0,0,0,0,0,0,False,0
2025-01-08 17:49:56,persegiMerah,239,221,117,117,88,56,89,56,1,0,True,0.3139752341010985
2025-01-08 17:49:56,Merah,239,221,tensor(117.9208),tensor(117.9940),138,22,138,24,0,2,True,0.0
2025-01-08 17:49:56,Fail to pick,239,221,0,0,0,0,0,0,0,0,False,0
2025-01-08 17:49:57,persegiMerah,243,226,121,116,127,9,131,7,4,2,True,0.20344545583369725
2025-01-08 17:49:57,Fail to pick,243,226,0,0,0,0,0,0,0,0,False,0
2025-01-08 17:49:57,persegiMerah,243,226,119,119,120,94,123,97,3,3,True,0.17304246777361493
2025-01-08 17:49:57,Fail to pick,243,226,0,0,0,0,0,0,0,0,False,0
2025-01-08 17:49:57,persegiMerah,237,222,118,117,125,25,121,26,4,1,True,0.43869443176785594
2025-01-08 17:49:57,Fail to pick,237,222,0,0,0,0,0,0,0,0,False,0
2025-01-08 17:49:57,persegiMerah,241,226,119,120,127,63,126,60,1,3,True,0.31793620716941257
2025-01-08 17:49:57,Fail to pick,241,226,0,0,0,0,0,0,0,0,False,0
2025-01-08 17:49:57,persegiMerah,240,230,121,120,69,78,70,74,1,4,True,0.2936356637185742
2025-01-08 17:49:57,Merah,240,230,tensor(121.4977),tensor(120.7733),136,22,134,24,2,2,True,0.0004992485046386719
2025-01-08 17:49:57,Fail to pick,240,230,0,0,0,0,0,0,0,0,False,0
2025-01-08 17:49:58,persegiMerah,245,232,120,118,23,86,26,89,3,3,True,0.2630996689884505
2025-01-08 17:49:58,Fail to pick,245,232,0,0,0,0,0,0,0,0,False,0
2025-01-08 17:49:58,persegiMerah,238,222,117,117,142,38,145,39,3,1,True,0.21610657949086784
2025-01-08 17:49:58,persegiMerah,240,223,115,116,162,82,161,84,1,2,True,0.1512479063404174
2025-01-08 17:49:58,Fail to pick,240,223,0,0,0,0,0,0,0,0,False,0
2025-01-08 17:49:58,persegiMerah,240,221,116,117,149,53,145,48,4,5,True,0.27163631056892756
2025-01-08 17:49:58,Fail to pick,240,221,0,0,0,0,0,0,0,0,False,0
2025-01-08 17:49:58,persegiMerah,238,220,117,118,29,77,27,74,2,3,True,0.39178680881615413
2025-01-08 17:49:58,Fail to pick,238,220,0,0,0,0,0,0,0,0,False,0
2025-01-08 17:49:58,persegiMerah,240,221,117,118,172,28,168,30,4,2,True,0.23810017252691656
2025-01-08 17:49:58,Fail to pick,240,221,0,0,0,0,0,0,0,0,False,0
2025-01-08 17:49:58,persegiMerah,236,222,116,116,8,43,3,44,5,1,True,0.20833985000976438
2025-01-08 17:49:58,Fail to pick,236,222,0,0,0,0,0,0,0,0,False,0
2025-01-08 17:49:58,persegiMerah,241,220,118,117,73,76,74,74,1,2,True,0.3208207214029246
2025-01-08 17:49:58,Fail to pick,241,220,0,0,0,0,0,0,0,0,False,0
2025-01-08 17:49:59,persegiMerah,240,222,116,116,99,55,94,52,5,3,True,0.37569218683431727
2025-01-08 17:49:59,Merah,240,222,tensor(116.4441),tensor(116.4202),138,22,134,19,4,3,True,0.0004987716674804688
2025-01-08 17:49:59,Fail to pick,240,222,0,0,0,0,0,0,0,0,False,0
2025-01-08 17:49:59,persegiMerah,239,222,116,117,126,44,129,48,3,4,True,0.35501211353699513
2025-01-08 17:49:59,Fail to pick,239,222,0,0,0,0,0,0,0,0,False,0
2025-01-08 17:49:59,persegiMerah,241,222,116,117,151,61,150,59,1,2,True,0.33509156184411304
2025-01-08 17:49:59,Fail to pick,241,222,0,0,0,0,0,0,0,0,False,0
2025-01-08 17:49:59,persegiMerah,239,223,116,118,144,37,144,35,0,2,True,0.46596628531129247
2025-01-08 17:49:59,Fail to pick,239,223,0,0,0,0,0,0,0,0,False,0
2025-01-08 17:49:59,persegiMerah,243,224,120,116,17,83,12,85,5,2,True,0.43585288914517084
2025-01-08 17:49:59,Fail to pick,243,224,0,0,0,0,0,0,0,0,False,0
2025-01-08 17:49:59,persegiMerah,236,223,119,117,13,75,17,76,4,1,True,0.11786552584153043
2025-01-08 17:49:59,Fail to pick,236,223,0,0,0,0,0,0,0,0,False,0
2025-01-08 17:49:59,persegiMerah,239,224,121,118,89,47,92,48,3,1,True,0.4069498154484724
2025-01-08 17:49:59,Fail to pick,239,224,0,0,0,0,0,0,0,0,False,0
2025-01-08 17:50:10,persegiMerah,510,222,122,115,106,16,103,19,3,3,True,0.2625545308182036
2025-01-08 17:50:10,Merah,510,222,tensor(122.7180),tensor(115.5591),138,47,142,51,4,4,True,0.0004994869232177734
2025-01-08 17:50:10,persegiMerah,508,224,121,119,164,71,159,70,5,1,True,0.1100353194295837
2025-01-08 17:50:10,Fail to pick,508,224,0,0,0,0,0,0,0,0,False,0
2025-01-08 17:50:23,persegiBiru,513,391,120,115,183,5,180,9,3,4,True,0.21548395869839526
2025-01-08 17:50:23,Biru,513,391,tensor(120.2336),tensor(115.7226),91,47,88,46,3,1,True,0.0
2025-01-08 17:50:23,persegiBiru,508,383,118,115,101,50,99,53,2,3,True,0.2636307212424791
2025-01-08 17:50:23,Fail to pick,508,383,0,0,0,0,0,0,0,0,False,0
2025-01-08 17:50:23,persegiBiru,512,383,120,115,95,82,92,78,3,4,True,0.11501977113975387
2025-01-08 17:50:23,Fail to pick,512,383,0,0,0,0,0,0,0,0,False,0
2025-01-08 17:50:23,persegiBiru,509,387,116,114,129,69,125,65,4,4,False,0.4778353823466618
2025-01-08 17:50:23,Fail to pick,509,387,0,0,0,0,0,0,0,0,False,0
2025-01-08 17:50:23,persegiBiru,510,386,121,115,142,65,140,62,2,3,True,0.12520685367742135
2025-01-08 17:50:23,Fail to pick,510,386,0,0,0,0,0,0,0,0,False,0
2025-01-08 17:50:23,persegiBiru,511,387,119,116,82,89,79,90,3,1,True,0.4443599966368571
2025-01-08 17:50:23,Fail to pick,511,387,0,0,0,0,0,0,0,0,False,0
2025-01-08 17:50:24,persegiBiru,519,388,126,115,168,88,172,90,4,2,True,0.2758634712879764
2025-01-08 17:50:24,Fail to pick,519,388,0,0,0,0,0,0,0,0,False,0
2025-01-08 17:50:24,persegiBiru,516,389,123,115,21,72,18,67,3,5,True,0.4701671583375352
2025-01-08 17:50:24,Fail to pick,516,389,0,0,0,0,0,0,0,0,False,0
2025-01-08 17:50:24,persegiBiru,511,383,120,115,57,8,57,7,0,1,True,0.28534832178532726
2025-01-08 17:50:24,Fail to pick,511,383,0,0,0,0,0,0,0,0,False,0
2025-01-08 17:50:24,persegiBiru,515,385,126,113,180,0,182,-5,2,5,True,0.4930735777201841
2025-01-08 17:50:24,Biru,515,385,tensor(126.5393),tensor(113.3599),93,47,94,44,1,3,True,0.0
2025-01-08 17:50:24,Fail to pick,515,385,0,0,0,0,0,0,0,0,False,0
2025-01-08 17:50:24,persegiBiru,504,386,124,118,86,52,90,54,4,2,False,0.21985083961438692
2025-01-08 17:50:24,persegiBiru,513,388,122,115,142,85,141,82,1,3,True,0.33049177096025095
2025-01-08 17:50:24,Fail to pick,513,388,0,0,0,0,0,0,0,0,False,0
2025-01-08 17:50:24,persegiBiru,513,384,121,113,73,64,76,65,3,1,True,0.4708736778290804
2025-01-08 17:50:24,Fail to pick,513,384,0,0,0,0,0,0,0,0,False,0
2025-01-08 17:50:24,persegiBiru,508,387,119,117,21,96,19,92,2,4,True,0.2456099702040965
2025-01-08 17:50:24,Fail to pick,508,387,0,0,0,0,0,0,0,0,False,0
2025-01-08 17:50:24,persegiBiru,547,415,123,110,183,42,182,45,1,3,True,0.44243659232026045
2025-01-08 17:50:25,persegiBiru,503,386,124,117,11,68,8,72,3,4,True,0.35474808925805446
2025-01-08 17:50:25,persegiBiru,504,386,126,118,63,96,61,99,2,3,True,0.4691110560031877
2025-01-08 17:50:25,Fail to pick,504,386,0,0,0,0,0,0,0,0,False,0
2025-01-08 17:50:25,persegiBiru,508,388,119,116,137,66,141,70,4,4,True,0.3499737075319934
2025-01-08 17:50:25,Fail to pick,508,388,0,0,0,0,0,0,0,0,False,0
2025-01-08 17:50:25,persegiBiru,510,388,118,116,162,76,159,73,3,3,True,0.3557114331022747
2025-01-08 17:50:25,Biru,510,388,tensor(118.8851),tensor(116.9550),92,47,94,49,2,2,True,0.0
2025-01-08 17:50:25,Fail to pick,510,388,0,0,0,0,0,0,0,0,False,0
2025-01-08 17:50:32,persegiBiru,520,552,123,102,53,37,50,39,3,2,False,0.11907186744627302
2025-01-08 17:50:32,Biru,520,552,tensor(123.3806),tensor(102.4886),46,48,50,44,4,4,True,0.0
2025-01-08 17:50:32,persegiBiru,527,561,121,97,25,91,29,94,4,3,True,0.3496194874318944
2025-01-08 17:50:32,Fail to pick,527,561,0,0,0,0,0,0,0,0,False,0
2025-01-08 17:50:32,persegiBiru,524,547,126,102,153,33,152,37,1,4,False,0.40698587641826267
2025-01-08 17:50:32,persegiBiru,518,559,123,101,175,76,171,75,4,1,True,0.4644444147743578
2025-01-08 17:50:33,persegiBiru,489,537,117,107,143,9,146,10,3,1,True,0.4857327811387545
2025-01-08 17:50:33,persegiBiru,542,558,120,98,150,74,145,78,5,4,True,0.3446332265824508
2025-01-08 17:50:33,persegiBiru,490,533,117,105,35,1,31,0,4,1,True,0.1062546046221097
2025-01-08 17:50:33,persegiBiru,490,533,117,105,80,2,78,5,2,3,True,0.243086817538805
2025-01-08 17:50:33,Fail to pick,490,533,0,0,0,0,0,0,0,0,False,0
2025-01-08 17:50:33,persegiBiru,488,536,121,108,154,60,155,56,1,4,True,0.383703245619861
2025-01-08 17:50:33,Fail to pick,488,536,0,0,0,0,0,0,0,0,False,0
2025-01-08 17:50:33,persegiBiru,529,561,118,97,16,89,12,91,4,2,True,0.37539265483352535
2025-01-08 17:50:33,persegiBiru,490,533,116,105,30,50,28,45,2,5,True,0.20254955156447593
2025-01-08 17:50:33,persegiBiru,486,534,122,105,160,48,162,47,2,1,True,0.23418355316375578
2025-01-08 17:50:33,Biru,486,534,tensor(122.5320),tensor(105.4963),51,45,53,41,2,4,True,0.0
2025-01-08 17:50:33,Fail to pick,486,534,0,0,0,0,0,0,0,0,False,0
2025-01-08 17:50:33,persegiBiru,486,538,119,106,125,10,124,8,1,2,True,0.37900235352716183
2025-01-08 17:50:33,Fail to pick,486,538,0,0,0,0,0,0,0,0,False,0
2025-01-08 17:50:34,persegiBiru,530,559,120,99,44,52,44,54,0,2,True,0.189330673137464
2025-01-08 17:50:34,persegiBiru,526,561,120,98,33,0,28,-4,5,4,True,0.20994698199678213
2025-01-08 17:50:34,Fail to pick,526,561,0,0,0,0,0,0,0,0,False,0
2025-01-08 17:50:34,persegiBiru,492,532,121,104,153,61,157,63,4,2,True,0.46832630822159127
2025-01-08 17:50:34,persegiBiru,498,530,116,103,13,21,13,22,0,1,True,0.3290865502268545
2025-01-08 17:50:34,Fail to pick,498,530,0,0,0,0,0,0,0,0,False,0
2025-01-08 17:50:34,persegiBiru,537,556,120,98,76,66,73,64,3,2,True,0.4601576244942217
2025-01-08 17:50:34,persegiBiru,531,558,118,98,146,2,143,-1,3,3,True,0.2798333595443319
2025-01-08 17:50:34,Fail to pick,531,558,0,0,0,0,0,0,0,0,False,0
2025-01-08 17:50:34,persegiBiru,516,553,120,104,194,66,193,64,1,2,True,0.3886058384976513
2025-01-08 17:50:34,Biru,516,553,tensor(120.9760),tensor(104.2600),46,47,47,50,1,3,True,0.0004992485046386719
2025-01-08 17:50:34,persegiBiru,492,535,123,108,192,42,188,41,4,1,True,0.3571661343938243
2025-01-08 17:50:35,persegiBiru,503,532,115,106,60,16,60,14,0,2,True,0.1267961072356429
2025-01-08 17:50:35,persegiBiru,493,531,119,108,168,91,166,87,2,4,True,0.126286223001028
2025-01-08 17:50:35,persegiBiru,496,540,119,111,26,22,21,25,5,3,True,0.41448555190348435
2025-01-08 17:50:35,Fail to pick,496,540,0,0,0,0,0,0,0,0,False,0
2025-01-08 17:50:35,persegiBiru,497,534,121,110,128,91,125,88,3,3,True,0.37321102266983563
2025-01-08 17:50:35,Fail to pick,497,534,0,0,0,0,0,0,0,0,False,0
2025-01-08 17:50:35,persegiBiru,498,538,123,113,171,24,168,27,3,3,True,0.45882962843388286
2025-01-08 17:50:35,Fail to pick,498,538,0,0,0,0,0,0,0,0,False,0
2025-01-08 17:50:35,persegiBiru,493,538,121,112,151,0,155,2,4,2,True,0.4172051542290277
2025-01-08 17:50:35,Fail to pick,493,538,0,0,0,0,0,0,0,0,False,0
2025-01-08 17:50:36,persegiBiru,534,547,118,106,161,63,165,67,4,4,True,0.3785188428559694
2025-01-08 17:50:36,Biru,534,547,tensor(118.4838),tensor(106.5066),48,49,43,51,5,2,True,0.0
2025-01-08 17:50:36,persegiBiru,501,536,121,111,113,68,111,68,2,0,True,0.42770115472970194
2025-01-08 17:50:36,persegiBiru,501,536,121,111,58,9,59,10,1,1,True,0.22719292685753756
2025-01-08 17:50:36,Fail to pick,501,536,0,0,0,0,0,0,0,0,False,0
2025-01-08 17:50:44,persegiMerah,775,494,138,133,126,93,121,94,5,1,False,0.12707996218622994
2025-01-08 17:50:44,Merah,775,494,tensor(138.3049),tensor(133.7973),62,71,61,75,1,4,True,0.0
2025-01-08 17:50:44,persegiMerah,772,493,145,134,164,78,160,80,4,2,True,0.19231623880639878
2025-01-08 17:50:44,Fail to pick,772,493,0,0,0,0,0,0,0,0,False,0
2025-01-08 17:50:44,persegiMerah,775,491,139,136,109,31,110,33,1,2,True,0.12648447080054326
2025-01-08 17:50:44,Fail to pick,775,491,0,0,0,0,0,0,0,0,False,0
2025-01-08 17:50:45,persegiMerah,782,491,151,133,81,14,80,15,1,1,True,0.31338040855402993
2025-01-08 17:50:45,Merah,782,491,tensor(151.0922),tensor(133.7847),63,72,64,73,1,1,True,0.0
2025-01-08 17:50:45,Fail to pick,782,491,0,0,0,0,0,0,0,0,False,0
2025-01-08 17:50:45,persegiMerah,757,487,145,132,128,59,124,59,4,0,True,0.1117672592919107
2025-01-08 17:50:53,persegiMerah,843,469,163,142,31,43,27,43,4,0,True,0.45499610230742815
2025-01-08 17:50:53,Merah,843,469,tensor(163.0629),tensor(142.4413),69,78,73,76,4,2,True,0.0
2025-01-08 17:50:53,persegiMerah,840,458,170,141,78,59,78,59,0,0,True,0.30174648309287644
2025-01-08 17:50:53,persegiMerah,872,463,157,136,20,74,21,71,1,3,True,0.1809798706157062
2025-01-08 17:50:58,persegiMerah,706,327,149,135,178,54,174,53,4,1,True,0.3225438592759352
2025-01-08 17:50:58,Merah,706,327,tensor(149.0852),tensor(135.7617),109,65,111,69,2,4,True,0.0
2025-01-08 17:51:04,persegiKuning,698,329,117,112,23,0,19,0,4,0,True,0.372185456051608
2025-01-08 17:51:04,Kuning,698,329,tensor(117.9764),tensor(112.6107),108,64,109,67,1,3,True,0.0
2025-01-08 17:51:04,Fail to pick,698,329,0,0,0,0,0,0,0,0,False,0
2025-01-08 17:51:04,persegiKuning,666,329,112,109,196,64,198,63,2,1,True,0.36446889248192194
2025-01-08 17:51:05,persegiKuning,697,350,119,111,98,81,100,81,2,0,True,0.3070962515996405
2025-01-08 17:51:06,persegiBiru,659,325,117,116,93,62,97,57,4,5,True,0.4039469956842515
2025-01-08 17:51:07,persegiBiru,663,324,118,115,165,64,161,62,4,2,True,0.16278691741363338
2025-01-08 17:51:07,Biru,663,324,tensor(118.7763),tensor(115.7983),110,61,110,56,0,5,True,0.0
2025-01-08 17:51:07,Fail to pick,663,324,0,0,0,0,0,0,0,0,False,0
2025-01-08 17:51:08,persegiBiru,670,332,116,115,103,77,100,81,3,4,True,0.11707672864571635
2025-01-08 17:51:08,Biru,670,332,tensor(116.3600),tensor(115.2792),107,62,108,60,1,2,True,0.0
2025-01-08 17:51:08,Fail to pick,670,332,0,0,0,0,0,0,0,0,False,0
2025-01-08 17:51:08,persegiBiru,657,325,117,114,87,30,84,29,3,1,True,0.3065998640422396
2025-01-08 17:51:09,persegiBiru,658,329,119,117,179,68,182,70,3,2,True,0.2968536514239377
2025-01-08 17:51:09,Fail to pick,658,329,0,0,0,0,0,0,0,0,False,0
2025-01-08 17:51:10,persegiKuning,688,347,119,109,0,65,2,68,2,3,True,0.2292514805637564
2025-01-08 17:51:10,Kuning,688,347,tensor(119.9009),tensor(109.7333),103,63,101,59,2,4,True,0.0
2025-01-08 17:51:10,persegiBiru,704,352,117,110,75,34,74,31,1,3,True,0.42904091088301954
2025-01-08 17:51:10,persegiKuning,696,351,120,113,48,57,47,54,1,3,True,0.41748019765683375
2025-01-08 17:51:10,Fail to pick,696,351,0,0,0,0,0,0,0,0,False,0
2025-01-08 17:51:11,persegiKuning,698,308,119,122,194,28,189,24,5,4,False,0.29988785380775035
2025-01-08 17:51:18,persegiKuning,688,355,121,112,120,90,123,92,3,2,True,0.3825757094252179
2025-01-08 17:51:18,Kuning,688,355,tensor(121.2765),tensor(112.8553),101,63,100,64,1,1,True,0.0004930496215820312
2025-01-08 17:51:18,persegiKuning,706,355,119,109,0,44,2,45,2,1,True,0.18147117584431413
2025-01-08 17:51:18,persegiBiru,699,353,120,111,85,2,87,1,2,1,True,0.10735670762895073
2025-01-08 17:51:18,Fail to pick,699,353,0,0,0,0,0,0,0,0,False,0
2025-01-08 17:51:19,persegiBiru,703,357,121,111,142,58,144,60,2,2,True,0.1729051777150421
2025-01-08 17:51:19,Fail to pick,703,357,0,0,0,0,0,0,0,0,False,0
2025-01-08 17:51:20,persegiBiru,697,301,118,127,94,31,90,30,4,1,True,0.29805196075290596
2025-01-08 17:51:20,Biru,697,301,tensor(118.0883),tensor(127.5640),116,64,120,59,4,5,True,0.0
2025-01-08 17:51:21,persegiMerah,693,279,128,131,41,45,45,48,4,3,True,0.13537732338215913
2025-01-08 17:51:21,persegiMerah,682,279,119,127,32,41,36,39,4,2,True,0.3213686806295564
2025-01-08 17:51:21,persegiMerah,682,274,127,134,194,7,192,2,2,5,True,0.320167536970156
2025-01-08 17:51:21,Fail to pick,682,274,0,0,0,0,0,0,0,0,False,0
2025-01-08 17:51:21,persegiMerah,677,278,130,134,74,70,75,72,1,2,True,0.4978622013994084
2025-01-08 17:51:21,Fail to pick,677,278,0,0,0,0,0,0,0,0,False,0
2025-01-08 17:51:21,persegiMerah,693,270,129,133,42,62,42,58,0,4,True,0.21200111539175284
2025-01-08 17:51:21,Merah,693,270,tensor(129.4318),tensor(133.7169),125,64,123,63,2,1,True,0.0
2025-01-08 17:51:21,persegiMerah,698,278,129,128,119,16,122,13,3,3,True,0.17168958637503612
2025-01-08 17:51:21,Fail to pick,698,278,0,0,0,0,0,0,0,0,False,0
2025-01-08 17:51:21,persegiMerah,696,283,123,129,110,53,113,52,3,1,True,0.4839506917770563
2025-01-08 17:51:21,Fail to pick,696,283,0,0,0,0,0,0,0,0,False,0
2025-01-08 17:51:22,persegiMerah,689,281,127,131,62,33,60,31,2,2,True,0.2877411912375394
2025-01-08 17:51:22,Fail to pick,689,281,0,0,0,0,0,0,0,0,False,0
2025-01-08 17:51:22,persegiMerah,692,278,129,130,141,22,144,24,3,2,True,0.2331361904427307
2025-01-08 17:51:22,Fail to pick,692,278,0,0,0,0,0,0,0,0,False,0
2025-01-08 17:51:22,persegiMerah,694,281,126,133,157,40,159,43,2,3,True,0.2753323254540785
2025-01-08 17:51:22,Fail to pick,694,281,0,0,0,0,0,0,0,0,False,0
2025-01-08 17:51:22,persegiMerah,697,282,127,133,91,37,90,34,1,3,True,0.33548344164365856
2025-01-08 17:51:22,Merah,697,282,tensor(127.4957),tensor(133.0036),121,64,120,64,1,0,True,0.0
2025-01-08 17:51:22,Fail to pick,697,282,0,0,0,0,0,0,0,0,False,0
2025-01-08 17:51:22,persegiMerah,691,278,127,130,141,95,139,96,2,1,False,0.21644632127454663
2025-01-08 17:51:22,Fail to pick,691,278,0,0,0,0,0,0,0,0,False,0
2025-01-08 17:51:23,persegiMerah,691,276,128,128,187,34,189,32,2,2,True,0.3758443896344238
2025-01-08 17:51:23,Fail to pick,691,276,0,0,0,0,0,0,0,0,False,0
2025-01-08 17:51:23,persegiMerah,700,287,124,129,156,28,152,31,4,3,True,0.4106782379394708
2025-01-08 17:51:23,persegiMerah,709,292,131,132,170,59,171,60,1,1,True,0.32681679318664425
2025-01-08 17:51:23,Merah,709,292,tensor(131.4926),tensor(132.2612),118,65,114,66,4,1,True,0.0
2025-01-08 17:51:23,Fail to pick,709,292,0,0,0,0,0,0,0,0,False,0
2025-01-08 17:51:24,persegiMerah,696,279,128,132,184,0,182,0,2,0,True,0.3248413468026415
2025-01-08 17:51:24,persegiMerah,699,288,128,134,42,31,37,26,5,5,True,0.2835749624885971
2025-01-08 17:51:24,Fail to pick,699,288,0,0,0,0,0,0,0,0,False,0
2025-01-08 17:51:24,persegiMerah,699,282,124,126,150,45,151,42,1,3,True,0.4700428685204576
2025-01-08 17:51:24,Fail to pick,699,282,0,0,0,0,0,0,0,0,False,0
2025-01-08 17:51:24,persegiMerah,720,287,127,134,47,6,43,5,4,1,True,0.43326794066593
2025-01-08 17:51:24,persegiMerah,749,274,124,135,116,91,115,94,1,3,True,0.32006308013500195
2025-01-08 17:51:24,Merah,749,274,tensor(124.4857),tensor(135.9109),123,69,125,70,2,1,True,0.0
2025-01-08 17:51:25,persegiMerah,747,283,125,131,46,95,50,96,4,1,False,0.45699798524004576
2025-01-08 17:51:25,Fail to pick,747,283,0,0,0,0,0,0,0,0,False,0
2025-01-08 17:51:25,persegiMerah,715,266,127,130,47,35,48,39,1,4,True,0.348163305956041
2025-01-08 17:51:25,persegiMerah,695,283,130,128,49,77,47,72,2,5,True,0.21931840924638776
2025-01-08 17:51:25,persegiMerah,732,297,132,130,45,57,42,54,3,3,True,0.39521842825949094
2025-01-08 17:51:32,persegiBiru,700,336,134,123,94,97,95,100,1,3,True,0.46171675988027894
2025-01-08 17:51:32,Biru,700,336,tensor(134.2679),tensor(123.3234),106,64,101,66,5,2,True,0.0
2025-01-08 17:51:32,persegiMerah,718,345,135,130,27,40,26,42,1,2,True,0.45227843741502627
2025-01-08 17:51:33,persegiMerah,723,343,131,134,7,51,2,49,5,2,True,0.3914790854480146
2025-01-08 17:51:33,Fail to pick,723,343,0,0,0,0,0,0,0,0,False,0
2025-01-08 17:54:27,persegiBiru,214,319,120,125,56,82,54,83,2,1,True,0.24029658466059126
2025-01-08 17:54:27,Biru,214,319,tensor(120.0156),tensor(125.9851),111,19,106,22,5,3,True,0.0004982948303222656
2025-01-08 17:54:27,persegiBiru,213,317,118,126,36,21,36,20,0,1,False,0.3838682920920401
2025-01-08 17:54:27,Fail to pick,213,317,0,0,0,0,0,0,0,0,False,0
2025-01-08 17:54:27,persegiBiru,188,327,124,124,176,73,180,68,4,5,True,0.2574629629307502
2025-01-08 17:54:27,persegiBiru,215,316,118,126,90,40,94,37,4,3,True,0.22249911637790354
2025-01-08 17:54:28,persegiBiru,216,321,123,125,131,2,128,2,3,0,True,0.2124551691871982
2025-01-08 17:54:28,Fail to pick,216,321,0,0,0,0,0,0,0,0,False,0
2025-01-08 17:54:28,persegiBiru,196,324,125,122,19,83,23,84,4,1,True,0.43929442312097466
2025-01-08 17:54:28,persegiBiru,192,324,123,123,28,4,29,2,1,2,True,0.20899004420602135
2025-01-08 17:54:28,Fail to pick,192,324,0,0,0,0,0,0,0,0,False,0
2025-01-08 17:54:28,persegiBiru,216,316,118,127,143,29,141,26,2,3,True,0.29305658498483833
2025-01-08 17:54:28,persegiBiru,184,328,121,125,181,6,185,3,4,3,True,0.3794340649076938
2025-01-08 17:54:28,persegiBiru,202,320,121,126,164,27,159,28,5,1,True,0.33980086620686306
2025-01-08 17:54:28,persegiBiru,216,320,121,124,16,25,15,21,1,4,True,0.10425623602986059
2025-01-08 17:54:28,Biru,216,320,tensor(121.4839),tensor(124.3384),111,20,108,23,3,3,True,0.0
2025-01-08 17:54:28,persegiBiru,191,331,126,125,188,2,187,2,1,0,True,0.4283380514836945
2025-01-08 17:54:28,persegiBiru,175,330,121,127,12,32,15,31,3,1,True,0.28123603284143633
2025-01-08 17:54:28,persegiBiru,201,320,119,124,95,7,92,4,3,3,True,0.41671051332485765
2025-01-08 17:54:29,persegiBiru,211,319,117,123,39,26,37,28,2,2,True,0.35530400542427665
2025-01-08 17:54:29,persegiBiru,184,326,118,123,134,36,130,36,4,0,True,0.2707879079703311
2025-01-08 17:54:29,persegiBiru,199,320,117,127,192,66,190,62,2,4,True,0.38662702370673685
2025-01-08 17:54:29,persegiBiru,205,319,114,128,167,13,168,11,1,2,True,0.41446014125254793
2025-01-08 17:54:29,Fail to pick,205,319,0,0,0,0,0,0,0,0,False,0
2025-01-08 17:54:29,persegiBiru,200,326,127,123,197,48,199,51,2,3,True,0.1812502220944368
2025-01-08 17:54:29,Fail to pick,200,326,0,0,0,0,0,0,0,0,False,0
2025-01-08 17:54:29,persegiBiru,199,324,121,123,153,97,155,93,2,4,True,0.13922131008452895
2025-01-08 17:54:29,Fail to pick,199,324,0,0,0,0,0,0,0,0,False,0
2025-01-08 17:54:29,persegiBiru,187,325,128,123,179,66,182,66,3,0,True,0.4978583951087915
2025-01-08 17:54:29,persegiBiru,191,355,130,125,2,37,-3,34,5,3,True,0.3618083882050709
2025-01-08 17:54:29,persegiBiru,182,329,123,126,168,78,171,79,3,1,False,0.4700679699402738
2025-01-08 17:54:29,Biru,182,329,tensor(123.2220),tensor(126.4510),108,16,110,14,2,2,True,0.0
2025-01-08 17:54:30,persegiBiru,186,324,125,124,125,18,127,16,2,2,True,0.11708276503884602
2025-01-08 17:54:30,Fail to pick,186,324,0,0,0,0,0,0,0,0,False,0
2025-01-08 17:54:34,persegiBiru,318,355,142,145,3,43,3,45,0,2,True,0.1803610758512181
2025-01-08 17:54:34,Biru,318,355,tensor(142.6853),tensor(145.3109),101,29,101,26,0,3,True,0.0005056858062744141
2025-01-08 17:54:34,persegiBiru,321,331,138,140,49,73,45,76,4,3,True,0.38764279641579014
2025-01-08 17:54:34,persegiBiru,308,337,139,141,86,62,90,58,4,4,True,0.4929079455702128
2025-01-08 17:54:34,persegiBiru,307,335,139,137,88,75,86,77,2,2,True,0.3052203130707811
2025-01-08 17:54:34,Fail to pick,307,335,0,0,0,0,0,0,0,0,False,0
2025-01-08 17:54:34,persegiBiru,312,337,135,141,23,61,23,57,0,4,True,0.14286026034068913
2025-01-08 17:54:34,Fail to pick,312,337,0,0,0,0,0,0,0,0,False,0
2025-01-08 17:54:34,persegiBiru,304,339,138,141,96,65,96,68,0,3,False,0.4265810405884084
2025-01-08 17:54:34,Fail to pick,304,339,0,0,0,0,0,0,0,0,False,0
2025-01-08 17:54:34,persegiBiru,303,331,136,141,161,17,163,12,2,5,True,0.15914356474507826
2025-01-08 17:54:34,Fail to pick,303,331,0,0,0,0,0,0,0,0,False,0
2025-01-08 17:55:29,persegiHijau,649,323,116,120,29,29,29,33,0,4,True,0.4743484364279079
2025-01-08 17:55:29,Hijau,649,323,tensor(116.7589),tensor(120.1964),110,60,110,60,0,0,True,0.0
2025-01-08 17:55:29,persegiHijau,654,327,114,123,60,32,60,35,0,3,True,0.4600200663068019
2025-01-08 17:55:29,Fail to pick,654,327,0,0,0,0,0,0,0,0,False,0
2025-01-08 17:55:30,persegiHijau,648,320,120,124,156,58,156,61,0,3,True,0.43525607850629877
2025-01-08 17:55:30,Fail to pick,648,320,0,0,0,0,0,0,0,0,False,0
2025-01-08 17:55:30,persegiHijau,647,321,120,124,193,94,191,89,2,5,True,0.4951288662267803
2025-01-08 17:55:30,Fail to pick,647,321,0,0,0,0,0,0,0,0,False,0
2025-01-08 17:55:30,persegiHijau,655,314,117,123,182,7,179,10,3,3,True,0.264292609501772
2025-01-08 17:55:30,Fail to pick,655,314,0,0,0,0,0,0,0,0,False,0
2025-01-08 17:55:30,persegiHijau,671,332,117,119,94,61,91,64,3,3,True,0.33199921991683384
2025-01-08 17:55:30,persegiHijau,653,322,120,124,159,15,161,15,2,0,True,0.3181936496207939
2025-01-08 17:55:30,Hijau,653,322,tensor(120.8221),tensor(124.1185),110,60,108,64,2,4,True,0.0
2025-01-08 17:55:30,persegiHijau,672,330,116,117,199,69,200,65,1,4,True,0.3744503771781291
2025-01-08 17:55:31,persegiHijau,673,333,116,118,60,18,57,15,3,3,True,0.27611217896571977
2025-01-08 17:55:31,Fail to pick,673,333,0,0,0,0,0,0,0,0,False,0
2025-01-08 17:55:31,persegiHijau,666,339,114,117,146,37,144,35,2,2,True,0.20674030192608492
2025-01-08 17:55:31,Fail to pick,666,339,0,0,0,0,0,0,0,0,False,0
2025-01-08 17:55:31,persegiHijau,667,329,118,118,60,92,55,95,5,3,True,0.3828231410938179
2025-01-08 17:55:31,persegiHijau,667,334,119,122,132,53,129,50,3,3,True,0.2616738851161894
2025-01-08 17:55:31,Fail to pick,667,334,0,0,0,0,0,0,0,0,False,0
2025-01-08 17:55:31,persegiHijau,656,334,118,124,107,11,106,11,1,0,True,0.43618449787660585
2025-01-08 17:55:31,persegiHijau,668,338,114,118,83,99,79,98,4,1,True,0.24954839529606937
2025-01-08 17:55:31,persegiHijau,669,339,115,119,77,93,77,94,0,1,True,0.24793221775722693
2025-01-08 17:55:31,Fail to pick,669,339,0,0,0,0,0,0,0,0,False,0
2025-01-08 17:55:31,persegiHijau,671,337,116,122,171,73,171,68,0,5,True,0.2533135673300918
2025-01-08 17:55:31,Fail to pick,671,337,0,0,0,0,0,0,0,0,False,0
2025-01-08 17:55:32,persegiHijau,653,355,130,121,97,47,93,48,4,1,True,0.4629499031231903
2025-01-08 17:55:32,Hijau,653,355,tensor(130.1872),tensor(121.6562),101,60,105,60,4,0,True,0.0
2025-01-08 17:55:32,persegiHijau,700,323,121,124,190,59,187,56,3,3,True,0.36353597437539753
2025-01-08 17:55:32,persegiHijau,672,338,116,119,25,4,23,4,2,0,True,0.33890196586115545
2025-01-08 17:55:32,persegiHijau,663,346,116,125,29,7,26,10,3,3,True,0.359109295742404
2025-01-08 17:55:32,Fail to pick,663,346,0,0,0,0,0,0,0,0,False,0
2025-01-08 17:55:32,persegiHijau,671,339,115,120,93,96,94,100,1,4,True,0.23264535937101397
2025-01-08 17:55:32,Fail to pick,671,339,0,0,0,0,0,0,0,0,False,0
2025-01-08 17:55:32,persegiHijau,663,336,123,119,36,75,31,78,5,3,True,0.17064982159818826
2025-01-08 17:55:32,Fail to pick,663,336,0,0,0,0,0,0,0,0,False,0
2025-01-08 17:55:32,persegiHijau,638,352,128,121,41,27,45,22,4,5,True,0.2805428531314511
2025-01-08 17:55:47,persegiBiru,236,213,135,113,138,67,134,67,4,0,False,0.4191558118345319
2025-01-08 17:55:47,Biru,236,213,tensor(135.0705),tensor(113.8122),140,21,142,23,2,2,True,0.0
2025-01-08 17:55:47,persegiBiru,214,233,121,113,86,13,90,17,4,4,True,0.4373981695784682
2025-01-08 17:55:47,persegiBiru,191,219,121,116,63,19,58,22,5,3,True,0.31074141673098377
2025-01-08 17:55:48,persegiBiru,214,216,122,118,84,26,80,25,4,1,True,0.32215438191653656
2025-01-08 17:55:48,persegiBiru,215,227,124,117,117,96,120,95,3,1,True,0.15883234232632595
2025-01-08 17:55:48,persegiBiru,198,220,119,118,180,11,180,11,0,0,True,0.2999287009145604
2025-01-08 17:55:48,persegiBiru,216,235,123,112,87,55,86,50,1,5,True,0.20627149287941904
2025-01-08 17:55:48,persegiBiru,216,235,126,113,84,46,79,49,5,3,True,0.25325018850835324
2025-01-08 17:55:48,Fail to pick,216,235,0,0,0,0,0,0,0,0,False,0
2025-01-08 17:55:48,persegiBiru,196,224,124,121,191,34,186,35,5,1,True,0.49652753661806526
2025-01-08 17:55:48,persegiBiru,196,220,120,119,55,77,53,74,2,3,True,0.2517277561515062
2025-01-08 17:55:48,Biru,196,220,tensor(120.8361),tensor(119.6678),138,18,138,22,0,4,True,0.0
2025-01-08 17:55:48,Fail to pick,196,220,0,0,0,0,0,0,0,0,False,0
2025-01-08 17:55:48,persegiBiru,194,219,119,121,89,29,85,25,4,4,True,0.20688015692967748
2025-01-08 17:55:48,Fail to pick,194,219,0,0,0,0,0,0,0,0,False,0
2025-01-08 17:55:48,persegiBiru,196,217,119,121,140,79,138,77,2,2,True,0.288256263698206
2025-01-08 17:55:48,Fail to pick,196,217,0,0,0,0,0,0,0,0,False,0
2025-01-08 17:55:49,persegiBiru,191,222,120,122,119,83,122,85,3,2,True,0.3979177216110431
2025-01-08 17:55:49,Fail to pick,191,222,0,0,0,0,0,0,0,0,False,0
2025-01-08 17:55:49,persegiBiru,193,222,119,118,169,41,170,42,1,1,True,0.3648171499139836
2025-01-08 17:55:49,Fail to pick,193,222,0,0,0,0,0,0,0,0,False,0
2025-01-08 17:55:49,persegiBiru,189,225,121,116,15,29,13,33,2,4,True,0.44206060334044306
2025-01-08 17:55:49,Fail to pick,189,225,0,0,0,0,0,0,0,0,False,0
2025-01-08 17:55:49,persegiBiru,187,224,118,115,35,79,32,79,3,0,True,0.2115350863315988
2025-01-08 17:55:49,Fail to pick,187,224,0,0,0,0,0,0,0,0,False,0
2025-01-08 17:55:49,persegiBiru,187,224,118,115,132,30,128,26,4,4,True,0.14082154310856204
2025-01-08 17:55:49,Fail to pick,187,224,0,0,0,0,0,0,0,0,False,0
2025-01-08 17:55:49,persegiBiru,193,222,120,118,62,37,58,41,4,4,True,0.39551425820124286
2025-01-08 17:55:49,Fail to pick,193,222,0,0,0,0,0,0,0,0,False,0
2025-01-08 17:55:49,persegiBiru,191,222,120,118,51,4,54,5,3,1,False,0.4855921731145263
2025-01-08 17:55:49,Fail to pick,191,222,0,0,0,0,0,0,0,0,False,0
2025-01-08 17:55:49,persegiBiru,215,233,124,115,196,40,191,35,5,5,True,0.33927950742881163
2025-01-08 17:55:49,Biru,215,233,tensor(124.2060),tensor(115.8211),135,19,131,22,4,3,True,0.0
2025-01-08 17:55:49,persegiBiru,194,219,119,118,36,44,37,45,1,1,True,0.1763517178600516
2025-01-08 17:55:50,persegiBiru,191,224,121,120,160,5,158,9,2,4,True,0.16359706692182474
2025-01-08 17:55:50,Fail to pick,191,224,0,0,0,0,0,0,0,0,False,0
2025-01-08 17:55:50,persegiBiru,196,222,116,122,27,7,28,2,1,5,True,0.4949354881966198
2025-01-08 17:55:50,Fail to pick,196,222,0,0,0,0,0,0,0,0,False,0
2025-01-08 17:55:50,persegiBiru,208,225,122,120,92,60,94,59,2,1,True,0.2940676684848985
2025-01-08 17:56:01,persegiMerah,230,191,127,120,64,96,67,96,3,0,False,0.30392919138008345
2025-01-08 17:56:01,Merah,230,191,tensor(127.9941),tensor(120.4459),146,21,150,16,4,5,True,0.0
2025-01-08 17:56:01,persegiMerah,225,188,130,121,25,59,24,57,1,2,True,0.19769083819895844
2025-01-08 17:56:01,Fail to pick,225,188,0,0,0,0,0,0,0,0,False,0
2025-01-08 17:56:01,persegiMerah,198,171,119,113,75,95,74,96,1,1,True,0.25758929305654743
2025-01-08 17:56:01,persegiMerah,223,191,125,119,174,8,175,7,1,1,True,0.41775529569119374
2025-01-08 17:56:01,persegiMerah,221,189,124,122,31,25,27,22,4,3,True,0.23903979411689155
2025-01-08 17:56:01,Fail to pick,221,189,0,0,0,0,0,0,0,0,False,0
2025-01-08 17:56:02,persegiMerah,220,187,126,122,96,88,100,92,4,4,True,0.17036672628484678
2025-01-08 17:56:02,Fail to pick,220,187,0,0,0,0,0,0,0,0,False,0
2025-01-08 17:56:02,persegiMerah,195,172,125,115,45,0,46,0,1,0,True,0.39083905479225434
2025-01-08 17:56:02,persegiMerah,193,165,115,113,47,99,46,99,1,0,True,0.38414610248287506
2025-01-08 17:56:02,Fail to pick,193,165,0,0,0,0,0,0,0,0,False,0
2025-01-08 17:56:02,persegiMerah,223,188,126,119,117,74,119,75,2,1,True,0.439010031270216
2025-01-08 17:56:02,persegiMerah,199,171,122,116,178,74,178,74,0,0,True,0.3163156639739082
2025-01-08 17:56:02,Merah,199,171,tensor(122.5853),tensor(116.2997),152,18,155,18,3,0,True,0.0
2025-01-08 17:56:02,persegiMerah,192,166,117,114,69,66,71,66,2,0,True,0.21887289356458026
2025-01-08 17:56:02,Fail to pick,192,166,0,0,0,0,0,0,0,0,False,0
2025-01-08 17:56:02,persegiMerah,225,189,128,117,38,59,41,58,3,1,False,0.17317787291968156
2025-01-08 17:56:02,persegiMerah,195,171,118,114,153,66,150,68,3,2,True,0.37627476159646156
2025-01-08 17:56:03,persegiMerah,194,173,125,114,180,63,177,67,3,4,True,0.20923523697551435
2025-01-08 17:56:03,Fail to pick,194,173,0,0,0,0,0,0,0,0,False,0
2025-01-08 17:56:03,persegiMerah,195,171,122,115,138,4,135,0,3,4,True,0.45130024795928714
2025-01-08 17:56:03,Fail to pick,195,171,0,0,0,0,0,0,0,0,False,0
2025-01-08 17:56:03,persegiMerah,194,172,121,114,15,58,14,58,1,0,True,0.2652524372841447
2025-01-08 17:56:03,Fail to pick,194,172,0,0,0,0,0,0,0,0,False,0
2025-01-08 17:56:03,persegiMerah,218,189,124,119,92,66,94,66,2,0,True,0.45701101161534685
2025-01-08 17:56:03,persegiMerah,218,190,126,120,75,65,71,61,4,4,True,0.46039479242508563
2025-01-08 17:56:03,Merah,218,190,tensor(126.6588),tensor(120.1956),147,20,150,22,3,2,True,0.0
2025-01-08 17:56:03,Fail to pick,218,190,0,0,0,0,0,0,0,0,False,0
2025-01-08 17:56:03,persegiMerah,224,190,128,120,107,16,108,19,1,3,True,0.22237737981159877
2025-01-08 17:56:03,Fail to pick,224,190,0,0,0,0,0,0,0,0,False,0
2025-01-08 17:56:03,persegiMerah,227,200,124,118,19,64,19,66,0,2,True,0.4957868029283583
2025-01-08 17:56:04,persegiMerah,189,169,115,115,94,2,94,2,0,0,True,0.18590348531564782
2025-01-08 17:56:08,persegiMerah,147,196,157,124,65,70,66,68,1,2,True,0.45599621617139474
2025-01-08 17:56:08,Merah,147,196,tensor(157.1823),tensor(124.5779),145,13,148,17,3,4,True,0.0005002021789550781
2025-01-08 17:56:09,persegiMerah,133,192,157,126,124,38,125,33,1,5,True,0.37080153461903065
2025-01-08 17:56:09,persegiMerah,152,189,161,127,112,80,108,84,4,4,True,0.4278478942128362
2025-01-08 17:56:09,persegiMerah,89,219,147,119,112,5,111,1,1,4,True,0.10193754226246808
2025-01-08 17:56:11,persegiBiru,837,367,122,112,124,88,125,92,1,4,True,0.49021519275348535
2025-01-08 17:56:11,Biru,837,367,tensor(122.5840),tensor(112.0502),98,77,102,81,4,4,True,0.0
2025-01-08 17:56:11,persegiBiru,861,378,122,115,137,48,133,47,4,1,True,0.23932106736048897
2025-01-08 17:56:11,persegiBiru,863,376,123,114,198,35,200,39,2,4,True,0.16131758346583083
2025-01-08 17:56:11,Fail to pick,863,376,0,0,0,0,0,0,0,0,False,0
2025-01-08 17:56:11,persegiBiru,872,370,125,111,155,56,154,56,1,0,True,0.2569161667047791
2025-01-08 17:56:11,Fail to pick,872,370,0,0,0,0,0,0,0,0,False,0
2025-01-08 17:56:11,persegiBiru,859,371,123,108,105,31,105,33,0,2,True,0.18855877802441637
2025-01-08 17:56:12,persegiBiru,846,403,121,111,58,55,62,56,4,1,True,0.2929889033993523
2025-01-08 17:56:12,Biru,846,403,tensor(121.0176),tensor(111.9255),88,78,84,77,4,1,True,0.0
2025-01-08 17:56:12,persegiBiru,837,398,118,106,178,69,180,68,2,1,True,0.43424181927116845
2025-01-08 17:56:12,Fail to pick,837,398,0,0,0,0,0,0,0,0,False,0
2025-01-08 17:56:12,persegiBiru,841,390,123,107,3,7,-2,4,5,3,False,0.33539043736633106
2025-01-08 17:56:12,Fail to pick,841,390,0,0,0,0,0,0,0,0,False,0
2025-01-08 17:56:12,persegiBiru,835,397,119,106,97,86,95,84,2,2,True,0.27094648805981625
2025-01-08 17:56:12,Fail to pick,835,397,0,0,0,0,0,0,0,0,False,0
2025-01-08 17:56:13,persegiBiru,846,401,120,108,134,22,136,24,2,2,True,0.20963654381413674
2025-01-08 17:56:13,persegiBiru,834,393,117,105,184,13,184,13,0,0,True,0.41909114207610665
2025-01-08 17:56:13,persegiBiru,833,391,118,106,64,78,63,75,1,3,True,0.27567157347276783
2025-01-08 17:56:13,Fail to pick,833,391,0,0,0,0,0,0,0,0,False,0
2025-01-08 17:56:19,persegiBiru,863,413,117,109,149,30,153,26,4,4,True,0.2822380620960303
2025-01-08 17:56:19,Biru,863,413,tensor(117.3218),tensor(109.9254),85,79,83,82,2,3,True,0.0
2025-01-08 17:56:19,persegiBiru,844,386,121,113,87,76,83,71,4,5,False,0.2571160552917686
2025-01-08 17:56:19,persegiBiru,840,390,121,115,147,56,144,59,3,3,True,0.2342153100345001
2025-01-08 17:56:19,Fail to pick,840,390,0,0,0,0,0,0,0,0,False,0
2025-01-08 17:56:19,persegiBiru,864,412,117,108,75,59,71,63,4,4,True,0.4365933255718303
2025-01-08 17:56:19,persegiBiru,841,398,120,112,46,29,44,24,2,5,True,0.14309437632247307
2025-01-08 17:56:19,persegiBiru,839,387,121,111,49,90,46,92,3,2,True,0.44963258132651274
2025-01-08 17:56:20,persegiBiru,861,411,117,110,86,0,82,0,4,0,True,0.317400068180314
2025-01-08 17:56:20,persegiBiru,870,406,119,110,102,85,100,80,2,5,True,0.4761152512616801
2025-01-08 17:56:20,Fail to pick,870,406,0,0,0,0,0,0,0,0,False,0
2025-01-08 17:56:20,persegiBiru,852,401,124,112,164,75,161,76,3,1,False,0.3015046349905651
2025-01-08 17:56:20,persegiBiru,837,380,120,118,175,98,170,102,5,4,True,0.12086318404398311
2025-01-08 17:56:20,persegiBiru,871,407,120,112,171,24,171,21,0,3,True,0.3449076299875731
2025-01-08 17:56:20,persegiBiru,815,363,124,118,42,8,43,12,1,4,True,0.381438724350604
2025-01-08 17:56:21,persegiBiru,858,388,121,113,167,85,163,85,4,0,True,0.4753576044572798
2025-01-08 17:56:21,Biru,858,388,tensor(121.0701),tensor(113.1292),92,79,95,81,3,2,True,0.0
2025-01-08 17:56:21,persegiBiru,858,388,121,113,21,29,20,29,1,0,True,0.31979526914691664
2025-01-08 17:56:21,Fail to pick,858,388,0,0,0,0,0,0,0,0,False,0
2025-01-08 17:56:21,persegiBiru,879,381,126,118,110,72,107,69,3,3,True,0.1553275145753036
2025-01-08 17:57:07,persegiBiru,250,325,128,132,80,53,83,53,3,0,True,0.15347602262979484
2025-01-08 17:57:07,Biru,250,325,tensor(128.8519),tensor(132.3568),109,23,104,26,5,3,True,0.0004992485046386719
2025-01-08 17:57:07,persegiBiru,250,328,129,132,149,56,144,53,5,3,True,0.2966554284420798
2025-01-08 17:57:07,Fail to pick,250,328,0,0,0,0,0,0,0,0,False,0
2025-01-08 17:57:08,persegiBiru,260,328,131,130,143,50,144,50,1,0,True,0.4792515032032397
2025-01-08 17:57:08,persegiBiru,245,329,128,131,81,44,83,45,2,1,False,0.21434032071660936
2025-01-08 17:57:08,persegiBiru,243,324,129,132,113,33,108,37,5,4,True,0.34360807649744973
2025-01-08 17:57:08,Fail to pick,243,324,0,0,0,0,0,0,0,0,False,0
2025-01-08 17:57:08,persegiBiru,254,333,131,132,31,34,35,33,4,1,True,0.19201861240978105
2025-01-08 17:57:08,persegiBiru,250,336,129,131,120,54,117,56,3,2,True,0.453963470572028
2025-01-08 17:57:08,Fail to pick,250,336,0,0,0,0,0,0,0,0,False,0
2025-01-08 17:57:08,persegiBiru,249,328,131,131,45,90,40,87,5,3,True,0.20632199530856507
2025-01-08 17:57:08,Fail to pick,249,328,0,0,0,0,0,0,0,0,False,0
2025-01-08 17:57:08,persegiBiru,251,333,132,131,3,85,3,84,0,1,True,0.4804225856200949
2025-01-08 17:57:08,Fail to pick,251,333,0,0,0,0,0,0,0,0,False,0
2025-01-08 17:57:08,persegiBiru,258,327,130,131,93,43,92,42,1,1,True,0.38437789633568054
2025-01-08 17:57:08,Biru,258,327,tensor(130.4195),tensor(131.1690),109,23,108,20,1,3,True,0.0004999637603759766
2025-01-08 17:57:08,Fail to pick,258,327,0,0,0,0,0,0,0,0,False,0
2025-01-08 17:57:09,persegiBiru,258,333,131,132,189,13,188,17,1,4,True,0.2873092162171915
2025-01-08 17:57:09,Fail to pick,258,333,0,0,0,0,0,0,0,0,False,0
2025-01-08 17:57:09,persegiBiru,264,324,131,129,136,57,131,56,5,1,True,0.43300272020053143
2025-01-08 17:57:09,Fail to pick,264,324,0,0,0,0,0,0,0,0,False,0
2025-01-08 17:57:09,persegiBiru,253,337,133,131,158,38,153,42,5,4,True,0.3687271344334011
2025-01-08 17:57:09,persegiBiru,260,341,127,135,193,10,195,7,2,3,True,0.2423745515975834
2025-01-08 17:57:09,Fail to pick,260,341,0,0,0,0,0,0,0,0,False,0
2025-01-08 17:57:09,persegiBiru,248,323,128,131,46,80,48,77,2,3,True,0.23456953821140292
2025-01-08 17:57:09,persegiBiru,246,323,129,129,149,63,149,64,0,1,True,0.16139076328023416
2025-01-08 17:57:09,Fail to pick,246,323,0,0,0,0,0,0,0,0,False,0
2025-01-08 17:57:09,persegiBiru,244,325,126,128,14,2,17,0,3,2,True,0.24604295366637607
2025-01-08 17:57:09,Fail to pick,244,325,0,0,0,0,0,0,0,0,False,0
2025-01-08 17:57:09,persegiBiru,248,324,132,129,55,24,54,23,1,1,True,0.30293926894489276
2025-01-08 17:57:09,Fail to pick,248,324,0,0,0,0,0,0,0,0,False,0
2025-01-08 17:57:09,persegiBiru,247,324,132,131,72,36,71,40,1,4,True,0.19971997552502183
2025-01-08 17:57:09,Biru,247,324,tensor(132.6528),tensor(131.0665),110,22,105,20,5,2,True,0.0
2025-01-08 17:57:09,Fail to pick,247,324,0,0,0,0,0,0,0,0,False,0
2025-01-08 17:57:10,persegiBiru,255,334,130,130,24,95,26,95,2,0,True,0.19850800835397242
2025-01-08 17:57:10,persegiBiru,245,323,127,129,104,94,101,96,3,2,True,0.36912912139237064
2025-01-08 17:57:14,persegiBiru,392,291,138,135,190,88,186,88,4,0,True,0.15296455086809108
2025-01-08 17:57:14,Biru,392,291,tensor(138.5333),tensor(135.4517),119,36,119,33,0,3,True,0.0005064010620117188
2025-01-08 17:57:14,persegiBiru,372,306,136,137,101,0,97,2,4,2,True,0.19368305492610963
2025-01-08 17:57:14,persegiBiru,389,291,140,134,112,3,108,-2,4,5,True,0.3629347893959459
2025-01-08 17:57:14,persegiBiru,378,311,136,143,57,15,55,14,2,1,True,0.35129640027939935
2025-01-08 17:57:14,persegiBiru,376,316,134,141,198,0,201,-4,3,4,True,0.49191685157980836
2025-01-08 17:57:14,Fail to pick,376,316,0,0,0,0,0,0,0,0,False,0
2025-01-08 17:57:14,persegiBiru,368,299,140,140,119,0,115,-3,4,3,True,0.13305406323525473
2025-01-08 17:57:15,persegiBiru,391,322,138,140,130,72,131,68,1,4,True,0.30986625754855635
2025-01-08 17:57:15,persegiBiru,393,327,139,139,185,7,187,9,2,2,True,0.15090961141239503
2025-01-08 17:57:15,Fail to pick,393,327,0,0,0,0,0,0,0,0,False,0
2025-01-08 17:57:15,persegiBiru,381,312,140,141,121,42,118,42,3,0,True,0.22904761157708542
2025-01-08 17:57:15,persegiBiru,380,316,137,139,1,30,3,29,2,1,True,0.39134868528512423
2025-01-08 17:57:15,Biru,380,316,tensor(137.9157),tensor(139.1913),112,35,115,34,3,1,True,0.0005006790161132812
2025-01-08 17:57:15,Fail to pick,380,316,0,0,0,0,0,0,0,0,False,0
2025-01-08 17:57:15,persegiBiru,373,313,142,141,144,84,147,88,3,4,True,0.3162626981662283
2025-01-08 17:57:15,Fail to pick,373,313,0,0,0,0,0,0,0,0,False,0
2025-01-08 17:57:41,persegiBiru,184,171,117,117,125,5,123,6,2,1,True,0.2431944396236271
2025-01-08 17:57:41,Biru,184,171,tensor(117.5697),tensor(117.0226),152,17,155,18,3,1,True,0.0
2025-01-08 17:57:41,persegiBiru,134,123,140,140,144,85,143,85,1,0,True,0.11183807267842778
2025-01-08 17:57:41,persegiBiru,230,89,127,128,107,2,109,3,2,1,True,0.16065434095711173
2025-01-08 17:57:41,persegiBiru,163,115,136,131,45,20,47,19,2,1,True,0.21567449139173794
2025-01-08 17:57:41,persegiBiru,167,108,134,137,25,89,28,86,3,3,True,0.3961220181700008
2025-01-08 17:57:41,Fail to pick,167,108,0,0,0,0,0,0,0,0,False,0
2025-01-08 17:57:41,persegiBiru,146,114,142,135,197,31,195,35,2,4,True,0.307198092153689
2025-01-08 17:57:42,persegiBiru,232,89,128,126,135,98,139,97,4,1,True,0.16523790575769193
2025-01-08 17:57:42,persegiBiru,130,115,142,138,137,52,139,51,2,1,True,0.2261181351884464
2025-01-08 17:57:42,persegiBiru,180,107,131,136,124,93,124,93,0,0,True,0.47452438497501437
2025-01-08 17:57:42,persegiBiru,226,90,125,127,92,26,93,24,1,2,True,0.45555993911488113
2025-01-08 17:57:42,persegiBiru,174,119,139,140,177,40,175,42,2,2,True,0.4739888075507378
2025-01-08 17:57:42,Biru,174,119,tensor(139.4177),tensor(140.0441),166,16,166,14,0,2,True,0.0
2025-01-08 17:57:42,persegiBiru,175,119,140,137,140,37,143,38,3,1,True,0.13112962792053273
2025-01-08 17:57:42,Fail to pick,175,119,0,0,0,0,0,0,0,0,False,0
2025-01-08 17:57:42,persegiBiru,232,92,129,126,176,24,171,19,5,5,True,0.45470162340713194
2025-01-08 17:57:42,persegiBiru,224,94,132,126,96,7,92,11,4,4,False,0.3256072983400003
2025-01-08 17:57:42,Fail to pick,224,94,0,0,0,0,0,0,0,0,False,0
2025-01-08 17:57:42,persegiBiru,225,90,127,126,89,48,88,45,1,3,True,0.46238913954681615
2025-01-08 17:57:42,Fail to pick,225,90,0,0,0,0,0,0,0,0,False,0
2025-01-08 17:57:43,persegiBiru,202,104,129,130,188,98,187,100,1,2,True,0.43414003146595126
2025-01-08 17:57:43,persegiBiru,227,89,125,127,59,49,58,52,1,3,False,0.4860083238808798
2025-01-08 17:57:43,persegiBiru,162,120,140,139,71,14,70,11,1,3,True,0.20283929245576077
2025-01-08 17:57:43,persegiBiru,232,88,129,129,29,64,25,67,4,3,True,0.457859762429085
2025-01-08 17:57:43,persegiBiru,175,121,139,140,148,70,144,71,4,1,True,0.26377676173739484
2025-01-08 17:57:43,persegiBiru,225,94,128,126,178,96,182,94,4,2,True,0.371539349721714
2025-01-08 17:57:43,Biru,225,94,tensor(128.8461),tensor(126.4661),173,20,174,15,1,5,True,0.0
2025-01-08 17:57:43,persegiBiru,225,94,128,126,118,27,115,28,3,1,True,0.11572895076859213
2025-01-08 17:57:43,Fail to pick,225,94,0,0,0,0,0,0,0,0,False,0
2025-01-08 17:57:43,persegiBiru,186,115,137,135,73,42,75,46,2,4,True,0.2361858786231121
2025-01-08 17:57:43,persegiBiru,238,95,134,126,166,37,170,41,4,4,True,0.22377845977356345
2025-01-08 17:57:44,persegiBiru,165,108,135,135,6,25,5,25,1,0,True,0.3987969954322713
2025-01-08 17:57:44,persegiBiru,162,108,134,140,95,58,94,55,1,3,True,0.29685211719647564
2025-01-08 17:57:44,Fail to pick,162,108,0,0,0,0,0,0,0,0,False,0
2025-01-08 17:57:44,persegiBiru,155,120,137,138,101,67,97,71,4,4,True,0.36661537742141626
2025-01-08 17:57:47,persegiBiru,253,105,146,147,185,92,187,90,2,2,True,0.41888941518837886
2025-01-08 17:57:47,Biru,253,105,tensor(146.2141),tensor(147.1119),170,23,170,20,0,3,True,0.0004985332489013672
2025-01-08 17:57:48,persegiBiru,276,91,148,146,184,94,183,93,1,1,False,0.36238722824887426
2025-01-08 17:57:48,persegiBiru,272,92,147,149,149,56,151,55,2,1,True,0.3133427772958629
2025-01-08 17:57:48,Fail to pick,272,92,0,0,0,0,0,0,0,0,False,0
2025-01-08 17:57:48,persegiBiru,274,95,148,144,161,61,163,58,2,3,True,0.332043887863683
2025-01-08 17:57:48,Fail to pick,274,95,0,0,0,0,0,0,0,0,False,0
2025-01-08 17:57:48,persegiBiru,276,91,148,149,35,85,38,84,3,1,True,0.19009967579075948
2025-01-08 17:57:48,Fail to pick,276,91,0,0,0,0,0,0,0,0,False,0
2025-01-08 17:57:48,persegiBiru,276,93,148,145,126,74,127,76,1,2,True,0.44497893682319434
2025-01-08 17:57:48,Fail to pick,276,93,0,0,0,0,0,0,0,0,False,0
2025-01-08 17:57:48,persegiBiru,306,111,152,151,26,66,28,63,2,3,True,0.47319854348924795
2025-01-08 17:57:48,persegiBiru,269,98,143,144,85,46,88,46,3,0,True,0.2984342232186403
2025-01-08 17:58:06,persegiBiru,689,408,132,124,194,40,189,35,5,5,True,0.4209974764913519
2025-01-08 17:58:59,persegiHijau,428,158,113,133,69,16,67,12,2,4,True,0.4865725554455699
2025-01-08 17:58:59,Hijau,428,158,tensor(113.6305),tensor(133.8291),156,39,154,35,2,4,True,0.0
2025-01-08 17:59:00,persegiHijau,417,153,117,137,59,53,60,50,1,3,True,0.4327865098304454
2025-01-08 17:59:00,persegiHijau,483,194,117,129,18,98,14,97,4,1,True,0.3132115445607915
2025-01-08 17:59:00,persegiHijau,473,199,126,130,44,4,48,3,4,1,True,0.495073473291635
2025-01-08 17:59:00,persegiHijau,473,191,119,128,192,87,195,87,3,0,True,0.12770274738925258
2025-01-08 17:59:00,Fail to pick,473,191,0,0,0,0,0,0,0,0,False,0
2025-01-08 17:59:00,persegiHijau,481,195,118,130,102,44,101,41,1,3,True,0.3018685549342667
2025-01-08 17:59:00,Fail to pick,481,195,0,0,0,0,0,0,0,0,False,0
2025-01-08 17:59:00,persegiHijau,473,194,118,133,78,49,74,46,4,3,True,0.22577372375686486
2025-01-08 17:59:00,Fail to pick,473,194,0,0,0,0,0,0,0,0,False,0
2025-01-08 17:59:00,persegiHijau,480,189,116,128,120,87,115,87,5,0,True,0.4201301407548914
2025-01-08 17:59:00,Fail to pick,480,189,0,0,0,0,0,0,0,0,False,0
2025-01-08 17:59:00,persegiHijau,480,194,118,128,164,74,166,76,2,2,True,0.442151543101302
2025-01-08 17:59:00,Fail to pick,480,194,0,0,0,0,0,0,0,0,False,0
2025-01-08 17:59:01,persegiHijau,481,194,119,129,57,54,59,52,2,2,True,0.4694127443967733
2025-01-08 17:59:01,Hijau,481,194,tensor(119.4127),tensor(129.5889),146,44,149,43,3,1,True,0.0
2025-01-08 17:59:01,Fail to pick,481,194,0,0,0,0,0,0,0,0,False,0
2025-01-08 17:59:01,persegiHijau,481,196,121,129,46,39,42,41,4,2,False,0.3242076642389715
2025-01-08 17:59:01,Fail to pick,481,196,0,0,0,0,0,0,0,0,False,0
2025-01-08 17:59:01,persegiHijau,425,158,116,135,112,32,114,30,2,2,True,0.2089864621050865
2025-01-08 17:59:01,persegiHijau,482,198,122,128,164,98,161,102,3,4,True,0.10619061868082383
2025-01-08 17:59:01,persegiHijau,501,205,122,126,121,37,122,35,1,2,True,0.43053382365168125
2025-01-08 17:59:01,persegiHijau,481,197,118,128,121,72,120,76,1,4,False,0.4468192615609481
2025-01-08 17:59:01,persegiHijau,489,199,124,132,49,90,52,86,3,4,True,0.26055725549371733
2025-01-08 17:59:01,Fail to pick,489,199,0,0,0,0,0,0,0,0,False,0
2025-01-08 17:59:01,persegiHijau,487,200,119,129,196,54,199,57,3,3,True,0.3226740829328376
2025-01-08 17:59:01,Fail to pick,487,200,0,0,0,0,0,0,0,0,False,0
2025-01-08 17:59:01,persegiHijau,482,194,118,129,92,28,91,23,1,5,True,0.31143338373497076
2025-01-08 17:59:01,Fail to pick,482,194,0,0,0,0,0,0,0,0,False,0
2025-01-08 17:59:02,persegiHijau,475,201,119,128,91,95,89,90,2,5,True,0.11776057355678989
2025-01-08 17:59:02,Fail to pick,475,201,0,0,0,0,0,0,0,0,False,0
2025-01-08 17:59:02,persegiHijau,479,195,119,129,110,45,111,46,1,1,True,0.1801138250116422
2025-01-08 17:59:02,Hijau,479,195,tensor(119.8077),tensor(129.7342),145,44,147,42,2,2,True,0.0005004405975341797
2025-01-08 17:59:02,Fail to pick,479,195,0,0,0,0,0,0,0,0,False,0
2025-01-08 17:59:02,persegiHijau,486,194,117,127,162,50,164,45,2,5,False,0.13132628702372282
2025-01-08 17:59:02,Fail to pick,486,194,0,0,0,0,0,0,0,0,False,0
2025-01-08 17:59:02,persegiHijau,485,194,118,131,182,93,183,93,1,0,True,0.24646829206221718
2025-01-08 17:59:02,Fail to pick,485,194,0,0,0,0,0,0,0,0,False,0
2025-01-08 17:59:02,persegiHijau,483,195,119,130,95,61,95,59,0,2,True,0.4417617565561702
2025-01-08 17:59:02,Fail to pick,483,195,0,0,0,0,0,0,0,0,False,0
2025-01-08 17:59:02,persegiHijau,421,149,111,134,96,82,93,80,3,2,True,0.14043654177900045
2025-01-08 17:59:06,persegiHijau,522,190,121,138,181,1,181,3,0,2,True,0.268375117753602
2025-01-08 17:59:06,Hijau,522,190,tensor(121.9086),tensor(138.9418),147,48,148,50,1,2,True,0.0004990100860595703
2025-01-08 17:59:06,persegiHijau,539,180,124,137,158,12,161,16,3,4,True,0.10075253882670863
2025-01-08 17:59:06,persegiHijau,539,179,127,138,95,14,90,14,5,0,True,0.27803657953594807
2025-01-08 17:59:06,Fail to pick,539,179,0,0,0,0,0,0,0,0,False,0
2025-01-08 17:59:07,persegiHijau,549,193,127,133,111,66,107,67,4,1,True,0.49716846269233905
2025-01-08 17:59:07,persegiHijau,542,188,127,136,106,21,105,23,1,2,True,0.27850515565870404
2025-01-08 17:59:07,Fail to pick,542,188,0,0,0,0,0,0,0,0,False,0
2025-01-08 17:59:07,persegiHijau,490,140,127,139,162,96,160,91,2,5,True,0.39814703665299256
2025-01-08 17:59:07,persegiHijau,555,194,132,136,38,56,34,51,4,5,True,0.341310334083056
2025-01-08 17:59:07,persegiHijau,534,192,120,129,93,81,91,82,2,1,True,0.45018302350851636
2025-01-08 17:59:07,segienamHijau,535,191,123,129,109,87,105,88,4,1,True,0.1955850819219237
2025-01-08 17:59:07,Fail to pick,535,191,0,0,0,0,0,0,0,0,False,0
2025-01-08 17:59:20,persegiBiru,528,426,112,117,117,45,117,44,0,1,True,0.3630091083651886
2025-01-08 17:59:20,Biru,528,426,tensor(112.8545),tensor(117.8510),81,48,79,47,2,1,True,0.0
2025-01-08 17:59:20,persegiBiru,528,426,112,117,56,50,56,54,0,4,True,0.1909213180339533
2025-01-08 17:59:20,Fail to pick,528,426,0,0,0,0,0,0,0,0,False,0
2025-01-08 17:59:21,persegiBiru,436,414,121,114,116,39,111,35,5,4,True,0.2731274114259381
2025-01-08 17:59:21,persegiBiru,415,418,118,118,103,89,106,88,3,1,True,0.18786900184032054
2025-01-08 17:59:21,persegiBiru,459,466,118,101,26,93,24,96,2,3,True,0.3239869739969317
2025-01-08 18:00:11,persegiMerah,349,444,121,116,163,31,165,34,2,3,False,0.3865390735898536
2025-01-08 18:00:11,Merah,349,444,tensor(121.4532),tensor(116.8758),76,32,80,27,4,5,True,0.0004982948303222656
2025-01-08 18:00:11,persegiMerah,349,445,121,117,52,51,56,54,4,3,True,0.21609362381775737
2025-01-08 18:00:11,Fail to pick,349,445,0,0,0,0,0,0,0,0,False,0
2025-01-08 18:00:12,persegiMerah,343,443,121,117,68,33,67,33,1,0,False,0.21159713575747371
2025-01-08 18:00:12,Fail to pick,343,443,0,0,0,0,0,0,0,0,False,0
2025-01-08 18:00:18,persegiMerah,435,364,148,134,159,71,161,68,2,3,False,0.4962638900562196
2025-01-08 18:00:18,Merah,435,364,tensor(148.1907),tensor(134.4979),98,40,97,36,1,4,True,0.0004944801330566406
2025-01-08 18:00:18,persegiMerah,461,386,146,129,56,48,51,46,5,2,True,0.15486278954597707
2025-01-08 18:00:18,persegiMerah,430,369,150,133,13,43,11,38,2,5,True,0.11531831213291946
2025-01-08 18:00:18,persegiMerah,440,364,143,132,160,19,159,17,1,2,True,0.4853006108179777
2025-01-08 18:00:18,persegiMerah,443,366,138,134,121,99,117,103,4,4,True,0.14165873451616304
2025-01-08 18:00:18,Fail to pick,443,366,0,0,0,0,0,0,0,0,False,0
2025-01-08 18:00:18,persegiMerah,445,371,138,131,46,91,42,95,4,4,True,0.4521186653571375
2025-01-08 18:00:18,Fail to pick,445,371,0,0,0,0,0,0,0,0,False,0
2025-01-08 18:00:18,persegiMerah,452,417,146,126,37,25,39,28,2,3,True,0.20282802984321752
2025-01-08 18:00:19,persegiMerah,457,389,147,128,191,27,188,31,3,4,True,0.1605864022175911
2025-01-08 18:00:19,Merah,457,389,tensor(147.6922),tensor(128.1871),91,42,95,37,4,5,True,0.0
2025-01-08 18:00:19,persegiMerah,424,366,147,134,135,68,135,64,0,4,True,0.18866756629731607
2025-01-08 18:00:19,persegiMerah,439,365,146,132,73,36,70,34,3,2,True,0.14894996603147806
2025-01-08 18:00:19,persegiMerah,427,364,143,134,93,35,95,36,2,1,False,0.4426397416425868
2025-01-08 18:00:19,persegiMerah,421,357,143,136,46,62,46,60,0,2,True,0.3730732190844789
2025-01-08 18:00:19,Fail to pick,421,357,0,0,0,0,0,0,0,0,False,0
2025-01-08 18:00:20,persegiMerah,428,365,143,135,21,71,25,74,4,3,True,0.3592303227163759
2025-01-08 18:00:20,Fail to pick,428,365,0,0,0,0,0,0,0,0,False,0
2025-01-08 18:00:20,persegiMerah,465,384,145,131,70,67,70,69,0,2,True,0.4977130070670316
2025-01-08 18:00:20,persegiMerah,439,368,145,131,90,86,87,85,3,1,True,0.3594462664568929
2025-01-08 18:00:20,persegiMerah,434,362,143,132,113,37,109,33,4,4,True,0.326212089062241
2025-01-08 18:00:20,Fail to pick,434,362,0,0,0,0,0,0,0,0,False,0
2025-01-08 18:00:20,persegiMerah,436,364,143,132,150,38,150,35,0,3,True,0.25520886030289935
2025-01-08 18:00:20,Merah,436,364,tensor(143.8146),tensor(132.5242),98,40,100,37,2,3,True,0.0004990100860595703
2025-01-08 18:00:20,Fail to pick,436,364,0,0,0,0,0,0,0,0,False,0
2025-01-08 18:00:20,persegiMerah,428,369,145,135,41,94,45,92,4,2,False,0.43418899971801506
2025-01-08 18:00:20,Fail to pick,428,369,0,0,0,0,0,0,0,0,False,0
2025-01-08 18:00:20,persegiMerah,429,362,146,135,91,9,92,9,1,0,True,0.268804059234203
2025-01-08 18:00:20,Fail to pick,429,362,0,0,0,0,0,0,0,0,False,0
2025-01-08 18:00:20,persegiMerah,429,365,144,133,40,61,37,57,3,4,True,0.34848559788564926
2025-01-08 18:00:20,Fail to pick,429,365,0,0,0,0,0,0,0,0,False,0
2025-01-08 18:00:20,persegiMerah,434,360,147,133,88,80,88,82,0,2,True,0.42904107932142155
2025-01-08 18:00:20,Fail to pick,434,360,0,0,0,0,0,0,0,0,False,0
2025-01-08 18:00:20,persegiMerah,435,363,145,132,96,53,98,49,2,4,True,0.12121337278461586
2025-01-08 18:00:20,Fail to pick,435,363,0,0,0,0,0,0,0,0,False,0
2025-01-08 18:00:21,persegiMerah,439,364,143,135,94,41,89,39,5,2,False,0.3774932018194126
2025-01-08 18:00:21,Fail to pick,439,364,0,0,0,0,0,0,0,0,False,0
2025-01-08 18:00:21,persegiMerah,436,359,143,134,110,11,105,14,5,3,True,0.32812361871999407
2025-01-08 18:00:21,Fail to pick,436,359,0,0,0,0,0,0,0,0,False,0
2025-01-08 18:00:21,persegiMerah,425,364,138,135,11,85,15,85,4,0,False,0.3713783492367254
2025-01-08 18:00:21,persegiMerah,432,358,143,135,53,46,53,46,0,0,True,0.18132526112634514
2025-01-08 18:00:21,Fail to pick,432,358,0,0,0,0,0,0,0,0,False,0
2025-01-08 18:00:58,persegiBiru,349,443,125,124,66,87,61,90,5,3,True,0.3020775718372906
2025-01-08 18:00:58,Biru,349,443,tensor(125.8087),tensor(124.5825),76,32,71,27,5,5,True,0.0004994869232177734
2025-01-08 18:00:58,persegiBiru,348,444,125,122,54,82,56,86,2,4,True,0.1826674041210259
2025-01-08 18:00:58,Fail to pick,348,444,0,0,0,0,0,0,0,0,False,0
2025-01-08 18:00:59,persegiBiru,349,440,125,124,8,0,10,-4,2,4,True,0.45900740672247875
2025-01-08 18:00:59,Fail to pick,349,440,0,0,0,0,0,0,0,0,False,0
2025-01-08 18:00:59,persegiBiru,342,446,125,123,108,60,112,62,4,2,True,0.3575740478075887
2025-01-08 18:00:59,Fail to pick,342,446,0,0,0,0,0,0,0,0,False,0
2025-01-08 18:00:59,persegiBiru,335,443,125,125,156,55,157,58,1,3,True,0.10340267302068629
2025-01-08 18:00:59,Fail to pick,335,443,0,0,0,0,0,0,0,0,False,0
2025-01-08 18:00:59,persegiBiru,346,447,126,124,159,30,158,32,1,2,True,0.4690683241300475
2025-01-08 18:00:59,persegiBiru,336,447,125,126,114,80,113,82,1,2,False,0.49195573227484257
2025-01-08 18:00:59,persegiBiru,343,443,129,126,99,28,99,31,0,3,True,0.30079460766919497
2025-01-08 18:00:59,Fail to pick,343,443,0,0,0,0,0,0,0,0,False,0
2025-01-08 18:00:59,persegiBiru,339,443,128,125,100,61,95,61,5,0,False,0.3527006704272897
2025-01-08 18:00:59,Fail to pick,339,443,0,0,0,0,0,0,0,0,False,0
2025-01-08 18:00:59,persegiBiru,342,444,128,126,82,94,77,90,5,4,True,0.381215220162889
2025-01-08 18:00:59,Biru,342,444,tensor(128.9470),tensor(126.5022),76,31,74,30,2,1,True,0.0
2025-01-08 18:00:59,Fail to pick,342,444,0,0,0,0,0,0,0,0,False,0
2025-01-08 18:00:59,persegiBiru,344,445,126,124,143,5,142,2,1,3,True,0.34315036247507125
2025-01-08 18:00:59,Fail to pick,344,445,0,0,0,0,0,0,0,0,False,0
2025-01-08 18:01:00,persegiBiru,347,441,126,125,14,31,16,32,2,1,True,0.44486700431864323
2025-01-08 18:01:00,Fail to pick,347,441,0,0,0,0,0,0,0,0,False,0
2025-01-08 18:01:00,persegiBiru,344,442,126,127,63,53,66,51,3,2,True,0.21416051523844565
2025-01-08 18:01:00,Fail to pick,344,442,0,0,0,0,0,0,0,0,False,0
2025-01-08 18:01:00,persegiBiru,341,449,131,126,95,98,98,99,3,1,True,0.45509285098247076
2025-01-08 18:01:00,Fail to pick,341,449,0,0,0,0,0,0,0,0,False,0
2025-01-08 18:01:00,persegiBiru,342,446,130,124,74,47,74,49,0,2,True,0.26084414600630224
2025-01-08 18:01:00,Fail to pick,342,446,0,0,0,0,0,0,0,0,False,0
2025-01-08 18:01:00,persegiBiru,336,449,127,123,95,57,96,56,1,1,True,0.2983352414217454
2025-01-08 18:01:00,Fail to pick,336,449,0,0,0,0,0,0,0,0,False,0
2025-01-08 18:01:00,persegiBiru,340,445,129,122,184,23,185,19,1,4,True,0.24732258146844985
2025-01-08 18:01:00,Fail to pick,340,445,0,0,0,0,0,0,0,0,False,0
2025-01-08 18:01:00,persegiBiru,343,445,126,122,6,56,10,56,4,0,False,0.3786293298211528
2025-01-08 18:01:00,Fail to pick,343,445,0,0,0,0,0,0,0,0,False,0
2025-01-08 18:01:00,persegiBiru,341,444,128,122,59,94,59,98,0,4,True,0.10035863191091617
2025-01-08 18:01:00,Fail to pick,341,444,0,0,0,0,0,0,0,0,False,0
2025-01-08 18:01:00,persegiBiru,350,445,127,122,142,19,146,20,4,1,True,0.1947617234726219
2025-01-08 18:01:00,Biru,350,445,tensor(127.6061),tensor(122.4651),76,32,78,32,2,0,True,0.000499725341796875
2025-01-08 18:01:00,Fail to pick,350,445,0,0,0,0,0,0,0,0,False,0
2025-01-08 18:01:05,persegiBiru,408,402,141,134,138,8,134,6,4,2,True,0.30718170976354875
2025-01-08 18:01:05,persegiBiru,391,387,138,132,18,4,20,1,2,3,True,0.16405370142435394
2025-01-08 18:01:05,persegiBiru,393,387,137,129,20,59,15,54,5,5,True,0.23100083452046638
2025-01-08 18:01:05,Biru,393,387,tensor(137.9700),tensor(129.7902),92,36,96,36,4,0,True,0.0
2025-01-08 18:01:05,Fail to pick,393,387,0,0,0,0,0,0,0,0,False,0
2025-01-08 18:01:05,persegiBiru,354,368,136,141,188,67,183,68,5,1,True,0.12240633776953876
2025-01-08 18:01:05,persegiBiru,393,391,135,139,15,48,17,51,2,3,True,0.4736887534376696
2025-01-08 18:01:05,persegiBiru,391,388,136,134,29,63,31,62,2,1,True,0.21643881959411515
2025-01-08 18:01:05,Fail to pick,391,388,0,0,0,0,0,0,0,0,False,0
2025-01-08 18:01:06,persegiBiru,391,396,140,135,42,85,40,89,2,4,True,0.2153096034205234
2025-01-08 18:01:06,Fail to pick,391,396,0,0,0,0,0,0,0,0,False,0
2025-01-08 18:01:06,persegiBiru,391,390,139,134,90,35,92,31,2,4,True,0.36550710835128686
2025-01-08 18:01:06,Fail to pick,391,390,0,0,0,0,0,0,0,0,False,0
2025-01-08 18:01:06,persegiBiru,395,399,132,129,24,19,22,14,2,5,True,0.20082670323067775
2025-01-08 18:01:06,Fail to pick,395,399,0,0,0,0,0,0,0,0,False,0
2025-01-08 18:01:06,persegiBiru,384,393,136,136,75,36,76,32,1,4,True,0.4282640460711836
2025-01-08 18:01:06,persegiBiru,399,387,136,130,152,49,154,45,2,4,True,0.40788333940919286
2025-01-08 18:01:06,persegiBiru,392,390,136,132,57,10,53,5,4,5,True,0.4621080384843683
2025-01-08 18:01:06,Biru,392,390,tensor(136.3157),tensor(132.2728),91,36,90,40,1,4,True,0.0005004405975341797
2025-01-08 18:01:06,Fail to pick,392,390,0,0,0,0,0,0,0,0,False,0
2025-01-08 18:01:06,persegiBiru,387,386,136,134,105,66,104,63,1,3,True,0.21381077327445117
2025-01-08 18:01:06,Fail to pick,387,386,0,0,0,0,0,0,0,0,False,0
2025-01-08 18:01:06,persegiBiru,381,387,131,132,108,51,110,46,2,5,True,0.36892530309834015
2025-01-08 18:01:06,Fail to pick,381,387,0,0,0,0,0,0,0,0,False,0
2025-01-08 18:01:07,persegiBiru,389,388,135,131,82,66,79,66,3,0,True,0.3932660169414629
2025-01-08 18:01:07,Fail to pick,389,388,0,0,0,0,0,0,0,0,False,0
2025-01-08 18:01:07,persegiBiru,392,388,133,133,32,66,35,68,3,2,True,0.431962161734745
2025-01-08 18:01:07,Fail to pick,392,388,0,0,0,0,0,0,0,0,False,0
2025-01-08 18:01:07,persegiBiru,410,421,137,129,40,61,35,65,5,4,True,0.4710634027065729
2025-01-08 18:01:07,persegiBiru,358,437,145,128,141,94,139,89,2,5,False,0.4848453148110584
2025-01-08 18:01:07,persegiBiru,392,389,135,130,99,24,102,26,3,2,True,0.10075937848034831
2025-01-08 18:01:07,persegiBiru,391,392,135,131,132,87,134,91,2,4,False,0.2563088101067017
2025-01-08 18:01:07,Fail to pick,391,392,0,0,0,0,0,0,0,0,False,0
2025-01-08 18:01:07,persegiBiru,380,395,132,132,153,9,156,6,3,3,True,0.30634635052071035
2025-01-08 18:01:07,Biru,380,395,tensor(132.7366),tensor(132.5649),90,35,86,39,4,4,True,0.0
2025-01-08 18:01:07,persegiBiru,365,410,135,131,183,48,184,52,1,4,False,0.3173478146121277
2025-01-08 18:01:08,persegiBiru,390,381,137,141,111,66,108,68,3,2,True,0.32131839639286763
2025-01-08 18:01:08,persegiBiru,368,449,145,130,156,78,157,82,1,4,False,0.3360319835222755
2025-01-08 18:01:16,persegiHijau,853,305,120,125,61,5,56,3,5,2,True,0.1291169601203148
2025-01-08 18:01:16,Hijau,853,305,tensor(120.1227),tensor(125.2664),115,78,118,81,3,3,True,0.0
2025-01-08 18:01:16,persegiHijau,879,335,116,119,145,30,149,31,4,1,True,0.2956544833456102
2025-01-08 18:01:17,persegiHijau,864,340,121,120,84,48,80,50,4,2,True,0.290826203818778
2025-01-08 18:01:17,persegiHijau,802,289,115,120,23,24,19,22,4,2,True,0.48572614242587864
2025-01-08 18:01:17,persegiHijau,829,308,113,118,136,30,137,33,1,3,True,0.2150372278283449
2025-01-08 18:01:17,persegiHijau,856,317,118,121,147,63,150,58,3,5,True,0.3431564495093852
2025-01-08 18:01:17,persegiHijau,865,322,122,118,20,62,18,61,2,1,True,0.3570994823726994
2025-01-08 18:01:17,Fail to pick,865,322,0,0,0,0,0,0,0,0,False,0
2025-01-08 18:01:17,persegiHijau,868,332,116,118,186,31,184,28,2,3,True,0.2912355281300977
2025-01-08 18:01:17,persegiHijau,870,314,118,119,186,30,184,26,2,4,True,0.12731343283271046
2025-01-08 18:01:17,persegiHijau,870,321,123,121,21,68,24,63,3,5,True,0.4615492515982048
2025-01-08 18:01:17,Fail to pick,870,321,0,0,0,0,0,0,0,0,False,0
2025-01-08 18:01:17,persegiHijau,844,313,119,118,106,77,108,76,2,1,True,0.37947960566622674
2025-01-08 18:01:17,Hijau,844,313,tensor(119.2469),tensor(118.3546),113,78,109,81,4,3,True,0.0
2025-01-08 18:01:18,persegiHijau,830,311,112,116,138,23,142,22,4,1,False,0.1872112117966377
2025-01-08 18:01:18,persegiHijau,847,304,121,125,27,73,31,77,4,4,True,0.4405551594649161
2025-01-08 18:01:18,persegiHijau,869,326,118,119,149,63,149,67,0,4,True,0.3960453645505516
2025-01-08 18:01:18,persegiHijau,857,301,118,124,6,39,6,43,0,4,True,0.19775126787215092
2025-01-08 18:01:18,persegiHijau,845,310,118,116,130,99,127,98,3,1,True,0.45685872542845285
2025-01-08 18:01:18,persegiHijau,817,301,114,118,128,19,124,16,4,3,True,0.19898970085821022
2025-01-08 18:01:18,persegiHijau,866,332,117,120,53,28,55,30,2,2,True,0.3635960564488995
2025-01-08 18:01:18,persegiHijau,854,303,116,127,196,84,200,81,4,3,True,0.202915546471917
2025-01-08 18:01:18,persegiHijau,865,311,115,123,68,32,69,27,1,5,False,0.17104459975209924
2025-01-08 18:01:18,Hijau,865,311,tensor(115.2773),tensor(123.8332),113,80,110,76,3,4,True,0.0
2025-01-08 18:01:19,persegiHijau,853,306,121,125,133,51,135,51,2,0,True,0.2022172106368348
2025-01-08 18:01:19,persegiHijau,852,308,121,123,88,51,92,54,4,3,False,0.2811852662456169
2025-01-08 18:01:19,Fail to pick,852,308,0,0,0,0,0,0,0,0,False,0
2025-01-08 18:01:19,persegiHijau,821,313,119,119,67,82,62,77,5,5,True,0.4566977388505927
2025-01-08 18:01:19,persegiHijau,848,313,114,119,193,88,195,85,2,3,True,0.13096758291162094
2025-01-08 18:01:19,persegiHijau,823,309,116,117,198,81,201,79,3,2,True,0.44421407583463257
2025-01-08 18:01:19,persegiHijau,849,307,117,122,4,49,3,48,1,1,True,0.3352175984769917
2025-01-08 18:01:19,persegiHijau,827,301,109,120,150,69,148,72,2,3,True,0.22759458875160188
2025-01-08 18:01:19,persegiHijau,849,296,127,126,179,21,181,24,2,3,True,0.20836493308527695
2025-01-08 18:01:19,persegiHijau,845,311,118,122,156,78,151,75,5,3,True,0.15064243180188003
2025-01-08 18:01:20,persegiHijau,825,301,114,119,5,51,4,49,1,2,True,0.46147976704300775
2025-01-08 18:01:20,persegiHijau,820,276,123,132,57,88,55,83,2,5,True,0.2754119324147531
2025-01-08 18:01:20,Hijau,820,276,tensor(123.1434),tensor(132.9448),123,75,121,77,2,2,True,0.0
2025-01-08 18:01:20,persegiHijau,850,300,122,124,98,69,101,70,3,1,True,0.21990470076116583
2025-01-08 18:01:20,persegiHijau,841,312,113,120,168,10,169,8,1,2,True,0.2315514732916241
2025-01-08 18:01:20,persegiHijau,849,306,122,120,151,32,146,31,5,1,True,0.12454548552958898
2025-01-08 18:01:20,Fail to pick,849,306,0,0,0,0,0,0,0,0,False,0
2025-01-08 18:01:20,persegiHijau,848,303,121,124,163,86,162,86,1,0,True,0.3096381860366103
2025-01-08 18:01:20,Fail to pick,848,303,0,0,0,0,0,0,0,0,False,0
2025-01-08 18:01:20,persegiHijau,846,305,118,123,117,63,115,59,2,4,True,0.3572693327138937
2025-01-08 18:01:20,Fail to pick,846,305,0,0,0,0,0,0,0,0,False,0
2025-01-08 18:01:20,persegiHijau,844,305,120,124,33,39,33,37,0,2,True,0.10624983632160881
2025-01-08 18:01:20,Fail to pick,844,305,0,0,0,0,0,0,0,0,False,0
2025-01-08 18:01:20,persegiHijau,853,317,122,128,46,9,41,9,5,0,True,0.21766145445763213
2025-01-08 18:01:21,persegiHijau,854,297,123,125,113,6,113,1,0,5,False,0.35670645956154357
2025-01-08 18:01:21,persegiHijau,849,307,118,118,170,93,165,97,5,4,True,0.26740131509521936
2025-01-08 18:01:21,Hijau,849,307,tensor(118.0914),tensor(118.8824),114,78,115,81,1,3,True,0.000591278076171875
2025-01-08 18:01:21,persegiHijau,860,318,120,123,53,84,55,81,2,3,True,0.21173911677527402
2025-01-08 18:01:21,persegiHijau,849,304,122,122,28,29,30,32,2,3,False,0.31063156263836433
2025-01-08 18:01:21,persegiHijau,842,306,119,127,198,3,198,-2,0,5,True,0.1402894749676259
2025-01-08 18:01:21,Fail to pick,842,306,0,0,0,0,0,0,0,0,False,0
2025-01-08 18:01:21,persegiHijau,848,305,123,125,52,75,51,70,1,5,True,0.1373451872327952
2025-01-08 18:01:21,Fail to pick,848,305,0,0,0,0,0,0,0,0,False,0
2025-01-08 18:01:21,persegiHijau,842,313,121,122,23,30,24,25,1,5,True,0.21797904988986222
2025-01-08 18:01:21,Fail to pick,842,313,0,0,0,0,0,0,0,0,False,0
2025-01-08 18:01:21,persegiHijau,845,308,120,119,21,84,19,79,2,5,True,0.26178796963993906
2025-01-08 18:01:21,Fail to pick,845,308,0,0,0,0,0,0,0,0,False,0
2025-01-08 18:01:21,persegiHijau,851,301,122,124,164,87,168,83,4,4,False,0.1781633162249343
2025-01-08 18:01:21,Fail to pick,851,301,0,0,0,0,0,0,0,0,False,0
2025-01-08 18:01:22,persegiHijau,849,303,123,128,92,11,95,13,3,2,True,0.3549014077453835
2025-01-08 18:01:22,Fail to pick,849,303,0,0,0,0,0,0,0,0,False,0
2025-01-08 18:01:22,persegiHijau,859,306,119,125,83,62,81,63,2,1,True,0.1435577245600925
2025-01-08 18:01:22,persegiHijau,852,297,119,128,41,79,39,81,2,2,True,0.1040914298181805
2025-01-08 18:01:22,Hijau,852,297,tensor(119.1461),tensor(128.2509),117,78,117,81,0,3,True,0.00049591064453125
2025-01-08 18:01:22,Fail to pick,852,297,0,0,0,0,0,0,0,0,False,0
2025-01-08 18:01:22,persegiHijau,845,305,121,127,72,1,73,0,1,1,True,0.44029844320812006
2025-01-08 18:01:22,Fail to pick,845,305,0,0,0,0,0,0,0,0,False,0
2025-01-08 18:01:22,persegiHijau,853,311,117,124,13,16,12,14,1,2,True,0.30674318979124016
2025-01-08 18:01:22,Fail to pick,853,311,0,0,0,0,0,0,0,0,False,0
2025-01-08 18:01:22,persegiHijau,856,319,117,123,44,36,39,32,5,4,False,0.26710157875283325
2025-01-08 18:01:22,Fail to pick,856,319,0,0,0,0,0,0,0,0,False,0
2025-01-08 18:01:22,persegiHijau,864,331,120,118,11,24,11,27,0,3,True,0.48545597921033323
2025-01-08 18:01:22,persegiHijau,872,324,123,121,16,63,15,67,1,4,True,0.4792895732238748
2025-01-08 18:01:22,Fail to pick,872,324,0,0,0,0,0,0,0,0,False,0
2025-01-08 18:01:22,persegiHijau,847,298,121,126,144,28,146,26,2,2,True,0.2653954730432438
2025-01-08 18:01:23,persegiHijau,838,304,119,126,94,98,98,96,4,2,True,0.1353767916757308
2025-01-08 18:01:23,Fail to pick,838,304,0,0,0,0,0,0,0,0,False,0
2025-01-08 18:01:23,persegiHijau,842,306,120,122,81,49,79,53,2,4,False,0.20215686466784988
2025-01-08 18:01:23,Fail to pick,842,306,0,0,0,0,0,0,0,0,False,0
2025-01-08 18:01:23,persegiHijau,845,305,121,124,168,39,168,40,0,1,True,0.4711254207383081
2025-01-08 18:01:23,Fail to pick,845,305,0,0,0,0,0,0,0,0,False,0
2025-01-08 18:01:23,persegiHijau,844,307,120,121,193,64,192,62,1,2,True,0.14602641936340235
2025-01-08 18:01:23,Hijau,844,307,tensor(120.0124),tensor(121.4085),114,78,112,73,2,5,True,0.0004994869232177734
2025-01-08 18:01:23,Fail to pick,844,307,0,0,0,0,0,0,0,0,False,0
2025-01-08 18:01:23,persegiHijau,840,311,119,122,17,28,15,27,2,1,True,0.25713471446477165
2025-01-08 18:01:23,Fail to pick,840,311,0,0,0,0,0,0,0,0,False,0
2025-01-08 18:01:23,persegiHijau,876,310,125,121,32,74,32,70,0,4,True,0.39019046121646717
2025-01-08 18:01:24,persegiHijau,907,476,117,111,197,95,200,92,3,3,True,0.19624047189466487
2025-01-08 18:01:24,persegiHijau,873,442,122,119,52,10,52,13,0,3,True,0.12066242538785771
2025-01-08 18:01:24,persegiHijau,870,435,127,121,33,25,32,23,1,2,True,0.2642083069826472
2025-01-08 18:01:24,Hijau,870,435,tensor(127.7259),tensor(121.7890),79,80,80,75,1,5,True,0.0
2025-01-08 18:01:24,Fail to pick,870,435,0,0,0,0,0,0,0,0,False,0
2025-01-08 18:01:24,persegiHijau,869,438,124,123,87,55,89,55,2,0,True,0.3941386863427916
2025-01-08 18:01:24,Fail to pick,869,438,0,0,0,0,0,0,0,0,False,0
2025-01-08 18:01:24,persegiHijau,839,407,128,130,185,42,187,43,2,1,True,0.4520502796019913
2025-01-08 18:01:24,persegiHijau,846,414,134,127,199,52,194,51,5,1,True,0.37543703795507033
2025-01-08 18:01:24,Fail to pick,846,414,0,0,0,0,0,0,0,0,False,0
2025-01-08 18:01:24,persegiHijau,869,438,124,124,171,14,174,9,3,5,True,0.35858729675333356
2025-01-08 18:01:24,persegiHijau,871,444,123,119,36,5,35,1,1,4,True,0.2136081028465275
2025-01-08 18:01:24,Fail to pick,871,444,0,0,0,0,0,0,0,0,False,0
2025-01-08 18:01:25,persegiHijau,868,453,124,119,172,32,176,30,4,2,True,0.37808714245232744
2025-01-08 18:01:25,Fail to pick,868,453,0,0,0,0,0,0,0,0,False,0
2025-01-08 18:01:25,persegiHijau,865,435,123,122,171,48,174,44,3,4,True,0.35264672680910913
2025-01-08 18:01:25,persegiHijau,869,438,128,125,98,62,98,64,0,2,True,0.4997201305616725
2025-01-08 18:01:25,Fail to pick,869,438,0,0,0,0,0,0,0,0,False,0
2025-01-08 18:01:25,persegiHijau,865,435,125,119,9,16,7,13,2,3,True,0.25911179546777485
2025-01-08 18:01:25,Fail to pick,865,435,0,0,0,0,0,0,0,0,False,0
2025-01-08 18:01:25,persegiHijau,864,437,123,119,119,79,122,81,3,2,True,0.3171933616706034
2025-01-08 18:01:25,Hijau,864,437,tensor(123.6695),tensor(119.8668),78,80,77,78,1,2,True,0.0
2025-01-08 18:01:25,Fail to pick,864,437,0,0,0,0,0,0,0,0,False,0
2025-01-08 18:01:25,persegiHijau,884,448,124,119,131,64,129,64,2,0,True,0.2913287817833424
2025-01-08 18:01:25,persegiHijau,877,453,121,118,144,80,143,81,1,1,True,0.20592433844333985
2025-01-08 18:01:25,Fail to pick,877,453,0,0,0,0,0,0,0,0,False,0
2025-01-08 18:01:25,persegiHijau,890,463,115,117,153,91,148,94,5,3,True,0.244531745465993
2025-01-08 18:01:25,persegiHijau,864,441,118,119,78,58,74,54,4,4,True,0.4210901265750947
2025-01-08 18:01:25,persegiHijau,875,437,125,121,10,78,9,73,1,5,False,0.253327816587349
2025-01-08 18:01:26,persegiHijau,880,436,122,120,112,85,109,85,3,0,True,0.16422562051410644
2025-01-08 18:01:26,Fail to pick,880,436,0,0,0,0,0,0,0,0,False,0
2025-01-08 18:01:26,persegiHijau,863,440,127,123,114,28,114,26,0,2,True,0.26750134931055003
2025-01-08 18:01:26,persegiHijau,866,443,118,121,108,71,108,75,0,4,True,0.2561667693983485
2025-01-08 18:01:26,Fail to pick,866,443,0,0,0,0,0,0,0,0,False,0
2025-01-08 18:01:26,persegiHijau,878,439,118,124,95,76,93,78,2,2,True,0.13520489123846036
2025-01-08 18:01:26,persegiHijau,894,458,122,116,46,88,43,91,3,3,True,0.19120575659086217
2025-01-08 18:01:26,persegiHijau,865,441,122,124,182,87,183,87,1,0,True,0.49245503892014464
2025-01-08 18:01:26,Hijau,865,441,tensor(122.3250),tensor(124.4429),77,80,81,82,4,2,True,0.0004990100860595703
2025-01-08 18:01:26,persegiHijau,882,456,114,121,177,87,179,87,2,0,True,0.40514601462390554
2025-01-08 18:01:26,persegiHijau,880,452,118,123,52,95,49,92,3,3,True,0.24905364846888603
2025-01-08 18:01:26,Fail to pick,880,452,0,0,0,0,0,0,0,0,False,0
2025-01-08 18:01:27,persegiHijau,831,403,125,136,191,57,187,60,4,3,True,0.377954928130796
2025-01-08 18:01:27,persegiHijau,836,416,124,131,181,30,181,28,0,2,True,0.46396155965014285
2025-01-08 18:01:27,persegiHijau,882,456,115,119,87,60,86,59,1,1,True,0.36985233900066083
2025-01-08 18:01:27,persegiHijau,882,452,120,122,48,12,48,13,0,1,True,0.2560321591495456
2025-01-08 18:01:27,Fail to pick,882,452,0,0,0,0,0,0,0,0,False,0
2025-01-08 18:01:27,persegiHijau,827,399,130,134,60,64,56,66,4,2,True,0.11563059636636203
2025-01-08 18:01:27,persegiHijau,884,456,118,121,53,85,55,82,2,3,True,0.24895991046734875
2025-01-08 18:01:27,persegiHijau,863,440,123,121,130,28,125,24,5,4,False,0.2017027137945239
2025-01-08 18:01:27,persegiHijau,856,444,128,124,58,26,57,22,1,4,True,0.4426119693577958
2025-01-08 18:01:27,Hijau,856,444,tensor(128.3716),tensor(124.6039),76,79,79,80,3,1,True,0.0004990100860595703
2025-01-08 18:01:27,Fail to pick,856,444,0,0,0,0,0,0,0,0,False,0
2025-01-08 18:01:27,persegiHijau,870,456,124,121,68,81,68,81,0,0,True,0.49136324693919065
2025-01-08 18:01:27,persegiHijau,859,440,123,125,129,32,132,29,3,3,False,0.3670681198236223
2025-01-08 18:01:28,persegiHijau,867,439,122,125,196,43,197,39,1,4,True,0.19218415195156693
2025-01-08 18:01:28,Fail to pick,867,439,0,0,0,0,0,0,0,0,False,0
2025-01-08 18:01:28,persegiHijau,866,440,119,119,76,85,79,89,3,4,True,0.45641381261277547
2025-01-08 18:01:28,Fail to pick,866,440,0,0,0,0,0,0,0,0,False,0
2025-01-08 18:01:28,persegiHijau,859,441,119,123,156,93,156,89,0,4,True,0.280732413089948
2025-01-08 18:01:28,Fail to pick,859,441,0,0,0,0,0,0,0,0,False,0
2025-01-08 18:01:28,persegiHijau,868,444,127,125,41,40,43,36,2,4,True,0.4671530273655503
2025-01-08 18:01:28,Fail to pick,868,444,0,0,0,0,0,0,0,0,False,0
2025-01-08 18:01:28,persegiHijau,835,408,124,132,169,25,165,22,4,3,True,0.11803181110427832
2025-01-08 18:01:28,persegiHijau,872,441,118,121,189,62,192,60,3,2,True,0.33799901402017307
2025-01-08 18:01:28,persegiHijau,867,444,123,126,131,50,134,53,3,3,True,0.170680048076449
2025-01-08 18:01:28,Fail to pick,867,444,0,0,0,0,0,0,0,0,False,0
2025-01-08 18:01:28,persegiHijau,865,445,124,124,197,29,197,25,0,4,True,0.36243843707545287
2025-01-08 18:01:28,Fail to pick,865,445,0,0,0,0,0,0,0,0,False,0
2025-01-08 18:01:28,persegiHijau,862,449,124,119,116,41,112,40,4,1,True,0.27775818541419117
2025-01-08 18:01:28,Fail to pick,862,449,0,0,0,0,0,0,0,0,False,0
2025-01-08 18:01:29,persegiHijau,873,441,126,122,49,29,51,24,2,5,True,0.32244675586146576
2025-01-08 18:01:29,Hijau,873,441,tensor(126.2728),tensor(122.2509),77,80,72,83,5,3,True,0.0004987716674804688
2025-01-08 18:01:29,persegiHijau,876,454,119,121,50,48,54,51,4,3,True,0.3014385419477409
2025-01-08 18:01:29,persegiHijau,890,460,119,120,164,29,164,28,0,1,True,0.4907083911732374
2025-01-08 18:01:29,persegiHijau,883,449,122,121,198,2,197,-3,1,5,True,0.13829062191326372
2025-01-08 18:01:29,persegiHijau,830,409,129,130,24,60,23,58,1,2,True,0.3715089377654758
2025-01-08 18:01:29,persegiHijau,867,441,125,127,186,30,184,29,2,1,True,0.4230613447385142
2025-01-08 18:01:29,persegiHijau,877,452,120,120,12,76,16,76,4,0,True,0.11090692479034114
2025-01-08 18:01:29,persegiHijau,869,437,124,125,24,21,20,24,4,3,True,0.37319938984746026
2025-01-08 18:01:29,persegiHijau,866,443,120,120,123,76,121,71,2,5,False,0.4847769348843799
2025-01-08 18:01:29,Fail to pick,866,443,0,0,0,0,0,0,0,0,False,0
2025-01-08 18:01:30,persegiHijau,820,397,129,134,4,74,4,77,0,3,False,0.35132554995258436
2025-01-08 18:01:30,persegiHijau,859,445,121,124,12,70,15,71,3,1,True,0.2927787968842621
2025-01-08 18:01:30,Hijau,859,445,tensor(121.2957),tensor(124.8323),76,79,73,79,3,0,True,0.0004961490631103516
2025-01-08 18:01:30,persegiHijau,843,413,127,131,57,24,57,24,0,0,True,0.4859976211176772
2025-01-08 18:01:30,persegiHijau,869,445,123,120,180,52,183,56,3,4,True,0.22996303509720462
2025-01-08 18:01:30,persegiHijau,867,440,123,121,19,45,15,42,4,3,True,0.18252334268307915
2025-01-08 18:01:30,Fail to pick,867,440,0,0,0,0,0,0,0,0,False,0
2025-01-08 18:01:30,persegiHijau,863,443,123,122,156,90,156,92,0,2,False,0.48595289847424494
2025-01-08 18:01:30,Fail to pick,863,443,0,0,0,0,0,0,0,0,False,0
2025-01-08 18:01:30,persegiHijau,843,420,124,131,93,20,90,22,3,2,True,0.42616790648742686
2025-01-08 18:01:30,persegiHijau,871,442,122,123,32,88,27,89,5,1,True,0.15650039871851337
2025-01-08 18:01:30,persegiHijau,863,447,123,121,103,17,101,17,2,0,False,0.25136889632757
2025-01-08 18:01:30,Fail to pick,863,447,0,0,0,0,0,0,0,0,False,0
2025-01-08 18:01:31,persegiHijau,857,444,123,123,68,90,70,86,2,4,True,0.17006336936869793
2025-01-08 18:01:31,Fail to pick,857,444,0,0,0,0,0,0,0,0,False,0
2025-01-08 18:01:31,persegiHijau,868,445,126,124,151,46,155,44,4,2,False,0.3468009934037493
2025-01-08 18:01:31,persegiHijau,860,446,122,121,136,87,140,89,4,2,True,0.38885328716467826
2025-01-08 18:01:31,Hijau,860,446,tensor(122.7370),tensor(121.7249),76,79,72,74,4,5,True,0.0004999637603759766
2025-01-08 18:01:31,Fail to pick,860,446,0,0,0,0,0,0,0,0,False,0
2025-01-08 18:01:31,persegiHijau,834,410,125,131,70,53,65,49,5,4,True,0.35004344604154747
2025-01-08 18:01:31,persegiHijau,871,444,123,122,195,39,197,41,2,2,True,0.33932061511299805
2025-01-08 18:01:31,persegiHijau,868,455,118,122,192,12,187,15,5,3,True,0.34901014810125597
2025-01-08 18:01:31,persegiHijau,864,441,121,126,155,70,153,71,2,1,True,0.33857442054564896
2025-01-08 18:01:31,persegiHijau,864,442,122,127,83,73,82,70,1,3,True,0.21609912958496957
2025-01-08 18:01:31,Fail to pick,864,442,0,0,0,0,0,0,0,0,False,0
2025-01-08 18:01:32,persegiHijau,868,445,121,122,125,88,123,85,2,3,False,0.40829918172772994
2025-01-08 18:01:32,Fail to pick,868,445,0,0,0,0,0,0,0,0,False,0
2025-01-08 18:01:32,persegiHijau,888,459,117,121,144,38,141,35,3,3,True,0.1128541686279267
2025-01-08 18:01:32,persegiHijau,888,459,117,121,112,64,108,67,4,3,True,0.13653974837796665
2025-01-08 18:01:32,Fail to pick,888,459,0,0,0,0,0,0,0,0,False,0
2025-01-08 18:01:32,persegiHijau,869,440,124,122,173,74,176,75,3,1,True,0.11507079979602773
2025-01-08 18:01:32,Hijau,869,440,tensor(124.1758),tensor(122.0463),77,80,81,80,4,0,True,0.0
2025-01-08 18:01:32,persegiHijau,878,436,127,121,95,97,97,98,2,1,True,0.24622457148147633
2025-01-08 18:01:32,Fail to pick,878,436,0,0,0,0,0,0,0,0,False,0
2025-01-08 18:01:32,persegiHijau,875,436,126,123,49,28,49,23,0,5,True,0.11780406880055289
2025-01-08 18:01:32,Fail to pick,875,436,0,0,0,0,0,0,0,0,False,0
2025-01-08 18:01:32,persegiHijau,876,435,129,122,22,98,17,102,5,4,True,0.4165629163014678
2025-01-08 18:01:32,Fail to pick,876,435,0,0,0,0,0,0,0,0,False,0
2025-01-08 18:01:32,persegiHijau,874,436,128,123,73,48,72,51,1,3,True,0.4138268535267079
2025-01-08 18:01:32,Fail to pick,874,436,0,0,0,0,0,0,0,0,False,0
2025-01-08 18:01:32,persegiHijau,872,440,122,122,84,69,81,70,3,1,True,0.2380563576165071
2025-01-08 18:01:32,Fail to pick,872,440,0,0,0,0,0,0,0,0,False,0
2025-01-08 18:01:33,persegiHijau,874,441,127,123,160,36,161,36,1,0,True,0.3351709972998873
2025-01-08 18:01:33,Fail to pick,874,441,0,0,0,0,0,0,0,0,False,0
2025-01-08 18:01:33,persegiHijau,871,441,128,121,121,19,116,17,5,2,False,0.4976883081271479
2025-01-08 18:01:33,Fail to pick,871,441,0,0,0,0,0,0,0,0,False,0
2025-01-08 18:01:33,persegiHijau,873,439,125,124,57,40,54,42,3,2,True,0.29958237078610306
2025-01-08 18:01:33,Fail to pick,873,439,0,0,0,0,0,0,0,0,False,0
2025-01-08 18:01:33,persegiHijau,890,455,125,121,34,12,35,8,1,4,True,0.3005546961119653
2025-01-08 18:01:33,persegiHijau,812,400,130,134,0,97,-2,92,2,5,True,0.39172103975820904
2025-01-08 18:01:33,persegiHijau,870,444,121,121,121,7,117,4,4,3,True,0.3914611435814662
2025-01-08 18:01:33,Hijau,870,444,tensor(121.2985),tensor(121.3697),76,80,77,77,1,3,True,0.0004994869232177734
2025-01-08 18:01:33,persegiHijau,858,449,122,121,66,43,66,43,0,0,True,0.2633659544514908
2025-01-08 18:01:33,persegiHijau,879,445,122,123,190,96,187,100,3,4,True,0.4029813469669393
2025-01-08 18:01:34,persegiHijau,863,442,120,122,174,3,178,7,4,4,True,0.2727372807839089
2025-01-08 18:01:34,persegiHijau,827,409,131,133,143,10,145,10,2,0,True,0.310444815258387
2025-01-08 18:01:34,persegiHijau,874,445,121,122,164,21,162,22,2,1,True,0.2758825308109767
2025-01-08 18:01:34,persegiHijau,817,394,130,135,135,87,131,88,4,1,True,0.236464839327596
2025-01-08 18:01:34,persegiHijau,885,457,118,121,35,23,33,20,2,3,True,0.23183963097126045
2025-01-08 18:01:34,persegiHijau,894,464,118,116,79,97,79,100,0,3,True,0.43406402373753605
2025-01-08 18:01:34,Hijau,894,464,tensor(118.8995),tensor(116.6385),71,82,72,80,1,2,True,0.0
2025-01-08 18:01:34,Fail to pick,894,464,0,0,0,0,0,0,0,0,False,0
2025-01-08 18:01:35,persegiHijau,862,178,136,143,92,4,87,-1,5,5,True,0.3484810460043122
2025-01-08 18:01:35,persegiHijau,874,181,145,139,147,48,150,43,3,5,True,0.45565975835043704
2025-01-08 18:01:35,persegiHijau,831,150,140,143,14,45,16,41,2,4,True,0.22564300441735435
2025-01-08 18:01:35,persegiHijau,838,139,151,143,92,32,96,33,4,1,True,0.4865664161725082
2025-01-08 18:01:35,persegiHijau,833,143,142,142,120,89,118,90,2,1,True,0.4649527286598487
2025-01-08 18:01:35,Hijau,833,143,tensor(142.7932),tensor(142.5400),160,77,160,81,0,4,True,0.0
2025-01-08 18:01:35,Fail to pick,833,143,0,0,0,0,0,0,0,0,False,0
2025-01-08 18:01:35,persegiHijau,827,138,142,143,7,66,6,66,1,0,True,0.4631202721004164
2025-01-08 18:01:35,Fail to pick,827,138,0,0,0,0,0,0,0,0,False,0
2025-01-08 18:01:35,persegiHijau,830,147,145,142,103,90,103,85,0,5,True,0.4067908760489858
2025-01-08 18:01:35,Fail to pick,830,147,0,0,0,0,0,0,0,0,False,0
2025-01-08 18:01:35,persegiHijau,826,145,137,139,154,40,151,38,3,2,True,0.46629532797341644
2025-01-08 18:01:35,Fail to pick,826,145,0,0,0,0,0,0,0,0,False,0
2025-01-08 18:01:36,persegiHijau,830,147,143,140,85,34,87,38,2,4,True,0.40521979308399525
2025-01-08 18:01:36,Fail to pick,830,147,0,0,0,0,0,0,0,0,False,0
2025-01-08 18:01:36,persegiHijau,831,146,145,143,137,86,141,85,4,1,True,0.1513197078509203
2025-01-08 18:01:36,Fail to pick,831,146,0,0,0,0,0,0,0,0,False,0
2025-01-08 18:01:36,persegiHijau,828,142,143,140,185,4,180,5,5,1,False,0.23550681691955058
2025-01-08 18:01:36,Fail to pick,828,142,0,0,0,0,0,0,0,0,False,0
2025-01-08 18:01:36,persegiHijau,824,146,143,146,161,56,156,51,5,5,True,0.4941212720406043
2025-01-08 18:01:36,Fail to pick,824,146,0,0,0,0,0,0,0,0,False,0
2025-01-08 18:01:36,persegiHijau,832,143,142,145,154,44,151,47,3,3,True,0.132552530486453
2025-01-08 18:01:36,Fail to pick,832,143,0,0,0,0,0,0,0,0,False,0
2025-01-08 18:01:36,persegiHijau,827,136,142,152,99,27,94,28,5,1,True,0.18839828136667527
2025-01-08 18:01:36,Fail to pick,827,136,0,0,0,0,0,0,0,0,False,0
2025-01-08 18:01:36,persegiHijau,851,168,135,140,50,36,51,38,1,2,True,0.32219941054059636
2025-01-08 18:01:36,Hijau,851,168,tensor(135.5492),tensor(140.2548),153,78,149,75,4,3,True,0.0
2025-01-08 18:01:36,persegiHijau,835,139,144,145,62,70,59,73,3,3,True,0.3289689076794078
2025-01-08 18:01:36,persegiHijau,834,147,143,140,79,12,81,15,2,3,True,0.4438979869601386
2025-01-08 18:01:36,Fail to pick,834,147,0,0,0,0,0,0,0,0,False,0
2025-01-08 18:01:37,segienamHijau,834,145,127,130,71,27,69,28,2,1,True,0.1446585011671885
2025-01-08 18:01:37,Fail to pick,834,145,0,0,0,0,0,0,0,0,False,0
2025-01-08 18:01:38,persegiHijau,449,129,128,135,158,93,153,96,5,3,True,0.2172568949715764
2025-01-08 18:01:38,Hijau,449,129,tensor(128.5352),tensor(135.3520),164,41,161,45,3,4,True,0.0
2025-01-08 18:01:38,persegiHijau,450,118,129,134,194,27,193,25,1,2,True,0.1071314595094151
2025-01-08 18:01:38,persegiHijau,447,123,130,135,191,26,186,30,5,4,True,0.17366155944674583
2025-01-08 18:01:38,Fail to pick,447,123,0,0,0,0,0,0,0,0,False,0
2025-01-08 18:01:38,persegiHijau,422,94,130,139,151,92,149,94,2,2,True,0.31902109530046896
2025-01-08 18:01:39,persegiHijau,451,117,134,145,122,47,122,42,0,5,True,0.2671108546133858
2025-01-08 18:01:39,Hijau,451,117,tensor(134.0389),tensor(145.1244),167,41,168,38,1,3,True,0.0
2025-01-08 18:01:39,persegiHijau,388,73,125,139,15,62,10,61,5,1,True,0.3181331731874184
2025-01-08 18:01:39,persegiHijau,386,70,123,140,115,12,112,12,3,0,False,0.4821176674801687
2025-01-08 18:01:39,Fail to pick,386,70,0,0,0,0,0,0,0,0,False,0
2025-01-08 18:01:39,persegiHijau,416,103,127,136,102,43,104,41,2,2,True,0.30433278695318244
2025-01-08 18:01:39,persegiHijau,424,103,130,138,182,52,180,51,2,1,True,0.4185519221065823
2025-01-08 18:01:39,Fail to pick,424,103,0,0,0,0,0,0,0,0,False,0
2025-01-08 18:01:39,persegiHijau,430,102,126,139,172,94,175,94,3,0,True,0.320933753243144
2025-01-08 18:01:39,Fail to pick,430,102,0,0,0,0,0,0,0,0,False,0
2025-01-08 18:01:39,persegiHijau,424,104,126,138,31,16,29,20,2,4,True,0.3871535521138231
2025-01-08 18:01:39,Fail to pick,424,104,0,0,0,0,0,0,0,0,False,0
2025-01-08 18:01:39,persegiHijau,426,99,128,140,3,7,7,3,4,4,True,0.36727292086556684
2025-01-08 18:01:39,Fail to pick,426,99,0,0,0,0,0,0,0,0,False,0
2025-01-08 18:01:39,persegiHijau,422,108,127,137,163,60,158,62,5,2,True,0.282775133036838
2025-01-08 18:01:39,Fail to pick,422,108,0,0,0,0,0,0,0,0,False,0
2025-01-08 18:01:40,persegiHijau,398,95,115,139,94,16,91,14,3,2,False,0.22638486741138286
2025-01-08 18:01:40,persegiHijau,416,104,125,138,17,52,12,54,5,2,True,0.25010724450464894
2025-01-08 18:01:40,Hijau,416,104,tensor(125.3112),tensor(138.7539),171,38,174,40,3,2,True,0.0
2025-01-08 18:01:40,persegiHijau,423,110,122,146,143,9,142,6,1,3,True,0.3125675307861707
2025-01-08 18:01:40,Fail to pick,423,110,0,0,0,0,0,0,0,0,False,0
2025-01-08 18:01:40,persegiHijau,395,90,123,147,86,82,89,83,3,1,True,0.16455958090108197
2025-01-08 18:01:40,persegiHijau,400,90,129,158,23,46,23,41,0,5,True,0.37970939325443664
2025-01-08 18:01:40,Fail to pick,400,90,0,0,0,0,0,0,0,0,False,0
2025-01-08 18:02:29,persegiHijau,247,400,115,115,112,4,110,6,2,2,True,0.10456122402864364
2025-01-08 18:02:29,persegiHijau,299,353,121,125,159,84,156,84,3,0,True,0.23848163514506215
2025-01-08 18:02:29,Hijau,299,353,tensor(121.4813),tensor(125.8819),101,27,97,30,4,3,True,0.0004999637603759766
2025-01-08 18:02:29,persegiHijau,267,331,117,128,125,71,121,68,4,3,True,0.11436903986827196
2025-01-08 18:02:29,persegiHijau,300,350,121,129,10,77,7,73,3,4,False,0.4290830572384574
2025-01-08 18:02:29,persegiHijau,304,348,123,127,62,69,62,73,0,4,True,0.17370219638390072
2025-01-08 18:02:29,Fail to pick,304,348,0,0,0,0,0,0,0,0,False,0
2025-01-08 18:02:29,persegiHijau,305,348,123,127,47,30,49,33,2,3,True,0.23509979994478827
2025-01-08 18:02:29,Fail to pick,305,348,0,0,0,0,0,0,0,0,False,0
2025-01-08 18:02:30,persegiHijau,300,352,122,125,99,33,101,29,2,4,True,0.16734668969823158
2025-01-08 18:02:30,Fail to pick,300,352,0,0,0,0,0,0,0,0,False,0
2025-01-08 18:02:30,persegiHijau,299,353,121,126,141,29,141,32,0,3,True,0.286467532785061
2025-01-08 18:02:30,Fail to pick,299,353,0,0,0,0,0,0,0,0,False,0
2025-01-08 18:02:30,persegiHijau,300,348,125,124,38,95,42,91,4,4,True,0.25343943567965277
2025-01-08 18:02:30,Fail to pick,300,348,0,0,0,0,0,0,0,0,False,0
2025-01-08 18:02:30,persegiHijau,305,349,122,124,7,28,11,31,4,3,True,0.4629511763671146
2025-01-08 18:02:30,Fail to pick,305,349,0,0,0,0,0,0,0,0,False,0
2025-01-08 18:02:30,persegiHijau,293,353,118,126,90,94,92,96,2,2,True,0.4292314848577551
2025-01-08 18:02:30,persegiHijau,303,349,123,126,109,56,110,59,1,3,True,0.22202023655235023
2025-01-08 18:02:30,Hijau,303,349,tensor(123.5579),tensor(126.2504),103,28,106,31,3,3,True,0.0
2025-01-08 18:02:30,persegiHijau,296,353,118,124,10,50,6,54,4,4,True,0.42717268526515717
2025-01-08 18:02:30,Fail to pick,296,353,0,0,0,0,0,0,0,0,False,0
2025-01-08 18:02:30,persegiHijau,300,352,119,124,16,80,18,84,2,4,True,0.3970085278225437
2025-01-08 18:02:30,Fail to pick,300,352,0,0,0,0,0,0,0,0,False,0
2025-01-08 18:02:30,persegiHijau,304,350,121,127,185,41,189,45,4,4,True,0.46787112652314633
2025-01-08 18:02:30,Fail to pick,304,350,0,0,0,0,0,0,0,0,False,0
2025-01-08 18:02:31,persegiHijau,296,353,119,126,81,44,84,41,3,3,False,0.10499359462704293
2025-01-08 18:02:31,Fail to pick,296,353,0,0,0,0,0,0,0,0,False,0
2025-01-08 18:02:31,persegiHijau,307,353,123,125,41,63,43,60,2,3,True,0.15051055832492924
2025-01-08 18:02:31,persegiHijau,300,352,122,126,92,50,92,46,0,4,True,0.4783751788463303
2025-01-08 18:02:31,Fail to pick,300,352,0,0,0,0,0,0,0,0,False,0
2025-01-08 18:02:31,persegiHijau,304,350,121,123,26,13,25,11,1,2,False,0.42718103689123477
2025-01-08 18:02:31,Fail to pick,304,350,0,0,0,0,0,0,0,0,False,0
2025-01-08 18:02:31,persegiHijau,304,348,121,125,122,89,119,91,3,2,False,0.3231621578695564
2025-01-08 18:02:31,Fail to pick,304,348,0,0,0,0,0,0,0,0,False,0
2025-01-08 18:02:35,persegiHijau,304,349,119,125,184,95,182,96,2,1,False,0.10673168250745024
2025-01-08 18:02:35,Hijau,304,349,tensor(119.0233),tensor(125.8066),103,28,104,23,1,5,True,0.0
2025-01-08 18:02:35,Fail to pick,304,349,0,0,0,0,0,0,0,0,False,0
2025-01-08 18:02:36,persegiHijau,303,357,120,125,0,84,0,79,0,5,True,0.4600544896579436
2025-01-08 18:02:36,Fail to pick,303,357,0,0,0,0,0,0,0,0,False,0
2025-01-08 18:02:36,persegiHijau,302,350,119,124,64,4,64,0,0,4,True,0.2695515975720363
2025-01-08 18:02:36,Fail to pick,302,350,0,0,0,0,0,0,0,0,False,0
2025-01-08 18:02:36,persegiHijau,300,352,121,126,150,90,145,91,5,1,True,0.3327978557451514
2025-01-08 18:02:36,Fail to pick,300,352,0,0,0,0,0,0,0,0,False,0
2025-01-08 18:02:36,persegiHijau,305,353,121,123,64,95,68,90,4,5,True,0.39136959228325674
2025-01-08 18:02:36,Fail to pick,305,353,0,0,0,0,0,0,0,0,False,0
2025-01-08 18:02:36,persegiHijau,306,350,120,128,103,76,101,77,2,1,True,0.38225585390218775
2025-01-08 18:02:36,Fail to pick,306,350,0,0,0,0,0,0,0,0,False,0
2025-01-08 18:02:36,persegiHijau,299,355,120,124,171,34,170,34,1,0,True,0.1286782387583536
2025-01-08 18:02:36,Fail to pick,299,355,0,0,0,0,0,0,0,0,False,0
2025-01-08 18:02:36,persegiHijau,307,349,121,128,83,76,82,71,1,5,True,0.14302610466511112
2025-01-08 18:02:36,Fail to pick,307,349,0,0,0,0,0,0,0,0,False,0
2025-01-08 18:02:36,persegiHijau,303,352,123,127,116,30,113,29,3,1,False,0.3692908763465974
2025-01-08 18:02:36,Fail to pick,303,352,0,0,0,0,0,0,0,0,False,0
2025-01-08 18:02:36,persegiHijau,308,349,122,127,106,97,106,99,0,2,True,0.382461165495802
2025-01-08 18:02:36,Hijau,308,349,tensor(122.9998),tensor(127.8914),103,28,104,23,1,5,True,0.0
2025-01-08 18:02:36,Fail to pick,308,349,0,0,0,0,0,0,0,0,False,0
2025-01-08 18:02:37,persegiHijau,315,357,122,125,90,90,90,91,0,1,True,0.10525281561826527
2025-01-08 18:02:37,Fail to pick,315,357,0,0,0,0,0,0,0,0,False,0
2025-01-08 18:02:37,persegiHijau,305,353,122,126,155,9,159,8,4,1,True,0.3161997925774839
2025-01-08 18:02:37,persegiHijau,304,353,125,123,116,3,113,1,3,2,True,0.1874892376965819
2025-01-08 18:02:37,Fail to pick,304,353,0,0,0,0,0,0,0,0,False,0
2025-01-08 18:02:37,persegiHijau,303,356,120,126,95,12,92,11,3,1,True,0.2133408013598952
2025-01-08 18:02:37,Fail to pick,303,356,0,0,0,0,0,0,0,0,False,0
2025-01-08 18:02:37,persegiHijau,303,353,121,125,59,33,63,36,4,3,True,0.3128157245840686
2025-01-08 18:02:37,Fail to pick,303,353,0,0,0,0,0,0,0,0,False,0
2025-01-08 18:02:37,persegiHijau,302,354,123,124,67,22,67,21,0,1,True,0.20117495851402156
2025-01-08 18:02:37,Fail to pick,302,354,0,0,0,0,0,0,0,0,False,0
2025-01-08 18:02:37,persegiHijau,306,349,122,128,106,57,101,52,5,5,True,0.47984739843894253
2025-01-08 18:02:37,Fail to pick,306,349,0,0,0,0,0,0,0,0,False,0
2025-01-08 18:02:37,persegiHijau,305,352,124,128,56,22,55,23,1,1,True,0.4123767293969126
2025-01-08 18:02:37,Fail to pick,305,352,0,0,0,0,0,0,0,0,False,0
2025-01-08 18:02:37,persegiHijau,306,353,124,124,164,40,166,36,2,4,True,0.42727775872227347
2025-01-08 18:02:37,Fail to pick,306,353,0,0,0,0,0,0,0,0,False,0
2025-01-08 18:02:37,persegiHijau,307,353,124,124,151,25,151,27,0,2,True,0.43592746717233677
2025-01-08 18:02:37,Hijau,307,353,tensor(124.7946),tensor(124.0564),101,28,100,31,1,3,True,0.0
2025-01-08 18:02:37,Fail to pick,307,353,0,0,0,0,0,0,0,0,False,0
2025-01-08 18:02:38,persegiHijau,308,356,123,126,26,35,29,30,3,5,True,0.2969757684279473
2025-01-08 18:02:38,Fail to pick,308,356,0,0,0,0,0,0,0,0,False,0
2025-01-08 18:02:38,persegiHijau,304,354,118,124,39,96,43,97,4,1,True,0.20487765131201147
2025-01-08 18:02:38,Fail to pick,304,354,0,0,0,0,0,0,0,0,False,0
2025-01-08 18:02:38,persegiHijau,301,356,120,124,194,24,197,24,3,0,True,0.46454244161845926
2025-01-08 18:02:38,Fail to pick,301,356,0,0,0,0,0,0,0,0,False,0
2025-01-08 18:02:38,persegiHijau,306,352,121,124,107,83,103,79,4,4,True,0.2823249130259132
2025-01-08 18:02:38,Fail to pick,306,352,0,0,0,0,0,0,0,0,False,0
2025-01-08 18:02:38,persegiHijau,302,350,118,126,33,85,37,84,4,1,True,0.23122182198344873
2025-01-08 18:02:38,Fail to pick,302,350,0,0,0,0,0,0,0,0,False,0
2025-01-08 18:02:38,persegiHijau,309,351,124,126,141,7,143,2,2,5,True,0.16013225587551905
2025-01-08 18:02:38,Fail to pick,309,351,0,0,0,0,0,0,0,0,False,0
2025-01-08 18:02:38,persegiHijau,306,349,119,128,28,49,32,45,4,4,False,0.36952836328064986
2025-01-08 18:02:38,Fail to pick,306,349,0,0,0,0,0,0,0,0,False,0
2025-01-08 18:02:38,persegiHijau,299,352,119,126,49,30,50,29,1,1,True,0.29895154919079236
2025-01-08 18:02:38,Fail to pick,299,352,0,0,0,0,0,0,0,0,False,0
2025-01-08 18:02:38,persegiHijau,304,351,118,128,135,21,131,17,4,4,True,0.304541786232585
2025-01-08 18:02:38,Fail to pick,304,351,0,0,0,0,0,0,0,0,False,0
2025-01-08 18:02:39,persegiHijau,302,354,119,126,114,8,116,5,2,3,True,0.131021998208889
2025-01-08 18:02:39,Hijau,302,354,tensor(119.2236),tensor(126.1583),101,27,105,22,4,5,True,0.0
2025-01-08 18:02:39,Fail to pick,302,354,0,0,0,0,0,0,0,0,False,0
2025-01-08 18:02:39,persegiHijau,306,352,123,125,179,70,182,68,3,2,True,0.25835510687446855
2025-01-08 18:02:39,Fail to pick,306,352,0,0,0,0,0,0,0,0,False,0
2025-01-08 18:02:39,persegiHijau,299,352,118,125,157,44,158,46,1,2,True,0.39359622087602564
2025-01-08 18:02:39,Fail to pick,299,352,0,0,0,0,0,0,0,0,False,0
2025-01-08 18:02:39,persegiHijau,304,350,118,127,37,79,32,82,5,3,True,0.2508082527403923
2025-01-08 18:02:39,Fail to pick,304,350,0,0,0,0,0,0,0,0,False,0
2025-01-08 18:02:39,persegiHijau,297,353,116,122,2,69,-1,68,3,1,True,0.2824204985244697
2025-01-08 18:02:39,Fail to pick,297,353,0,0,0,0,0,0,0,0,False,0
2025-01-08 18:02:39,persegiHijau,294,350,116,124,94,59,94,57,0,2,False,0.3833753662095335
2025-01-08 18:02:39,Fail to pick,294,350,0,0,0,0,0,0,0,0,False,0
2025-01-08 18:02:39,persegiHijau,294,353,116,125,91,29,95,31,4,2,True,0.15006908064436275
2025-01-08 18:02:39,Fail to pick,294,353,0,0,0,0,0,0,0,0,False,0
2025-01-08 18:02:39,persegiHijau,314,358,125,122,73,64,75,62,2,2,True,0.17311481523322203
2025-01-08 18:02:39,persegiHijau,299,353,116,126,189,53,184,56,5,3,True,0.24921681659063016
2025-01-08 18:02:40,persegiHijau,309,354,120,123,104,15,107,10,3,5,True,0.19068690259822457
2025-01-08 18:02:40,persegiHijau,304,358,120,123,67,44,70,42,3,2,True,0.3391353009913999
2025-01-08 18:02:40,Hijau,304,358,tensor(120.3788),tensor(123.2317),100,28,103,25,3,3,True,0.0
2025-01-08 18:02:40,Fail to pick,304,358,0,0,0,0,0,0,0,0,False,0
2025-01-08 18:02:40,persegiHijau,302,356,120,121,164,46,162,46,2,0,True,0.248592759937321
2025-01-08 18:02:40,Fail to pick,302,356,0,0,0,0,0,0,0,0,False,0
2025-01-08 18:02:40,persegiHijau,310,354,125,123,143,23,147,26,4,3,True,0.23957264565243763
2025-01-08 18:02:40,Fail to pick,310,354,0,0,0,0,0,0,0,0,False,0
2025-01-08 18:02:40,persegiHijau,320,362,121,126,71,59,75,63,4,4,False,0.4922319425020204
2025-01-08 18:02:40,persegiHijau,272,336,116,129,135,43,138,39,3,4,True,0.3986970271054503
2025-01-08 18:02:40,persegiHijau,309,366,122,122,178,79,177,83,1,4,True,0.2732042759030857
2025-01-08 18:02:40,persegiHijau,304,347,119,118,12,40,12,35,0,5,True,0.22257995899610192
2025-01-08 18:02:40,persegiHijau,296,356,117,122,186,52,181,56,5,4,True,0.3233861923031649
2025-01-08 18:02:40,Fail to pick,296,356,0,0,0,0,0,0,0,0,False,0
2025-01-08 18:02:40,persegiHijau,317,367,123,121,17,99,20,96,3,3,True,0.21619334286610026
2025-01-08 18:02:41,persegiHijau,295,351,120,122,60,58,59,56,1,2,True,0.2880122799150564
2025-01-08 18:02:41,persegiHijau,297,353,124,123,40,14,36,15,4,1,True,0.15278102205171115
2025-01-08 18:02:41,Hijau,297,353,tensor(124.3904),tensor(123.2960),101,27,100,25,1,2,True,0.0
2025-01-08 18:02:41,Fail to pick,297,353,0,0,0,0,0,0,0,0,False,0
2025-01-08 18:02:41,persegiHijau,312,364,126,122,35,12,36,8,1,4,True,0.37741330513923455
2025-01-08 18:02:41,persegiHijau,316,358,126,124,62,35,59,31,3,4,True,0.20844104307199596
2025-01-08 18:02:41,Fail to pick,316,358,0,0,0,0,0,0,0,0,False,0
2025-01-08 18:02:41,persegiHijau,306,356,124,120,158,72,157,74,1,2,False,0.19652495949284485
2025-01-08 18:02:41,persegiHijau,305,353,125,121,110,22,112,23,2,1,True,0.34180158499149393
2025-01-08 18:02:41,Fail to pick,305,353,0,0,0,0,0,0,0,0,False,0
2025-01-08 18:02:41,persegiHijau,311,352,127,123,154,31,151,26,3,5,True,0.33981395127950226
2025-01-08 18:02:41,Fail to pick,311,352,0,0,0,0,0,0,0,0,False,0
2025-01-08 18:02:41,persegiHijau,295,351,119,121,132,55,130,56,2,1,True,0.30245447776665746
2025-01-08 18:02:46,persegiHijau,338,354,125,116,112,47,108,44,4,3,True,0.3708576095420728
2025-01-08 18:02:46,Hijau,338,354,tensor(125.7620),tensor(116.8333),101,31,97,27,4,4,True,0.0
2025-01-08 18:02:46,persegiHijau,343,351,121,115,16,54,12,51,4,3,True,0.16576917724871326
2025-01-08 18:02:46,Fail to pick,343,351,0,0,0,0,0,0,0,0,False,0
2025-01-08 18:02:46,persegiHijau,343,351,121,114,129,70,124,72,5,2,True,0.3809896784169463
2025-01-08 18:02:46,Fail to pick,343,351,0,0,0,0,0,0,0,0,False,0
2025-01-08 18:02:46,persegiHijau,336,360,121,113,175,52,170,56,5,4,True,0.3440179296081657
2025-01-08 18:02:46,Fail to pick,336,360,0,0,0,0,0,0,0,0,False,0
2025-01-08 18:02:46,persegiHijau,345,360,117,113,199,78,200,79,1,1,True,0.48079004164640404
2025-01-08 18:02:46,Fail to pick,345,360,0,0,0,0,0,0,0,0,False,0
2025-01-08 18:02:46,persegiHijau,319,338,114,120,191,63,187,65,4,2,True,0.3093941984032401
2025-01-08 18:02:47,persegiHijau,351,364,122,116,33,15,36,19,3,4,True,0.4643085025363133
2025-01-08 18:02:47,persegiHijau,319,346,116,120,73,60,70,57,3,3,True,0.42483090646606225
2025-01-08 18:02:47,persegiHijau,348,357,122,118,144,68,141,69,3,1,True,0.2527753709089802
2025-01-08 18:02:48,segienamHijau,291,127,133,132,138,8,135,10,3,2,True,0.34342461767733523
2025-01-08 18:02:48,Hijau,291,127,tensor(133.9134),tensor(132.3788),164,26,164,27,0,1,True,0.0005028247833251953
2025-01-08 18:02:48,persegiHijau,291,128,134,138,184,98,181,100,3,2,True,0.3050864175473725
2025-01-08 18:02:48,Fail to pick,291,128,0,0,0,0,0,0,0,0,False,0
2025-01-08 18:02:48,persegiHijau,302,138,136,137,190,2,185,0,5,2,True,0.3910165578968955
2025-01-08 18:02:48,persegiHijau,288,129,136,138,137,1,137,0,0,1,True,0.11443270286669122
2025-01-08 18:02:48,persegiHijau,296,129,134,137,113,53,111,55,2,2,True,0.2348656104262831
2025-01-08 18:02:48,Fail to pick,296,129,0,0,0,0,0,0,0,0,False,0
2025-01-08 18:02:48,persegiHijau,290,128,137,142,106,27,103,28,3,1,True,0.24327547255016496
2025-01-08 18:02:48,Fail to pick,290,128,0,0,0,0,0,0,0,0,False,0
2025-01-08 18:02:48,persegiHijau,307,137,144,144,187,62,184,58,3,4,True,0.4417722840266891
2025-01-08 18:02:49,persegiHijau,293,131,138,137,13,34,15,33,2,1,True,0.18765384700676715
2025-01-08 18:02:49,persegiHijau,289,131,137,141,25,65,29,64,4,1,True,0.16985585213893467
2025-01-08 18:02:49,Fail to pick,289,131,0,0,0,0,0,0,0,0,False,0
2025-01-08 18:02:49,persegiHijau,292,132,141,137,48,13,49,10,1,3,True,0.22541736098567133
2025-01-08 18:02:49,Fail to pick,292,132,0,0,0,0,0,0,0,0,False,0
2025-01-08 18:02:49,persegiHijau,304,135,140,140,91,59,95,61,4,2,False,0.3207256701090786
2025-01-08 18:02:49,persegiHijau,300,134,133,135,149,66,151,68,2,2,True,0.4494121948558326
2025-01-08 18:02:49,segienamHijau,300,130,134,129,105,39,101,36,4,3,False,0.16969685749191366
2025-01-08 18:02:49,Hijau,300,134,tensor(133.7755),tensor(135.1507),162,27,159,23,3,4,True,0.0
2025-01-08 18:02:49,Fail to pick,300,134,0,0,0,0,0,0,0,0,False,0
2025-01-08 18:02:49,Fail to pick,300,130,0,0,0,0,0,0,0,0,False,0
2025-01-08 18:02:49,persegiHijau,302,138,140,141,118,4,122,0,4,4,True,0.19864760711900942
2025-01-08 18:02:49,Fail to pick,302,138,0,0,0,0,0,0,0,0,False,0
2025-01-08 18:02:49,persegiHijau,309,137,140,137,117,23,116,26,1,3,True,0.21109866404881755
2025-01-08 18:02:49,Fail to pick,309,137,0,0,0,0,0,0,0,0,False,0
2025-01-08 18:02:49,persegiHijau,290,133,139,135,123,44,119,46,4,2,True,0.2915761900834356
2025-01-08 18:02:49,persegiHijau,288,129,138,139,192,49,196,50,4,1,True,0.48670875575420924
2025-01-08 18:02:49,Fail to pick,288,129,0,0,0,0,0,0,0,0,False,0
2025-01-08 18:02:49,persegiHijau,298,137,139,132,177,96,172,93,5,3,True,0.1123486996813222
2025-01-08 18:02:51,persegiHijau,451,369,127,125,2,24,4,22,2,2,False,0.3188717226434983
2025-01-08 18:02:51,Hijau,451,369,tensor(127.2995),tensor(125.0493),97,41,97,41,0,0,True,0.0004985332489013672
2025-01-08 18:02:51,persegiHijau,461,360,129,122,145,57,142,59,3,2,True,0.33146759878213494
2025-01-08 18:02:51,persegiHijau,469,372,129,127,57,36,58,31,1,5,True,0.30988904234717013
2025-01-08 18:02:51,persegiHijau,466,370,131,126,119,32,119,27,0,5,True,0.32058666952126136
2025-01-08 18:02:51,Fail to pick,466,370,0,0,0,0,0,0,0,0,False,0
2025-01-08 18:02:51,persegiHijau,466,368,129,124,126,90,124,88,2,2,True,0.32558945149245516
2025-01-08 18:02:51,Fail to pick,466,368,0,0,0,0,0,0,0,0,False,0
2025-01-08 18:02:51,persegiHijau,455,356,121,129,168,56,163,53,5,3,True,0.22774371026472542
2025-01-08 18:02:51,persegiHijau,455,353,121,124,73,20,74,17,1,3,True,0.44598490238992416
2025-01-08 18:02:51,Fail to pick,455,353,0,0,0,0,0,0,0,0,False,0
2025-01-08 18:02:51,persegiHijau,472,365,126,123,55,4,50,7,5,3,True,0.44467249563817446
2025-01-08 18:02:52,persegiHijau,468,375,125,121,63,89,65,91,2,2,True,0.3796049508879046
2025-01-08 18:02:52,persegiHijau,476,368,126,122,13,74,12,78,1,4,True,0.4170684482665997
2025-01-08 18:02:52,Hijau,476,368,tensor(126.9444),tensor(122.1829),97,44,95,47,2,3,True,0.0004985332489013672
2025-01-08 18:02:52,Fail to pick,476,368,0,0,0,0,0,0,0,0,False,0
2025-01-08 18:02:52,persegiHijau,477,377,125,120,151,84,150,85,1,1,True,0.2850238737758064
2025-01-08 18:02:52,Fail to pick,477,377,0,0,0,0,0,0,0,0,False,0
2025-01-08 18:02:52,persegiHijau,481,379,129,117,194,99,198,99,4,0,True,0.33627260689236343
2025-01-08 18:02:52,Fail to pick,481,379,0,0,0,0,0,0,0,0,False,0
2025-01-08 18:02:52,persegiHijau,449,355,127,122,82,8,79,4,3,4,True,0.2071378498633051
2025-01-08 18:02:52,persegiHijau,449,355,129,122,89,51,93,50,4,1,True,0.4915987880758018
2025-01-08 18:02:52,Fail to pick,449,355,0,0,0,0,0,0,0,0,False,0
2025-01-08 18:02:52,persegiHijau,479,379,125,119,146,38,145,41,1,3,True,0.11119768854295403
2025-01-08 18:02:52,persegiHijau,449,356,125,120,165,48,160,48,5,0,True,0.43382769426233125
2025-01-08 18:02:57,persegiHijau,435,356,126,123,130,41,129,36,1,5,True,0.30135057571593515
2025-01-08 18:02:57,Hijau,435,356,tensor(126.8274),tensor(123.8506),101,40,103,43,2,3,True,0.0
2025-01-08 18:02:57,persegiHijau,445,357,128,124,117,33,114,34,3,1,False,0.3642992868538182
2025-01-08 18:02:57,persegiHijau,472,369,125,118,31,42,27,44,4,2,True,0.47926517438593363
2025-01-08 18:02:57,persegiHijau,468,373,130,122,158,59,162,61,4,2,True,0.3899968347719718
2025-01-08 18:02:57,Fail to pick,468,373,0,0,0,0,0,0,0,0,False,0
2025-01-08 18:02:57,persegiHijau,470,372,127,120,137,65,136,69,1,4,False,0.3799751699166952
2025-01-08 18:02:57,Fail to pick,470,372,0,0,0,0,0,0,0,0,False,0
2025-01-08 18:02:57,persegiHijau,442,355,126,123,110,70,114,74,4,4,True,0.4007576238385906
2025-01-08 18:02:58,persegiHijau,278,288,120,118,120,33,117,31,3,2,True,0.10513886939644124
2025-01-08 18:02:58,Hijau,278,288,tensor(120.0667),tensor(118.0827),120,25,115,23,5,2,True,0.0005011558532714844
2025-01-08 18:02:59,persegiHijau,274,295,118,118,102,17,105,15,3,2,True,0.1467927017038398
2025-01-08 18:02:59,Fail to pick,274,295,0,0,0,0,0,0,0,0,False,0
2025-01-08 18:02:59,persegiHijau,250,269,117,120,190,74,186,72,4,2,True,0.10493978136184673
2025-01-08 18:02:59,persegiHijau,251,267,119,120,4,64,8,66,4,2,True,0.1388342702509791
2025-01-08 18:02:59,Fail to pick,251,267,0,0,0,0,0,0,0,0,False,0
2025-01-08 18:02:59,persegiHijau,252,267,115,120,112,61,110,59,2,2,False,0.19173196604211795
2025-01-08 18:02:59,Fail to pick,252,267,0,0,0,0,0,0,0,0,False,0
2025-01-08 18:02:59,persegiHijau,248,273,115,118,138,41,138,41,0,0,True,0.10033367970013196
2025-01-08 18:02:59,Fail to pick,248,273,0,0,0,0,0,0,0,0,False,0
2025-01-08 18:02:59,persegiHijau,252,266,118,119,93,88,95,83,2,5,True,0.47199918760558035
2025-01-08 18:02:59,Fail to pick,252,266,0,0,0,0,0,0,0,0,False,0
2025-01-08 18:02:59,persegiHijau,245,268,113,120,73,73,73,68,0,5,True,0.47055295016914145
2025-01-08 18:02:59,Fail to pick,245,268,0,0,0,0,0,0,0,0,False,0
2025-01-08 18:02:59,persegiHijau,249,268,115,120,188,86,192,87,4,1,True,0.15959245400246305
2025-01-08 18:02:59,Fail to pick,249,268,0,0,0,0,0,0,0,0,False,0
2025-01-08 18:02:59,persegiHijau,249,272,117,118,100,94,100,92,0,2,True,0.18917715834262122
2025-01-08 18:02:59,Fail to pick,249,272,0,0,0,0,0,0,0,0,False,0
2025-01-08 18:02:59,persegiHijau,245,271,112,121,129,45,133,44,4,1,True,0.252458505598428
2025-01-08 18:02:59,Hijau,245,271,tensor(112.5764),tensor(121.1878),124,22,124,18,0,4,True,0.0
2025-01-08 18:02:59,Fail to pick,245,271,0,0,0,0,0,0,0,0,False,0
2025-01-08 18:03:00,persegiHijau,250,268,115,117,6,76,1,71,5,5,True,0.4738985901132421
2025-01-08 18:03:00,Fail to pick,250,268,0,0,0,0,0,0,0,0,False,0
2025-01-08 18:03:00,persegiHijau,250,269,116,122,141,99,143,101,2,2,True,0.3747607478799594
2025-01-08 18:03:00,Fail to pick,250,269,0,0,0,0,0,0,0,0,False,0
2025-01-08 18:03:00,persegiHijau,263,280,118,117,99,46,96,41,3,5,True,0.44232093061086686
2025-01-08 18:03:00,persegiHijau,250,273,118,122,102,39,100,37,2,2,True,0.3578215064018816
2025-01-08 18:03:00,persegiHijau,269,288,124,120,149,9,145,11,4,2,True,0.37365650017664154
2025-01-08 18:03:00,persegiHijau,254,272,119,120,177,43,181,45,4,2,True,0.3754856203132235
2025-01-08 18:03:00,persegiHijau,259,273,123,122,147,12,148,7,1,5,True,0.4525628685632733
2025-01-08 18:03:00,Fail to pick,259,273,0,0,0,0,0,0,0,0,False,0
2025-01-08 18:03:00,persegiHijau,263,275,117,119,114,40,109,40,5,0,True,0.17458377718861062
2025-01-08 18:03:00,Fail to pick,263,275,0,0,0,0,0,0,0,0,False,0
2025-01-08 18:03:00,persegiHijau,261,274,119,120,109,96,110,95,1,1,True,0.22388863944166923
2025-01-08 18:03:00,Fail to pick,261,274,0,0,0,0,0,0,0,0,False,0
2025-01-08 18:03:01,persegiHijau,259,269,115,117,134,1,134,2,0,1,True,0.33948416959287464
2025-01-08 18:03:01,Hijau,259,269,tensor(115.1766),tensor(117.9554),125,23,121,18,4,5,True,0.0
2025-01-08 18:03:01,Fail to pick,259,269,0,0,0,0,0,0,0,0,False,0
2025-01-08 18:03:01,persegiHijau,251,271,119,121,133,60,135,56,2,4,True,0.19342163071393045
2025-01-08 18:03:01,Fail to pick,251,271,0,0,0,0,0,0,0,0,False,0
2025-01-08 18:03:01,persegiHijau,266,278,120,119,187,96,187,95,0,1,True,0.13724531272057022
2025-01-08 18:03:01,persegiHijau,251,274,116,122,89,50,91,48,2,2,True,0.3726715414107459
2025-01-08 18:03:01,persegiHijau,253,267,120,123,120,27,122,28,2,1,True,0.10068989494866334
2025-01-08 18:03:01,Fail to pick,253,267,0,0,0,0,0,0,0,0,False,0
2025-01-08 18:03:01,persegiHijau,238,267,113,123,86,39,90,42,4,3,True,0.3922371943705044
2025-01-08 18:03:01,persegiHijau,250,271,120,120,110,88,112,90,2,2,True,0.19077776308335098
2025-01-08 18:03:01,persegiHijau,254,265,120,117,124,94,124,96,0,2,True,0.4584104803388874
2025-01-08 18:03:01,Fail to pick,254,265,0,0,0,0,0,0,0,0,False,0
2025-01-08 18:03:01,persegiHijau,259,271,119,121,105,83,108,86,3,3,True,0.4120499475864259
2025-01-08 18:03:01,Fail to pick,259,271,0,0,0,0,0,0,0,0,False,0
2025-01-08 18:03:01,persegiHijau,245,271,114,122,5,95,1,93,4,2,True,0.18142936173496446
2025-01-08 18:03:02,persegiHijau,272,281,117,118,167,83,168,82,1,1,True,0.2420904653211925
2025-01-08 18:03:02,Hijau,272,281,tensor(117.7514),tensor(118.6418),121,25,119,27,2,2,True,0.0
2025-01-08 18:03:02,persegiHijau,244,273,116,119,94,57,97,52,3,5,True,0.2970350689385364
2025-01-08 18:03:02,persegiHijau,226,256,112,121,26,8,28,11,2,3,False,0.4724852382915833
2025-01-08 18:03:02,persegiHijau,274,288,123,117,144,61,145,60,1,1,False,0.27767506024138733
2025-01-08 18:03:02,persegiHijau,272,283,123,116,60,58,57,60,3,2,True,0.1251078555386486
2025-01-08 18:03:02,Fail to pick,272,283,0,0,0,0,0,0,0,0,False,0
2025-01-08 18:03:02,persegiHijau,272,287,121,117,35,13,33,15,2,2,True,0.2921919674454032
2025-01-08 18:03:02,Fail to pick,272,287,0,0,0,0,0,0,0,0,False,0
2025-01-08 18:03:02,persegiHijau,267,285,117,119,126,52,121,49,5,3,True,0.13545760652986996
2025-01-08 18:03:02,Fail to pick,267,285,0,0,0,0,0,0,0,0,False,0
2025-01-08 18:03:02,persegiHijau,270,284,117,117,188,66,186,63,2,3,False,0.26315805708835316
2025-01-08 18:03:02,Fail to pick,270,284,0,0,0,0,0,0,0,0,False,0
2025-01-08 18:03:02,persegiHijau,271,286,122,117,72,96,72,94,0,2,True,0.4738499846471679
2025-01-08 18:03:03,Fail to pick,271,286,0,0,0,0,0,0,0,0,False,0
2025-01-08 18:03:03,persegiHijau,264,285,118,119,185,92,181,89,4,3,True,0.3998509592681144
2025-01-08 18:03:03,Hijau,264,285,tensor(118.0617),tensor(119.3162),120,24,119,20,1,4,True,0.0
2025-01-08 18:03:03,Fail to pick,264,285,0,0,0,0,0,0,0,0,False,0
2025-01-08 18:03:03,persegiHijau,249,268,115,118,143,86,143,90,0,4,True,0.44451360075454693
2025-01-08 18:03:03,persegiHijau,249,268,116,119,130,32,126,28,4,4,True,0.2473292215568726
2025-01-08 18:03:03,Fail to pick,249,268,0,0,0,0,0,0,0,0,False,0
2025-01-08 18:03:03,persegiHijau,265,283,118,118,103,84,100,83,3,1,True,0.42993437512685895
2025-01-08 18:03:03,persegiHijau,249,268,120,117,177,44,179,41,2,3,True,0.15638210236515776
2025-01-08 18:03:03,persegiHijau,246,270,121,117,141,54,137,58,4,4,True,0.2765140505689385
2025-01-08 18:03:03,Fail to pick,246,270,0,0,0,0,0,0,0,0,False,0
2025-01-08 18:03:10,persegiHijau,334,259,120,118,188,11,190,9,2,2,False,0.4599006103121258
2025-01-08 18:03:10,Hijau,334,259,tensor(120.5724),tensor(118.3130),128,30,123,28,5,2,True,0.0005054473876953125
2025-01-08 18:03:10,persegiHijau,341,255,121,124,164,68,160,65,4,3,True,0.25017944084132804
2025-01-08 18:03:10,Fail to pick,341,255,0,0,0,0,0,0,0,0,False,0
2025-01-08 18:03:10,persegiHijau,366,274,131,121,77,57,72,59,5,2,False,0.2601312177673806
2025-01-08 18:03:10,persegiHijau,360,275,124,120,123,15,125,18,2,3,True,0.23422760485311606
2025-01-08 18:03:10,Fail to pick,360,275,0,0,0,0,0,0,0,0,False,0
2025-01-08 18:03:10,persegiHijau,368,270,128,122,169,76,168,80,1,4,True,0.4332540179297828
2025-01-08 18:03:10,Fail to pick,368,270,0,0,0,0,0,0,0,0,False,0
2025-01-08 18:03:10,persegiHijau,333,254,122,124,139,96,138,100,1,4,False,0.3012705242477016
2025-01-08 18:03:11,persegiHijau,334,251,122,126,113,18,116,14,3,4,True,0.25305180720778875
2025-01-08 18:03:11,Fail to pick,334,251,0,0,0,0,0,0,0,0,False,0
2025-01-08 18:03:11,persegiHijau,331,250,119,126,45,20,47,20,2,0,True,0.11973445771889094
2025-01-08 18:03:11,Fail to pick,331,250,0,0,0,0,0,0,0,0,False,0
2025-01-08 18:03:11,persegiHijau,354,273,123,122,58,16,57,20,1,4,False,0.13483867587226125
2025-01-08 18:03:11,persegiHijau,330,254,119,123,11,94,7,94,4,0,True,0.3649940882977871
2025-01-08 18:03:11,Hijau,330,254,tensor(119.9171),tensor(123.1731),129,30,132,30,3,0,True,0.0
2025-01-08 18:03:11,persegiHijau,333,252,123,125,196,8,198,8,2,0,True,0.4542121634944586
2025-01-08 18:03:11,Fail to pick,333,252,0,0,0,0,0,0,0,0,False,0
2025-01-08 18:03:11,persegiHijau,361,276,127,120,30,22,33,17,3,5,True,0.15162604808780455
2025-01-08 18:03:11,persegiHijau,331,252,119,125,180,43,178,41,2,2,True,0.4672116991837909
2025-01-08 18:03:11,persegiHijau,335,252,120,123,194,85,195,80,1,5,True,0.4794403108499571
2025-01-08 18:03:11,Fail to pick,335,252,0,0,0,0,0,0,0,0,False,0
2025-01-08 18:03:11,persegiHijau,336,252,123,124,154,79,156,77,2,2,True,0.33376814896676155
2025-01-08 18:03:11,Fail to pick,336,252,0,0,0,0,0,0,0,0,False,0
2025-01-08 18:03:12,persegiHijau,336,251,121,125,66,12,68,12,2,0,True,0.4951316467264386
2025-01-08 18:03:12,Fail to pick,336,251,0,0,0,0,0,0,0,0,False,0
2025-01-08 18:03:12,persegiHijau,366,276,129,123,69,77,66,73,3,4,True,0.4264123216058595
2025-01-08 18:03:12,persegiHijau,359,271,124,123,122,35,118,38,4,3,True,0.4666509795117427
2025-01-08 18:03:12,Fail to pick,359,271,0,0,0,0,0,0,0,0,False,0
2025-01-08 18:03:12,persegiHijau,350,269,123,122,20,77,20,75,0,2,True,0.39633599740960934
2025-01-08 18:03:12,Hijau,350,269,tensor(123.0786),tensor(122.8028),125,32,120,36,5,4,True,0.0004942417144775391
2025-01-08 18:03:12,Fail to pick,350,269,0,0,0,0,0,0,0,0,False,0
2025-01-08 18:03:12,persegiHijau,361,274,127,120,153,47,152,42,1,5,True,0.2939845720513506
2025-01-08 18:03:12,persegiHijau,336,254,124,126,25,37,22,39,3,2,True,0.4864684518853918
2025-01-08 18:03:12,persegiHijau,358,273,123,120,115,6,118,2,3,4,True,0.12724823663266088
2025-01-08 18:03:12,persegiHijau,344,260,122,121,129,27,132,30,3,3,True,0.3410376639951032
2025-01-08 18:03:12,persegiHijau,335,258,121,122,47,86,51,84,4,2,True,0.40242362358255424
2025-01-08 18:03:12,Fail to pick,335,258,0,0,0,0,0,0,0,0,False,0
2025-01-08 18:03:13,persegiHijau,331,257,127,125,124,89,124,92,0,3,True,0.16085511033476166
2025-01-08 18:03:13,Fail to pick,331,257,0,0,0,0,0,0,0,0,False,0
2025-01-08 18:03:13,persegiHijau,341,252,120,123,183,31,187,34,4,3,True,0.29929324225208986
2025-01-08 18:03:13,persegiHijau,329,258,122,125,22,75,24,74,2,1,True,0.19758915007885727
2025-01-08 18:03:13,persegiHijau,330,259,118,118,103,19,98,16,5,3,True,0.3190255275033063
2025-01-08 18:03:13,Hijau,330,259,tensor(118.7588),tensor(118.7230),128,30,131,28,3,2,True,0.0004990100860595703
2025-01-08 18:03:13,Fail to pick,330,259,0,0,0,0,0,0,0,0,False,0
2025-01-08 18:03:13,persegiHijau,365,274,126,121,144,16,142,13,2,3,True,0.14324515011439695
2025-01-08 18:03:13,persegiHijau,337,255,122,123,181,53,184,48,3,5,True,0.163437842121732
2025-01-08 18:03:13,persegiHijau,358,273,126,118,194,23,193,18,1,5,True,0.13596637740153625
2025-01-08 18:03:13,persegiHijau,330,260,121,118,26,60,21,63,5,3,True,0.3718780064434303
2025-01-08 18:03:13,persegiHijau,352,271,127,122,52,0,47,-2,5,2,True,0.28552662422351693
2025-01-08 18:03:14,persegiHijau,339,256,123,120,67,71,65,68,2,3,True,0.20289654502997756
2025-01-08 18:03:14,persegiHijau,331,255,119,123,141,73,138,70,3,3,True,0.29621933430931435
2025-01-08 18:03:14,Fail to pick,331,255,0,0,0,0,0,0,0,0,False,0
2025-01-08 18:03:14,persegiHijau,364,281,130,118,159,16,163,14,4,2,True,0.15381437510559298
2025-01-08 18:03:14,persegiHijau,368,281,128,116,18,43,22,44,4,1,False,0.4891244373279996
2025-01-08 18:03:14,Hijau,368,281,tensor(128.9760),tensor(116.0191),121,34,119,37,2,3,True,0.0004987716674804688
2025-01-08 18:03:14,Fail to pick,368,281,0,0,0,0,0,0,0,0,False,0
2025-01-08 18:03:14,persegiHijau,336,254,122,122,72,77,76,77,4,0,True,0.2325872000882152
2025-01-08 18:03:14,persegiHijau,359,273,128,123,18,16,14,16,4,0,True,0.124598366143784
2025-01-08 18:03:14,persegiHijau,336,263,124,128,146,49,150,51,4,2,True,0.4412441208081871
2025-01-08 18:03:14,persegiHijau,364,272,127,124,26,27,24,23,2,4,True,0.130481066347047
2025-01-08 18:03:15,persegiHijau,334,258,123,124,157,53,160,49,3,4,True,0.36625852089647803
2025-01-08 18:03:29,persegiHijau,285,265,115,124,153,64,153,63,0,1,False,0.3961579370286613
2025-01-08 18:03:29,Hijau,285,265,tensor(115.4916),tensor(124.2125),126,26,124,27,2,1,True,0.0005066394805908203
2025-01-08 18:03:29,persegiHijau,327,287,124,118,76,63,72,64,4,1,True,0.31175995104679793
2025-01-08 18:03:29,persegiHijau,335,278,120,115,69,34,64,32,5,2,True,0.18257426566534854
2025-01-08 18:03:29,Fail to pick,335,278,0,0,0,0,0,0,0,0,False,0
2025-01-08 18:03:29,persegiHijau,335,280,120,115,128,19,130,19,2,0,True,0.30356253688864643
2025-01-08 18:03:29,Fail to pick,335,280,0,0,0,0,0,0,0,0,False,0
2025-01-08 18:03:29,persegiHijau,290,265,115,120,126,1,123,-3,3,4,True,0.4517262794337493
2025-01-08 18:03:29,persegiHijau,327,282,124,117,90,68,94,70,4,2,True,0.23843295613654247
2025-01-08 18:03:30,persegiHijau,292,255,115,117,124,50,126,49,2,1,True,0.3322111243876923
2025-01-08 18:03:30,persegiHijau,336,288,121,111,191,72,192,71,1,1,True,0.23078132801389742
2025-01-08 18:03:30,persegiHijau,326,282,122,115,167,37,162,32,5,5,True,0.38160561142752825
2025-01-08 18:03:30,persegiHijau,324,286,124,113,80,94,84,93,4,1,True,0.11990976484787047
2025-01-08 18:03:30,Fail to pick,324,286,0,0,0,0,0,0,0,0,False,0
2025-01-08 18:03:30,persegiHijau,290,260,118,117,55,14,53,11,2,3,True,0.33437089819462884
2025-01-08 18:03:30,Hijau,290,260,tensor(118.7292),tensor(117.1277),127,26,122,23,5,3,True,0.0
2025-01-08 18:03:30,persegiHijau,318,282,125,111,194,42,191,45,3,3,True,0.47976356749126514
2025-01-08 18:03:30,persegiHijau,328,288,122,113,26,59,28,56,2,3,True,0.20779710691522713
2025-01-08 18:03:30,persegiHijau,330,290,120,115,167,93,170,94,3,1,True,0.3589572430202187
2025-01-08 18:03:30,Fail to pick,330,290,0,0,0,0,0,0,0,0,False,0
2025-01-08 18:03:30,persegiHijau,312,276,121,123,118,22,114,24,4,2,True,0.1189853574956859
2025-01-08 18:03:47,persegiBiru,692,497,135,120,98,91,94,91,4,0,True,0.4520190318504115
2025-01-08 18:03:47,Biru,692,497,tensor(135.0323),tensor(120.3506),61,64,61,67,0,3,True,0.0005044937133789062
2025-01-08 18:03:47,persegiBiru,706,492,130,117,190,62,190,57,0,5,True,0.3183742331388274
2025-01-08 18:03:47,persegiBiru,750,517,123,111,102,20,98,15,4,5,True,0.43065709730940693
2025-01-08 18:03:47,persegiBiru,738,514,128,112,94,12,89,15,5,3,True,0.13336881863222097
2025-01-08 18:03:48,persegiBiru,726,469,118,124,96,16,96,20,0,4,False,0.29890160420061584
2025-01-08 18:03:48,Biru,726,469,tensor(118.9100),tensor(124.1344),69,67,69,62,0,5,True,0.0
2025-01-08 18:03:48,persegiBiru,726,469,118,124,182,3,177,5,5,2,True,0.4246411577711212
2025-01-08 18:03:48,Fail to pick,726,469,0,0,0,0,0,0,0,0,False,0
2025-01-08 18:05:32,persegiBiru,755,462,134,124,133,39,129,43,4,4,True,0.1619226336813646
2025-01-08 18:05:32,Biru,755,462,tensor(134.4969),tensor(124.4038),71,69,72,69,1,0,True,0.000499725341796875
2025-01-08 18:05:33,persegiBiru,760,465,127,122,160,27,162,22,2,5,True,0.333929935941731
2025-01-08 18:05:33,Fail to pick,760,465,0,0,0,0,0,0,0,0,False,0
2025-01-08 18:05:34,persegiBiru,756,466,128,125,34,69,36,68,2,1,True,0.2794761056533813
2025-01-08 18:05:34,Biru,756,466,tensor(128.7856),tensor(125.6002),70,70,69,69,1,1,True,0.0004987716674804688
2025-01-08 18:05:34,Fail to pick,756,466,0,0,0,0,0,0,0,0,False,0
2025-01-08 18:05:34,persegiBiru,755,459,128,129,11,80,8,83,3,3,True,0.30495638225596444
2025-01-08 18:05:34,Fail to pick,755,459,0,0,0,0,0,0,0,0,False,0
2025-01-08 18:05:46,persegiMerah,727,160,127,134,146,54,142,57,4,3,True,0.4026144865139897
2025-01-08 18:05:46,Merah,727,160,tensor(127.4984),tensor(134.1446),155,67,157,67,2,0,True,0.0004992485046386719
2025-01-08 18:05:46,persegiMerah,712,162,126,131,67,8,62,3,5,5,True,0.10293346175310375
2025-01-08 18:05:46,persegiMerah,703,164,123,128,6,85,8,80,2,5,True,0.19310350804228543
2025-01-08 18:05:46,Fail to pick,703,164,0,0,0,0,0,0,0,0,False,0
2025-01-08 18:05:46,persegiMerah,733,163,130,130,120,74,116,76,4,2,True,0.2564659157611837
2025-01-08 18:05:47,persegiMerah,756,175,133,134,8,9,6,4,2,5,True,0.4578156197313644
2025-01-08 18:05:47,Merah,756,175,tensor(133.2937),tensor(134.4655),151,70,155,68,4,2,True,0.0004990100860595703
2025-01-08 18:05:47,persegiMerah,733,167,130,132,49,70,48,71,1,1,True,0.4592263068593456
2025-01-08 18:05:48,persegiMerah,736,166,130,131,37,32,39,33,2,1,False,0.1952074257928921
2025-01-08 18:05:48,Fail to pick,736,166,0,0,0,0,0,0,0,0,False,0
2025-01-08 18:05:48,persegiMerah,734,174,135,130,36,4,38,5,2,1,True,0.1745765495298585
2025-01-08 18:05:48,Fail to pick,734,174,0,0,0,0,0,0,0,0,False,0
2025-01-08 18:05:48,persegiMerah,723,159,128,130,87,1,83,4,4,3,True,0.3448119777742086
2025-01-08 18:05:48,persegiMerah,708,163,127,135,11,89,8,89,3,0,True,0.20515256789598948
2025-01-08 18:05:48,Merah,708,163,tensor(127.9536),tensor(135.9773),154,65,151,66,3,1,True,0.0
2025-01-08 18:05:49,persegiMerah,708,163,127,135,59,51,60,55,1,4,True,0.19832328628512103
2025-01-08 18:05:49,Fail to pick,708,163,0,0,0,0,0,0,0,0,False,0
2025-01-08 18:05:49,persegiMerah,733,190,131,127,118,32,114,36,4,4,False,0.16466871040946834
2025-01-08 18:05:54,persegiKuning,744,190,113,114,116,34,115,38,1,4,False,0.35420798069351245
2025-01-08 18:05:54,Kuning,744,190,tensor(113.7581),tensor(114.1299),147,68,147,67,0,1,True,0.0
2025-01-08 18:05:54,persegiKuning,737,196,115,115,64,64,64,61,0,3,True,0.31674529101316495
2025-01-08 18:05:54,Fail to pick,737,196,0,0,0,0,0,0,0,0,False,0
2025-01-08 18:05:54,persegiKuning,742,194,118,115,165,16,160,14,5,2,True,0.39450100753803063
2025-01-08 18:05:54,Fail to pick,742,194,0,0,0,0,0,0,0,0,False,0
2025-01-08 18:05:56,persegiBiru,739,186,121,118,135,29,130,27,5,2,True,0.21194808830991663
2025-01-08 18:05:56,Biru,739,186,tensor(121.9911),tensor(118.1211),148,68,146,67,2,1,True,0.0005042552947998047
2025-01-08 18:05:56,Fail to pick,739,186,0,0,0,0,0,0,0,0,False,0
2025-01-08 18:05:56,persegiBiru,743,190,121,117,12,60,9,62,3,2,True,0.13660297089257317
2025-01-08 18:05:56,Fail to pick,743,190,0,0,0,0,0,0,0,0,False,0
2025-01-08 18:05:56,persegiBiru,734,189,122,116,24,98,28,97,4,1,True,0.3014847356517928
2025-01-08 18:05:56,Fail to pick,734,189,0,0,0,0,0,0,0,0,False,0
2025-01-08 18:05:56,persegiBiru,735,181,122,115,189,78,190,78,1,0,True,0.17762317024280244
2025-01-08 18:05:56,Fail to pick,735,181,0,0,0,0,0,0,0,0,False,0
2025-01-08 18:05:56,persegiBiru,687,172,116,120,104,97,104,99,0,2,True,0.2140386554383702
2025-01-08 18:05:59,persegiBiru,696,291,117,116,180,69,178,70,2,1,False,0.14390485068808131
2025-01-08 18:05:59,Biru,696,291,tensor(117.8109),tensor(116.1069),119,64,121,64,2,0,True,0.0
2025-01-08 18:06:00,persegiBiru,702,298,116,115,56,1,56,-2,0,3,True,0.41372940935506075
2025-01-08 18:06:00,Fail to pick,702,298,0,0,0,0,0,0,0,0,False,0
2025-01-08 18:06:01,persegiBiru,756,332,122,108,22,7,24,5,2,2,True,0.10298685228851144
2025-01-08 18:06:01,Biru,756,332,tensor(122.3486),tensor(108.2546),107,70,109,68,2,2,True,0.0
2025-01-08 18:06:02,persegiBiru,739,317,117,111,41,6,45,6,4,0,True,0.40411865278040215
2025-01-08 18:06:02,Biru,739,317,tensor(117.7882),tensor(111.8095),111,68,107,63,4,5,True,0.0
2025-01-08 18:06:02,persegiBiru,754,323,117,112,4,93,4,93,0,0,True,0.17180519824748366
2025-01-08 18:06:02,persegiBiru,739,316,118,110,54,41,49,39,5,2,False,0.3834211319251003
2025-01-08 18:06:02,persegiBiru,734,321,120,111,137,98,135,96,2,2,True,0.2004901109517336
2025-01-08 18:06:02,Fail to pick,734,321,0,0,0,0,0,0,0,0,False,0
2025-01-08 18:06:03,persegiBiru,737,326,120,112,1,38,-3,34,4,4,True,0.43417590173848464
2025-01-08 18:06:03,Fail to pick,737,326,0,0,0,0,0,0,0,0,False,0
2025-01-08 18:06:03,persegiBiru,746,330,126,113,72,67,67,63,5,4,True,0.32055746401161134
2025-01-08 18:06:03,Fail to pick,746,330,0,0,0,0,0,0,0,0,False,0
2025-01-08 18:06:03,persegiBiru,730,327,118,111,126,40,128,41,2,1,True,0.4474431088216404
2025-01-08 18:06:03,persegiMerah,748,327,118,114,71,84,72,88,1,4,True,0.30315258002489204
2025-01-08 18:06:03,Merah,748,327,tensor(118.7636),tensor(114.0678),109,69,109,73,0,4,True,0.0
2025-01-08 18:06:03,persegiBiru,751,330,117,114,122,23,120,24,2,1,True,0.25879454949549296
2025-01-08 18:06:03,Fail to pick,751,330,0,0,0,0,0,0,0,0,False,0
2025-01-08 18:06:03,persegiBiru,748,329,119,114,123,38,118,33,5,5,True,0.1422162585948947
2025-01-08 18:06:03,Fail to pick,748,329,0,0,0,0,0,0,0,0,False,0
2025-01-08 18:06:03,persegiBiru,744,325,115,110,8,69,9,67,1,2,True,0.3611904095741286
2025-01-08 18:06:03,Fail to pick,744,325,0,0,0,0,0,0,0,0,False,0
2025-01-08 18:06:04,persegiBiru,751,332,117,111,114,66,114,63,0,3,True,0.3586694837041263
2025-01-08 18:06:04,Fail to pick,751,332,0,0,0,0,0,0,0,0,False,0
2025-01-08 18:06:10,persegiMerah,750,327,121,115,168,5,167,9,1,4,True,0.20109204295383787
2025-01-08 18:06:10,Merah,750,327,tensor(121.1264),tensor(115.9354),109,69,111,70,2,1,True,0.0004990100860595703
2025-01-08 18:06:10,Fail to pick,750,327,0,0,0,0,0,0,0,0,False,0
2025-01-08 18:06:10,persegiMerah,738,324,119,114,102,4,100,5,2,1,True,0.23575818434388474
2025-01-08 18:06:10,persegiBiru,751,332,119,111,175,90,175,93,0,3,True,0.4193158874938142
2025-01-08 18:06:11,persegiBiru,740,324,119,110,118,31,120,35,2,4,True,0.2161126205701026
2025-01-08 18:06:11,Biru,740,324,tensor(119.3527),tensor(110.1477),110,68,113,71,3,3,True,0.0
2025-01-08 18:06:11,persegiBiru,750,329,121,107,53,41,52,37,1,4,True,0.38527520533838
2025-01-08 18:06:11,persegiBiru,748,327,119,108,84,10,87,7,3,3,True,0.18708982512535868
2025-01-08 18:06:11,Fail to pick,748,327,0,0,0,0,0,0,0,0,False,0
2025-01-08 18:06:11,persegiBiru,725,304,118,115,196,47,198,42,2,5,True,0.3749896186411861
2025-01-08 18:06:12,persegiMerah,737,324,119,123,95,99,92,103,3,4,True,0.23864433292850726
2025-01-08 18:06:13,persegiMerah,706,297,124,130,79,67,83,66,4,1,True,0.21738558398197957
2025-01-08 18:06:13,Merah,706,297,tensor(124.1539),tensor(130.3644),117,65,120,60,3,5,True,0.0005280971527099609
2025-01-08 18:06:14,persegiMerah,737,322,126,127,143,20,144,16,1,4,True,0.23007099754307656
2025-01-08 18:06:16,persegiBiru,738,322,121,119,143,84,138,79,5,5,True,0.2650004168068886
2025-01-08 18:06:16,Biru,738,322,tensor(121.2637),tensor(119.7558),110,68,111,72,1,4,True,0.0
2025-01-08 18:06:16,Fail to pick,738,322,0,0,0,0,0,0,0,0,False,0
2025-01-08 18:06:16,persegiBiru,750,322,120,115,95,6,97,1,2,5,True,0.4846519292467443
2025-01-08 18:06:17,persegiBiru,745,318,123,116,6,60,6,58,0,2,True,0.14898182799608214
2025-01-08 18:06:17,Fail to pick,745,318,0,0,0,0,0,0,0,0,False,0
2025-01-08 18:06:17,persegiBiru,752,320,117,112,31,79,28,75,3,4,True,0.3461279677005123
2025-01-08 18:06:17,Fail to pick,752,320,0,0,0,0,0,0,0,0,False,0
2025-01-08 18:06:17,persegiBiru,765,282,114,122,6,6,3,3,3,3,True,0.4925384036375602
2025-01-08 18:06:17,Biru,765,282,tensor(114.5988),tensor(122.0131),121,70,120,68,1,2,True,0.0004999637603759766
2025-01-08 18:07:07,persegiMerah,863,313,134,132,2,62,4,62,2,0,True,0.13598900362372365
2025-01-08 18:07:07,Merah,863,313,tensor(134.2827),tensor(132.4673),113,79,110,78,3,1,True,0.000507354736328125
2025-01-08 18:07:07,persegiMerah,758,254,125,140,54,88,57,89,3,1,True,0.3524205163299088
2025-01-08 18:07:07,persegiMerah,757,245,127,145,134,29,130,33,4,4,True,0.2328946109365544
2025-01-08 18:07:07,Fail to pick,757,245,0,0,0,0,0,0,0,0,False,0
2025-01-08 18:07:07,persegiMerah,773,250,124,143,85,53,88,48,3,5,True,0.19634121508163857
2025-01-08 18:07:07,persegiMerah,783,241,127,139,193,27,194,31,1,4,True,0.2960628177432262
2025-01-08 18:07:07,persegiMerah,758,259,132,142,88,96,90,96,2,0,True,0.2371379826886828
2025-01-08 18:07:08,persegiMerah,760,233,136,152,107,9,110,9,3,0,True,0.22694543602322345
2025-01-08 18:07:08,Merah,760,233,tensor(136.3569),tensor(152.3906),135,70,139,71,4,1,True,0.0
2025-01-08 18:07:08,persegiMerah,758,237,134,150,157,44,153,45,4,1,True,0.16340143112455077
2025-01-08 18:07:08,Fail to pick,758,237,0,0,0,0,0,0,0,0,False,0
2025-01-08 18:07:08,persegiMerah,750,254,131,146,63,22,59,26,4,4,True,0.3533856437688436
2025-01-08 18:07:08,persegiMerah,760,241,133,147,100,59,103,55,3,4,True,0.3842723854871811
2025-01-08 18:07:08,persegiMerah,757,256,135,142,22,53,19,48,3,5,True,0.44924743379304255
2025-01-08 18:07:08,persegiMerah,768,241,135,147,70,7,67,3,3,4,True,0.15968742668287714
2025-01-08 18:07:08,persegiMerah,749,259,133,141,83,8,78,11,5,3,True,0.48853071474400833
2025-01-08 18:07:08,persegiMerah,769,234,132,144,64,43,67,39,3,4,True,0.2531865898274266
2025-01-08 18:07:09,persegiMerah,755,251,133,143,145,68,142,64,3,4,True,0.39998545639696226
2025-01-08 18:07:09,persegiMerah,761,249,129,139,107,59,102,56,5,3,True,0.34761862698865287
2025-01-08 18:07:09,Merah,761,249,tensor(129.8825),tensor(139.6132),130,70,127,66,3,4,True,0.0
2025-01-08 18:07:09,Fail to pick,761,249,0,0,0,0,0,0,0,0,False,0
2025-01-08 18:07:18,persegiBiru,749,484,122,112,28,90,26,92,2,2,True,0.29232127845747136
2025-01-08 18:07:18,Biru,749,484,tensor(122.1573),tensor(112.8683),65,69,60,64,5,5,True,0.0
2025-01-08 18:07:18,persegiBiru,745,451,122,120,85,75,86,75,1,0,True,0.2291360009471403
2025-01-08 18:07:18,persegiBiru,777,468,119,112,143,11,147,11,4,0,True,0.21394032636740695
2025-01-08 18:07:18,persegiBiru,776,446,119,116,76,68,77,70,1,2,True,0.20063566076238504
2025-01-08 18:07:18,persegiBiru,759,450,120,117,136,59,133,54,3,5,True,0.49096254613466384
2025-01-08 18:07:18,persegiBiru,742,484,128,120,60,66,58,65,2,1,True,0.3391886646613844
2025-01-08 18:07:18,persegiBiru,733,481,126,122,44,8,48,3,4,5,True,0.4175721534310427
2025-01-08 18:07:18,Fail to pick,733,481,0,0,0,0,0,0,0,0,False,0
2025-01-08 18:07:18,persegiBiru,737,479,124,124,140,40,142,39,2,1,True,0.2611881707089444
2025-01-08 18:07:18,Fail to pick,737,479,0,0,0,0,0,0,0,0,False,0
2025-01-08 18:07:19,persegiBiru,783,451,117,115,14,72,9,71,5,1,True,0.29900589554531765
2025-01-08 18:07:19,persegiBiru,771,442,121,114,128,35,132,34,4,1,True,0.3875432871014005
2025-01-08 18:07:19,persegiBiru,769,441,121,115,44,7,42,2,2,5,True,0.4863859810303508
2025-01-08 18:07:19,Biru,769,441,tensor(121.5589),tensor(115.6079),77,71,75,71,2,0,True,0.0
2025-01-08 18:07:19,Fail to pick,769,441,0,0,0,0,0,0,0,0,False,0
2025-01-08 18:07:19,persegiBiru,768,441,120,117,13,71,9,75,4,4,True,0.43398456050622425
2025-01-08 18:07:19,Fail to pick,768,441,0,0,0,0,0,0,0,0,False,0
2025-01-08 18:07:19,persegiBiru,751,444,122,120,145,12,142,12,3,0,True,0.2535905974520079
2025-01-08 18:07:19,persegiBiru,752,442,124,119,55,11,59,15,4,4,True,0.11289887747793861
2025-01-08 18:07:19,Fail to pick,752,442,0,0,0,0,0,0,0,0,False,0
2025-01-08 18:07:19,persegiBiru,766,442,119,114,178,51,176,51,2,0,False,0.3143844606328397
2025-01-08 18:07:19,persegiBiru,752,436,124,119,48,48,48,46,0,2,True,0.2732160509174797
2025-01-08 18:07:19,persegiBiru,757,431,129,121,32,69,30,73,2,4,True,0.4181744052027825
2025-01-08 18:07:19,Fail to pick,757,431,0,0,0,0,0,0,0,0,False,0
2025-01-08 18:07:19,persegiBiru,760,434,127,117,9,20,10,19,1,1,True,0.3250097289499111
2025-01-08 18:07:19,Fail to pick,760,434,0,0,0,0,0,0,0,0,False,0
2025-01-08 18:07:20,persegiBiru,753,434,123,116,1,15,2,19,1,4,True,0.21267756259039158
2025-01-08 18:07:20,Fail to pick,753,434,0,0,0,0,0,0,0,0,False,0
2025-01-08 18:07:20,persegiBiru,754,438,124,119,150,3,149,7,1,4,True,0.11700399864401914
2025-01-08 18:07:20,Fail to pick,754,438,0,0,0,0,0,0,0,0,False,0
2025-01-08 18:07:20,persegiBiru,750,441,122,117,147,57,148,61,1,4,True,0.11712527336749434
2025-01-08 18:07:20,Biru,750,441,tensor(122.6998),tensor(117.1703),77,69,73,67,4,2,True,0.0
2025-01-08 18:07:20,Fail to pick,750,441,0,0,0,0,0,0,0,0,False,0
2025-01-08 18:07:20,persegiBiru,745,479,126,111,118,65,121,63,3,2,True,0.3506087495416982
2025-01-08 18:07:20,persegiBiru,754,480,124,111,89,87,88,90,1,3,True,0.14525111571560526
2025-01-08 18:07:20,Fail to pick,754,480,0,0,0,0,0,0,0,0,False,0
2025-01-08 18:07:20,persegiBiru,747,435,126,113,135,50,137,49,2,1,True,0.48720859776091996
2025-01-08 18:07:20,persegiBiru,748,437,125,118,198,87,202,84,4,3,True,0.24201850673772782
2025-01-08 18:07:20,Fail to pick,748,437,0,0,0,0,0,0,0,0,False,0
2025-01-08 18:07:20,persegiBiru,748,440,125,119,29,53,25,55,4,2,True,0.46689337734823166
2025-01-08 18:07:20,Fail to pick,748,440,0,0,0,0,0,0,0,0,False,0
2025-01-08 18:07:20,persegiBiru,752,472,128,115,114,19,114,21,0,2,True,0.34242493888486836
2025-01-08 18:07:21,persegiBiru,763,449,127,115,192,58,196,58,4,0,True,0.2741543060084143
2025-01-08 18:07:21,persegiBiru,776,446,129,115,43,61,41,57,2,4,True,0.43317211981282455
2025-01-08 18:07:21,persegiBiru,760,439,127,117,157,29,161,27,4,2,True,0.11398756433477525
2025-01-08 18:07:21,Biru,760,439,tensor(127.8214),tensor(117.1565),78,70,74,68,4,2,True,0.0
2025-01-08 18:07:28,persegiBiru,784,155,130,131,146,59,146,63,0,4,False,0.4910541287046696
2025-01-08 18:07:28,Biru,784,155,tensor(130.1829),tensor(131.9765),156,72,160,68,4,4,True,0.0
2025-01-08 18:07:28,persegiBiru,826,169,121,120,189,31,187,26,2,5,True,0.4032953619872335
2025-01-08 18:07:28,persegiBiru,818,139,117,121,173,12,175,8,2,4,True,0.4093403433614544
2025-01-08 18:07:28,persegiBiru,864,167,119,116,82,41,79,44,3,3,True,0.2897627477837944
2025-01-08 18:07:28,persegiBiru,838,161,116,116,50,26,54,26,4,0,True,0.15077310842009967
2025-01-08 18:07:29,persegiBiru,909,183,122,123,79,79,79,76,0,3,True,0.4483932231662774
2025-01-08 18:07:29,persegiBiru,881,204,129,128,157,64,154,68,3,4,True,0.32498229446123733
2025-01-08 18:07:29,persegiBiru,898,187,120,116,54,55,53,54,1,1,True,0.30400119466687303
2025-01-08 18:07:29,persegiBiru,849,84,134,137,196,81,191,76,5,5,True,0.1809750778755621
2025-01-08 18:07:29,Biru,849,84,tensor(134.1641),tensor(137.9617),176,78,175,75,1,3,True,0.0005059242248535156
2025-01-08 18:07:29,persegiBiru,890,196,127,126,136,92,132,90,4,2,False,0.2274959513591071
2025-01-08 18:07:29,persegiBiru,879,154,124,125,2,94,4,95,2,1,True,0.15362061852518655
2025-01-08 18:07:29,persegiBiru,884,156,121,123,158,72,160,73,2,1,True,0.23060520800828851
2025-01-08 18:07:29,Fail to pick,884,156,0,0,0,0,0,0,0,0,False,0
2025-01-08 18:07:30,persegiBiru,881,153,123,127,93,24,90,23,3,1,True,0.13466979559254277
2025-01-08 18:07:30,Fail to pick,881,153,0,0,0,0,0,0,0,0,False,0
2025-01-08 18:07:30,persegiBiru,885,163,121,121,37,43,39,45,2,2,True,0.18689506916850696
2025-01-08 18:07:30,persegiBiru,885,149,121,124,127,46,128,44,1,2,True,0.49573117949136436
2025-01-08 18:07:30,persegiBiru,858,116,128,129,104,50,100,52,4,2,True,0.2937354544279276
2025-01-08 18:07:30,persegiBiru,880,159,120,118,165,83,165,83,0,0,False,0.4844240041893936
2025-01-08 18:07:30,persegiBiru,902,170,118,118,134,85,132,89,2,4,True,0.12099179153488954
2025-01-08 18:07:30,persegiBiru,883,146,121,122,59,35,58,39,1,4,True,0.26675575201628265
2025-01-08 18:07:30,Biru,883,146,tensor(121.1704),tensor(122.2895),159,81,160,81,1,0,True,0.0
2025-01-08 18:07:30,persegiBiru,873,141,124,124,3,54,7,53,4,1,True,0.36166070722122123
2025-01-08 18:07:30,persegiBiru,869,149,120,119,4,7,7,10,3,3,True,0.3800661864635646
2025-01-08 18:07:30,Fail to pick,869,149,0,0,0,0,0,0,0,0,False,0
2025-01-08 18:07:31,persegiBiru,918,177,116,113,10,54,7,56,3,2,True,0.4184467916726555
2025-01-08 18:07:31,persegiBiru,918,181,122,114,12,6,9,2,3,4,True,0.10055774482951857
2025-01-08 18:07:31,Fail to pick,918,181,0,0,0,0,0,0,0,0,False,0
2025-01-08 18:07:31,persegiBiru,887,139,121,119,28,51,26,47,2,4,True,0.4780159611179725
2025-01-08 18:07:31,persegiBiru,911,177,121,111,32,32,31,34,1,2,True,0.14652548981874822
2025-01-08 18:07:31,persegiBiru,874,143,124,118,139,61,138,63,1,2,True,0.10597066969767505
2025-01-08 18:07:31,persegiBiru,876,147,121,119,13,93,10,90,3,3,False,0.4594181138968718
2025-01-08 18:07:31,Fail to pick,876,147,0,0,0,0,0,0,0,0,False,0
2025-01-08 18:07:31,persegiBiru,868,157,119,118,11,24,9,23,2,1,True,0.2669311180846876
2025-01-08 18:07:31,Biru,868,157,tensor(119.7316),tensor(118.2249),156,80,153,80,3,0,True,0.0
2025-01-08 18:07:31,persegiBiru,914,176,116,114,187,36,186,35,1,1,True,0.11012253623940711
2025-01-08 18:07:31,persegiBiru,882,158,112,116,155,14,152,11,3,3,False,0.3819391375242037
2025-01-08 18:07:32,persegiBiru,927,193,116,115,156,67,152,70,4,3,True,0.175837298063922
2025-01-08 18:07:32,persegiBiru,914,185,119,112,68,93,70,88,2,5,True,0.11649890762088365
2025-01-08 18:07:32,persegiBiru,913,190,119,113,191,64,192,67,1,3,False,0.4258778508848492
2025-01-08 18:07:32,Fail to pick,913,190,0,0,0,0,0,0,0,0,False,0
2025-01-08 18:07:32,persegiBiru,879,141,122,127,119,65,121,63,2,2,True,0.3119112515488379
2025-01-08 18:07:32,persegiBiru,866,154,127,124,117,10,120,11,3,1,True,0.35766834870488384
2025-01-08 18:07:32,persegiBiru,873,151,117,115,160,42,161,38,1,4,True,0.40292431887771385
2025-01-08 18:07:32,Fail to pick,873,151,0,0,0,0,0,0,0,0,False,0
2025-01-08 18:07:32,persegiBiru,907,180,121,114,10,3,11,1,1,2,True,0.3591068616162113
2025-01-08 18:07:32,persegiBiru,861,160,119,115,128,56,123,58,5,2,True,0.2359731334483137
2025-01-08 18:07:32,Biru,861,160,tensor(119.2023),tensor(115.2762),155,79,156,78,1,1,True,0.000499725341796875
2025-01-08 18:07:32,persegiBiru,847,104,124,130,153,22,149,20,4,2,True,0.33412736106153984
2025-01-08 18:07:33,persegiBiru,863,153,122,118,185,90,189,93,4,3,True,0.17736198974073175
2025-01-08 18:07:33,persegiBiru,905,178,118,111,157,92,153,91,4,1,False,0.32502378962764056
2025-01-08 18:07:33,persegiBiru,919,181,121,114,86,54,90,55,4,1,True,0.1616985123279765
2025-01-08 18:07:33,persegiBiru,897,165,122,115,42,81,44,84,2,3,False,0.3174443796260314
2025-01-08 18:07:33,persegiBiru,859,156,122,121,119,74,121,76,2,2,True,0.4090720100525934
2025-01-08 18:07:34,persegiBiru,907,181,121,113,69,54,73,49,4,5,True,0.14799094548069358
2025-01-08 18:07:34,Biru,907,181,tensor(121.2983),tensor(113.4997),149,83,144,84,5,1,True,0.0
2025-01-08 18:07:34,persegiBiru,863,168,116,110,90,33,85,32,5,1,True,0.18031824800752633
2025-01-08 18:07:34,persegiBiru,913,184,125,114,154,51,158,49,4,2,True,0.3816305533760198
2025-01-08 18:07:34,persegiBiru,889,155,124,121,119,18,116,16,3,2,True,0.32234295354380543
2025-01-08 18:07:34,persegiBiru,909,181,120,113,147,65,148,62,1,3,True,0.12065002637706788
2025-01-08 18:07:34,persegiBiru,919,177,119,113,177,45,174,48,3,3,False,0.31588732411589215
2025-01-08 18:07:34,persegiBiru,944,218,124,118,182,61,182,60,0,1,True,0.1940162433947324
2025-01-08 18:07:34,persegiBiru,944,218,124,118,133,98,137,93,4,5,True,0.45450586680645444
2025-01-08 18:07:34,Fail to pick,944,218,0,0,0,0,0,0,0,0,False,0
2025-01-08 18:07:34,persegiBiru,964,225,124,118,116,16,119,15,3,1,True,0.15767048718728965
2025-01-08 18:07:35,persegiBiru,944,218,122,120,102,91,104,88,2,3,True,0.27997342934248204
2025-01-08 18:07:35,persegiBiru,944,218,120,118,150,23,148,26,2,3,False,0.15920617117281652
2025-01-08 18:07:35,Biru,944,218,tensor(120.8434),tensor(118.0844),139,87,134,86,5,1,True,0.0
2025-01-08 18:07:35,Fail to pick,944,218,0,0,0,0,0,0,0,0,False,0
2025-01-08 18:07:35,persegiBiru,937,213,122,118,55,98,56,102,1,4,True,0.18269997740400656
2025-01-08 18:07:35,Fail to pick,937,213,0,0,0,0,0,0,0,0,False,0
2025-01-08 18:07:35,persegiBiru,989,231,132,120,168,19,167,16,1,3,True,0.36361754742164476
2025-01-08 18:07:35,persegiBiru,899,198,126,128,120,30,117,27,3,3,True,0.3942849322478178
2025-01-08 18:08:10,persegiBiru,289,278,123,122,153,14,149,18,4,4,True,0.4293370149803859
2025-01-08 18:08:10,Biru,289,278,tensor(123.2055),tensor(122.5703),122,26,120,21,2,5,True,0.0004982948303222656
2025-01-08 18:08:11,persegiBiru,360,274,127,123,60,35,62,35,2,0,False,0.48950973408154874
2025-01-08 18:08:11,persegiBiru,338,291,124,123,40,67,38,63,2,4,True,0.34458918697668084
2025-01-08 18:08:11,persegiBiru,294,271,121,122,118,6,116,8,2,2,True,0.2691886554462023
2025-01-08 18:08:11,persegiBiru,289,279,125,121,48,72,43,70,5,2,True,0.3179976874129755
2025-01-08 18:08:11,Fail to pick,289,279,0,0,0,0,0,0,0,0,False,0
2025-01-08 18:08:11,persegiBiru,291,275,121,122,144,0,146,1,2,1,True,0.2162715674543764
2025-01-08 18:08:11,Fail to pick,291,275,0,0,0,0,0,0,0,0,False,0
2025-01-08 18:08:11,persegiBiru,315,270,119,121,29,70,32,65,3,5,True,0.22695621696000434
2025-01-08 18:08:11,persegiBiru,304,267,119,122,73,50,72,50,1,0,True,0.21084325528827855
2025-01-08 18:08:11,persegiBiru,340,288,126,121,71,6,72,7,1,1,True,0.46094683220724686
2025-01-08 18:08:11,persegiBiru,296,313,135,120,188,13,186,16,2,3,True,0.20951587133759886
2025-01-08 18:08:11,Biru,296,313,tensor(135.6887),tensor(120.8775),113,27,112,27,1,0,True,0.0004994869232177734
2025-01-08 18:08:12,persegiBiru,295,278,123,123,192,32,190,34,2,2,True,0.15757995191935442
2025-01-08 18:08:12,persegiBiru,343,294,123,121,59,4,54,8,5,4,False,0.2913242037104148
2025-01-08 18:08:12,persegiBiru,292,319,138,126,122,83,126,87,4,4,True,0.21466924737425197
2025-01-08 18:08:12,persegiBiru,350,288,123,120,44,96,45,97,1,1,True,0.35357839500934884
2025-01-08 18:08:12,persegiBiru,282,324,139,121,121,46,119,43,2,3,True,0.4325447282794911
2025-01-08 18:08:12,persegiBiru,308,312,132,120,171,29,175,33,4,4,False,0.36131184533455674
2025-01-08 18:08:12,persegiBiru,350,291,122,123,60,4,62,8,2,4,False,0.2025524927659316
2025-01-08 18:08:12,persegiBiru,345,295,122,121,57,30,52,28,5,2,True,0.4576382461711077
2025-01-08 18:08:12,Fail to pick,345,295,0,0,0,0,0,0,0,0,False,0
2025-01-08 18:08:13,persegiBiru,241,309,136,123,152,19,150,20,2,1,True,0.2219436908107525
2025-01-08 18:08:13,Biru,241,309,tensor(136.7319),tensor(123.9321),114,22,115,17,1,5,True,0.0
2025-01-08 18:08:13,persegiBiru,298,314,132,120,43,30,42,33,1,3,False,0.18979350305368975
2025-01-08 18:08:23,persegiBiru,409,63,117,120,28,19,27,23,1,4,True,0.4964585218979608
2025-01-08 18:08:23,Biru,409,63,tensor(117.0279),tensor(120.8298),182,37,180,34,2,3,True,0.0004990100860595703
2025-01-08 18:08:23,persegiBiru,423,72,115,110,75,52,75,52,0,0,False,0.29114571836315095
2025-01-08 18:08:23,persegiBiru,417,66,112,114,176,61,175,61,1,0,True,0.21784332202875212
2025-01-08 18:08:23,Fail to pick,417,66,0,0,0,0,0,0,0,0,False,0
2025-01-08 18:08:24,persegiBiru,415,68,114,113,53,50,55,53,2,3,False,0.465328167365776
2025-01-08 18:08:24,Fail to pick,415,68,0,0,0,0,0,0,0,0,False,0
2025-01-08 18:08:24,persegiBiru,414,64,115,117,126,87,129,91,3,4,True,0.2624766695020551
2025-01-08 18:08:24,Fail to pick,414,64,0,0,0,0,0,0,0,0,False,0
2025-01-08 18:08:24,persegiBiru,412,67,116,116,151,73,147,68,4,5,False,0.43197201292627563
2025-01-08 18:08:24,Fail to pick,412,67,0,0,0,0,0,0,0,0,False,0
2025-01-08 18:08:24,persegiBiru,418,65,114,115,37,47,37,42,0,5,True,0.43967953106667146
2025-01-08 18:08:24,Fail to pick,418,65,0,0,0,0,0,0,0,0,False,0
2025-01-08 18:08:24,persegiBiru,415,68,114,113,148,9,152,10,4,1,True,0.44202328643674593
2025-01-08 18:08:24,Fail to pick,415,68,0,0,0,0,0,0,0,0,False,0
2025-01-08 18:08:24,persegiBiru,413,73,115,115,154,8,157,7,3,1,False,0.12843725776254533
2025-01-08 18:08:24,Fail to pick,413,73,0,0,0,0,0,0,0,0,False,0
2025-01-08 18:08:24,persegiBiru,456,93,118,115,174,12,178,15,4,3,True,0.15025246882786783
2025-01-08 18:08:24,persegiBiru,417,64,114,122,147,16,144,14,3,2,True,0.23916122641065068
2025-01-08 18:08:24,Biru,417,64,tensor(114.1746),tensor(122.0903),182,38,182,37,0,1,True,0.0004990100860595703
2025-01-08 18:08:24,persegiBiru,467,103,121,118,149,79,149,79,0,0,True,0.21291473063460906
2025-01-08 18:08:25,persegiBiru,412,65,117,117,49,61,49,61,0,0,True,0.4149761727656205
2025-01-08 18:08:25,persegiBiru,413,62,117,120,128,40,130,44,2,4,True,0.42102606795423914
2025-01-08 18:08:25,Fail to pick,413,62,0,0,0,0,0,0,0,0,False,0
2025-01-08 18:08:25,persegiBiru,410,69,112,114,122,35,126,31,4,4,True,0.12144780584352827
2025-01-08 18:08:25,Fail to pick,410,69,0,0,0,0,0,0,0,0,False,0
2025-01-08 18:08:25,persegiBiru,467,108,121,117,114,19,114,16,0,3,True,0.31144230560219244
2025-01-08 18:08:25,persegiBiru,418,64,115,117,32,48,33,46,1,2,True,0.4257376071365123
2025-01-08 18:08:25,persegiBiru,415,64,113,116,125,39,124,37,1,2,True,0.15143732640471574
2025-01-08 18:08:25,Fail to pick,415,64,0,0,0,0,0,0,0,0,False,0
2025-01-08 18:08:25,persegiBiru,467,99,124,113,167,42,171,40,4,2,True,0.12061273399700312
2025-01-08 18:08:25,persegiBiru,416,65,114,115,57,64,60,61,3,3,True,0.2910011335647653
2025-01-08 18:08:25,Biru,416,65,tensor(114.6137),tensor(115.9063),181,38,184,38,3,0,True,0.0
2025-01-08 18:08:25,persegiBiru,415,67,114,114,180,82,183,80,3,2,True,0.19097851057925497
2025-01-08 18:08:25,Fail to pick,415,67,0,0,0,0,0,0,0,0,False,0
2025-01-08 18:08:26,persegiBiru,421,69,114,110,70,64,68,61,2,3,False,0.34797742101731777
2025-01-08 18:08:26,Fail to pick,421,69,0,0,0,0,0,0,0,0,False,0
2025-01-08 18:08:26,persegiBiru,454,91,117,113,151,79,147,83,4,4,True,0.2400497466308313
2025-01-08 18:08:26,persegiBiru,474,101,122,115,14,57,11,52,3,5,True,0.10010973538096897
2025-01-08 18:08:26,persegiBiru,414,67,114,115,83,50,78,47,5,3,True,0.4766063198937516
2025-01-08 18:08:26,persegiBiru,410,68,112,113,156,97,160,95,4,2,True,0.415118017346764
2025-01-08 18:08:26,Fail to pick,410,68,0,0,0,0,0,0,0,0,False,0
2025-01-08 18:08:26,persegiBiru,418,66,111,113,49,53,44,51,5,2,True,0.16240306660283205
2025-01-08 18:08:26,Fail to pick,418,66,0,0,0,0,0,0,0,0,False,0
2025-01-08 18:08:32,persegiBiru,735,392,126,110,54,57,56,53,2,4,True,0.2821677228695382
2025-01-08 18:08:32,Biru,735,392,tensor(126.8476),tensor(110.9909),91,68,89,70,2,2,True,0.0004994869232177734
2025-01-08 18:08:32,persegiBiru,752,443,124,110,21,81,16,83,5,2,True,0.24935373601745298
2025-01-08 18:08:32,persegiBiru,751,418,125,112,62,40,58,36,4,4,True,0.4090236311076362
2025-01-08 18:08:32,persegiBiru,732,367,124,116,16,72,15,75,1,3,True,0.2266715074965319
2025-01-08 18:08:32,persegiBiru,728,351,124,120,94,48,96,49,2,1,True,0.36783642646320147
2025-01-08 18:08:33,persegiBiru,776,374,122,111,105,45,108,47,3,2,True,0.3415228450907975
2025-01-08 18:08:33,persegiBiru,756,387,128,107,175,31,175,31,0,0,True,0.30796142551127037
2025-01-08 18:08:33,Biru,756,387,tensor(128.2245),tensor(107.8646),92,70,95,71,3,1,True,0.0
2025-01-08 18:08:33,persegiBiru,763,396,134,105,26,86,21,84,5,2,True,0.41010709134116197
2025-01-08 18:08:33,Fail to pick,763,396,0,0,0,0,0,0,0,0,False,0
2025-01-08 18:08:33,persegiBiru,752,394,129,109,180,96,182,95,2,1,True,0.28506014457663414
2025-01-08 18:08:33,persegiBiru,756,385,126,108,0,80,1,76,1,4,True,0.3823374113164051
2025-01-08 18:08:33,Fail to pick,756,385,0,0,0,0,0,0,0,0,False,0
2025-01-08 18:08:34,persegiBiru,759,388,125,104,181,9,179,10,2,1,True,0.3336317044711169
2025-01-08 18:08:34,Fail to pick,759,388,0,0,0,0,0,0,0,0,False,0
2025-01-08 18:08:34,persegiBiru,762,387,124,106,176,35,171,33,5,2,True,0.23098629695707584
2025-01-08 18:08:34,Fail to pick,762,387,0,0,0,0,0,0,0,0,False,0
2025-01-08 18:08:44,persegiBiru,744,527,128,117,34,53,31,49,3,4,True,0.30546747663394674
2025-01-08 18:08:44,Biru,744,527,tensor(128.1673),tensor(117.8642),53,68,55,63,2,5,True,0.0
2025-01-08 18:08:44,persegiBiru,749,535,123,116,182,39,182,35,0,4,True,0.32891511701112114
2025-01-08 18:08:44,Fail to pick,749,535,0,0,0,0,0,0,0,0,False,0
2025-01-08 18:08:44,persegiBiru,772,539,125,113,23,12,19,8,4,4,True,0.3292218896643402
2025-01-08 18:08:45,persegiBiru,754,506,122,115,166,6,165,9,1,3,True,0.46398825932216736
2025-01-08 18:08:45,persegiBiru,738,519,128,114,23,35,23,36,0,1,True,0.12605062544784984
2025-01-08 18:08:45,persegiBiru,775,492,123,115,55,32,52,32,3,0,True,0.15882295159837742
2025-01-08 18:08:45,persegiBiru,795,491,129,115,89,23,84,21,5,2,True,0.2008250360085668
2025-01-08 18:08:46,persegiBiru,783,481,128,120,94,54,92,56,2,2,True,0.40467428634878444
2025-01-08 18:08:46,Biru,783,481,tensor(128.2809),tensor(120.2565),66,72,65,74,1,2,True,0.0
2025-01-08 18:08:46,persegiBiru,760,532,127,112,199,0,199,3,0,3,True,0.11091866802628765
2025-01-08 18:08:46,persegiBiru,788,548,125,110,96,13,95,13,1,0,True,0.4727910642491969
2025-01-08 18:08:46,persegiBiru,790,538,123,116,102,88,105,91,3,3,False,0.12122849476046063
2025-01-08 18:08:46,persegiBiru,790,538,126,114,160,11,159,7,1,4,True,0.24572885642222997
2025-01-08 18:08:46,Fail to pick,790,538,0,0,0,0,0,0,0,0,False,0
2025-01-08 18:08:46,persegiBiru,748,525,129,114,121,88,116,91,5,3,True,0.41686761249549853
2025-01-08 18:08:47,persegiBiru,808,497,120,118,80,60,83,63,3,3,True,0.4391894712451384
2025-01-08 18:08:47,persegiBiru,755,533,130,106,159,28,162,28,3,0,True,0.36348189706321077
2025-01-08 18:08:47,persegiBiru,751,524,126,111,23,5,27,7,4,2,True,0.4580056024396931
2025-01-08 18:08:47,Fail to pick,751,524,0,0,0,0,0,0,0,0,False,0
2025-01-08 18:08:57,persegiMerah,910,77,128,136,75,65,70,60,5,5,True,0.2351334765172639
2025-01-08 18:08:57,Merah,910,77,tensor(128.3752),tensor(136.8988),178,84,174,82,4,2,True,0.0
2025-01-08 18:08:57,persegiMerah,836,48,119,97,65,29,65,24,0,5,True,0.28137230046331174
2025-01-08 18:08:57,persegiMerah,909,76,112,126,168,61,172,61,4,0,True,0.18326204748447827
2025-01-08 18:08:58,persegiMerah,867,41,112,82,43,25,38,26,5,1,False,0.3185308493264194
2025-01-08 18:08:58,Merah,867,41,tensor(112.5515),tensor(82.7842),188,80,186,79,2,1,True,0.0
2025-01-08 18:08:58,persegiMerah,880,34,115,69,114,14,118,17,4,3,True,0.20178658815954034
2025-01-08 18:08:58,persegiMerah,900,42,108,85,61,47,57,46,4,1,True,0.14787498317053138
2025-01-08 18:08:58,persegiMerah,872,41,114,82,9,58,10,54,1,4,True,0.21969841360001785
2025-01-08 18:08:59,persegiMerah,912,50,111,100,161,55,161,58,0,3,False,0.4200783693897694
2025-01-08 18:08:59,persegiMerah,887,40,111,81,154,71,155,70,1,1,True,0.22811008780625724
2025-01-08 18:08:59,Merah,887,40,tensor(111.0114),tensor(81.3573),188,82,187,79,1,3,True,0.0
2025-01-08 18:08:59,persegiMerah,902,49,112,99,181,71,184,72,3,1,True,0.4990508793311267
2025-01-08 18:08:59,persegiMerah,887,37,117,74,103,40,103,35,0,5,True,0.17661888576338702
2025-01-08 18:08:59,persegiMerah,902,46,112,93,117,12,115,15,2,3,True,0.13241541854148628
2025-01-08 18:09:00,persegiMerah,925,60,109,118,46,50,50,51,4,1,True,0.12102490468729643
2025-01-08 18:09:00,Merah,925,60,tensor(109.6417),tensor(118.6410),183,85,185,83,2,2,True,0.0005056858062744141
2025-01-08 18:09:00,persegiMerah,904,46,112,93,13,64,11,62,2,2,True,0.45999551390595994
2025-01-08 18:09:01,persegiMerah,922,62,115,118,21,68,19,69,2,1,True,0.37970099283607883
2025-01-08 18:09:02,persegiMerah,917,72,117,119,160,45,157,43,3,2,True,0.4263050504682967
2025-01-08 18:09:02,Merah,917,72,tensor(117.0320),tensor(119.6437),180,84,184,79,4,5,True,0.0
2025-01-08 18:09:02,persegiMerah,914,76,115,121,24,78,24,76,0,2,True,0.2538879874928066
2025-01-08 18:09:02,Fail to pick,914,76,0,0,0,0,0,0,0,0,False,0
2025-01-08 18:09:02,persegiMerah,908,62,118,124,44,46,40,49,4,3,True,0.49701368661601053
2025-01-08 18:09:02,persegiMerah,871,56,114,113,197,98,196,102,1,4,True,0.4330855099406291
2025-01-08 18:09:10,persegiBiru,734,633,125,110,80,45,78,46,2,1,True,0.49563998363777817
2025-01-08 18:09:10,Biru,734,633,tensor(125.7723),tensor(110.7424),24,67,26,64,2,3,True,0.0
2025-01-08 18:09:11,persegiBiru,747,627,126,113,91,14,88,10,3,4,True,0.36787396873716516
2025-01-08 18:09:11,persegiBiru,733,632,126,111,193,34,197,31,4,3,True,0.21119420385451307
2025-01-08 18:09:11,Biru,733,632,tensor(126.3755),tensor(111.1133),24,67,26,67,2,0,True,0.0004937648773193359
2025-01-08 18:09:12,persegiBiru,733,629,125,113,20,53,21,51,1,2,True,0.4160628413352253
2025-01-08 18:09:12,Fail to pick,733,629,0,0,0,0,0,0,0,0,False,0
2025-01-08 18:09:12,persegiBiru,739,627,126,113,26,92,30,91,4,1,True,0.17532652468038568
2025-01-08 18:09:12,Fail to pick,739,627,0,0,0,0,0,0,0,0,False,0
2025-01-08 18:09:12,persegiBiru,737,627,135,116,138,34,135,35,3,1,True,0.40737522400268456
2025-01-08 18:09:12,Fail to pick,737,627,0,0,0,0,0,0,0,0,False,0
2025-01-08 18:09:12,persegiBiru,711,628,139,116,165,31,160,33,5,2,True,0.23528300880552966
2025-01-08 18:09:12,persegiBiru,736,633,128,112,135,42,139,44,4,2,False,0.11920460972776442
2025-01-08 18:09:12,Biru,736,633,tensor(128.7749),tensor(112.2999),24,68,26,69,2,1,True,0.0
2025-01-08 18:09:13,persegiBiru,731,635,125,110,60,10,62,5,2,5,True,0.46366141899609115
2025-01-08 18:09:13,Fail to pick,731,635,0,0,0,0,0,0,0,0,False,0
2025-01-08 18:09:13,persegiBiru,714,619,129,118,66,71,62,67,4,4,True,0.23955694699817953
2025-01-08 18:09:13,persegiBiru,726,626,128,114,19,49,22,46,3,3,True,0.11920557547560935
2025-01-08 18:09:13,Biru,726,626,tensor(128.0581),tensor(114.9220),26,67,30,69,4,2,True,0.0004954338073730469
2025-01-08 18:09:14,persegiBiru,705,668,124,83,94,12,93,8,1,4,True,0.2828904995135858
2025-01-08 18:10:15,persegiHijau,301,111,122,138,105,10,107,9,2,1,True,0.3727912133005924
2025-01-08 18:10:15,Hijau,301,111,tensor(122.1942),tensor(138.8056),169,27,172,22,3,5,True,0.0004992485046386719
2025-01-08 18:10:15,persegiHijau,327,109,125,130,65,20,64,15,1,5,True,0.15111824005576777
2025-01-08 18:10:15,persegiHijau,272,117,131,142,138,92,138,95,0,3,True,0.40383146628771927
2025-01-08 18:10:15,persegiHijau,272,117,131,142,136,63,133,58,3,5,True,0.3781581013230494
2025-01-08 18:10:15,Fail to pick,272,117,0,0,0,0,0,0,0,0,False,0
2025-01-08 18:10:15,persegiHijau,302,112,122,137,87,8,86,9,1,1,True,0.38710687250416076
2025-01-08 18:10:15,persegiHijau,304,116,124,136,54,22,51,17,3,5,True,0.3672208011190572
2025-01-08 18:10:15,Fail to pick,304,116,0,0,0,0,0,0,0,0,False,0
2025-01-08 18:10:15,persegiHijau,302,110,124,142,59,28,60,27,1,1,True,0.462167287004005
2025-01-08 18:10:15,Fail to pick,302,110,0,0,0,0,0,0,0,0,False,0
2025-01-08 18:10:15,persegiHijau,275,120,131,143,173,28,175,29,2,1,True,0.1279966744429137
2025-01-08 18:10:15,persegiHijau,323,127,124,140,69,14,73,13,4,1,True,0.2438377068605283
2025-01-08 18:10:16,persegiHijau,303,111,120,136,158,75,161,76,3,1,True,0.423620137371268
2025-01-08 18:10:16,Hijau,303,111,tensor(120.3025),tensor(136.9436),169,28,172,27,3,1,True,0.0005002021789550781
2025-01-08 18:10:16,persegiHijau,295,117,121,135,139,0,143,-2,4,2,True,0.3569824002988766
2025-01-08 18:10:16,Fail to pick,295,117,0,0,0,0,0,0,0,0,False,0
2025-01-08 18:10:16,persegiHijau,299,115,122,137,69,93,70,88,1,5,True,0.2934944320380189
2025-01-08 18:10:16,Fail to pick,299,115,0,0,0,0,0,0,0,0,False,0
2025-01-08 18:10:16,persegiHijau,302,112,122,141,73,92,75,88,2,4,True,0.3182025481160282
2025-01-08 18:10:16,Fail to pick,302,112,0,0,0,0,0,0,0,0,False,0
2025-01-08 18:10:16,persegiHijau,310,112,119,138,76,26,79,27,3,1,True,0.36223270072027447
2025-01-08 18:10:16,Fail to pick,310,112,0,0,0,0,0,0,0,0,False,0
2025-01-08 18:10:16,persegiHijau,295,117,123,136,8,88,11,83,3,5,True,0.2690657391952206
2025-01-08 18:10:16,persegiHijau,319,123,122,143,137,98,140,99,3,1,True,0.41596112666722185
2025-01-08 18:10:16,persegiHijau,299,113,123,137,190,70,186,74,4,4,True,0.2809190013938343
2025-01-08 18:10:17,persegiHijau,325,122,123,141,147,7,149,6,2,1,True,0.3257375197611738
2025-01-08 18:10:17,persegiHijau,323,105,124,133,60,74,56,77,4,3,True,0.20708087771643943
2025-01-08 18:10:17,Hijau,323,105,tensor(124.5063),tensor(133.4933),170,29,169,31,1,2,True,0.0
2025-01-08 18:10:17,persegiHijau,305,118,118,135,142,38,139,38,3,0,True,0.11587109128559768
2025-01-08 18:10:17,persegiHijau,303,117,125,135,38,13,36,8,2,5,False,0.3361236458767634
2025-01-08 18:10:17,Fail to pick,303,117,0,0,0,0,0,0,0,0,False,0
2025-01-08 18:10:17,persegiHijau,298,122,128,139,68,9,72,9,4,0,True,0.48996119275319183
2025-01-08 18:10:17,Fail to pick,298,122,0,0,0,0,0,0,0,0,False,0
2025-01-08 18:10:17,persegiHijau,328,109,128,131,188,86,190,87,2,1,True,0.46233587623547545
2025-01-08 18:10:17,persegiHijau,294,117,119,137,180,35,183,37,3,2,False,0.24263515286470733
2025-01-08 18:10:17,persegiHijau,284,115,125,139,113,34,112,38,1,4,True,0.34399092374946494
2025-01-08 18:10:17,persegiHijau,274,125,128,141,14,49,9,51,5,2,True,0.4591459727712659
2025-01-08 18:10:21,persegiHijau,239,137,129,137,167,96,169,93,2,3,True,0.32536401918263524
2025-01-08 18:10:21,Hijau,239,137,tensor(129.5461),tensor(137.3148),161,22,161,26,0,4,True,0.0
2025-01-08 18:10:21,persegiHijau,197,148,134,143,137,84,133,80,4,4,True,0.3515603687446899
2025-01-08 18:10:21,persegiHijau,201,148,134,141,175,72,175,75,0,3,True,0.27503253624094426
2025-01-08 18:10:21,Fail to pick,201,148,0,0,0,0,0,0,0,0,False,0
2025-01-08 18:10:22,persegiHijau,216,133,131,144,57,41,54,36,3,5,True,0.23254734112327952
2025-01-08 18:10:22,persegiHijau,231,135,131,141,179,21,178,22,1,1,True,0.35376493427239575
2025-01-08 18:10:22,persegiHijau,196,140,139,147,131,92,126,96,5,4,True,0.49962677427916546
2025-01-08 18:10:22,persegiHijau,223,134,129,143,57,19,56,22,1,3,True,0.4753745665965843
2025-01-08 18:10:22,persegiHijau,226,134,129,140,174,20,178,19,4,1,False,0.41961446545710357
2025-01-08 18:10:22,Fail to pick,226,134,0,0,0,0,0,0,0,0,False,0
2025-01-08 18:10:22,persegiHijau,225,134,128,139,24,23,24,18,0,5,True,0.41716010189731967
2025-01-08 18:10:22,Hijau,225,134,tensor(128.1498),tensor(139.3238),162,20,166,24,4,4,True,0.0004992485046386719
2025-01-08 18:10:22,Fail to pick,225,134,0,0,0,0,0,0,0,0,False,0
2025-01-08 18:10:22,persegiHijau,187,145,137,141,18,58,18,53,0,5,True,0.2580334837938188
2025-01-08 18:10:25,persegiHijau,373,214,113,137,55,41,50,40,5,1,True,0.1837212931335775
2025-01-08 18:10:25,Hijau,373,214,tensor(113.7132),tensor(137.5897),140,34,144,37,4,3,True,0.0005002021789550781
2025-01-08 18:10:25,persegiHijau,366,219,111,139,198,88,193,88,5,0,True,0.21973578446399641
2025-01-08 18:10:25,Fail to pick,366,219,0,0,0,0,0,0,0,0,False,0
2025-01-08 18:10:25,persegiHijau,373,225,113,137,110,60,105,58,5,2,True,0.3366009804388768
2025-01-08 18:10:25,Fail to pick,373,225,0,0,0,0,0,0,0,0,False,0
2025-01-08 18:10:25,persegiHijau,379,224,115,138,138,11,138,12,0,1,True,0.17765137155147498
2025-01-08 18:10:25,Fail to pick,379,224,0,0,0,0,0,0,0,0,False,0
2025-01-08 18:10:25,persegiHijau,312,259,129,141,30,5,33,1,3,4,False,0.4631089599431252
2025-01-08 18:10:25,persegiHijau,357,225,113,135,69,69,69,71,0,2,True,0.41013255119283454
2025-01-08 18:10:26,persegiHijau,360,232,112,139,55,40,54,38,1,2,False,0.4178912615198441
2025-01-08 18:10:26,Fail to pick,360,232,0,0,0,0,0,0,0,0,False,0
2025-01-08 18:10:26,persegiHijau,371,233,112,137,92,55,95,54,3,1,True,0.3828035257720398
2025-01-08 18:10:26,persegiHijau,360,230,114,139,95,67,92,67,3,0,True,0.2579261493416916
2025-01-08 18:10:26,persegiHijau,360,236,115,135,94,99,93,97,1,2,True,0.41450633257362035
2025-01-08 18:10:26,Fail to pick,360,236,0,0,0,0,0,0,0,0,False,0
2025-01-08 18:10:26,persegiHijau,345,243,116,138,130,98,134,100,4,2,False,0.32104718528934284
2025-01-08 18:10:26,Hijau,345,243,tensor(116.8407),tensor(138.7254),132,31,136,33,4,2,True,0.0
2025-01-08 18:10:26,persegiHijau,342,238,117,136,64,73,65,73,1,0,True,0.18145440011427466
2025-01-08 18:10:26,Fail to pick,342,238,0,0,0,0,0,0,0,0,False,0
2025-01-08 18:10:26,persegiHijau,357,232,113,140,169,52,168,55,1,3,True,0.2108001695995904
2025-01-08 18:10:26,persegiHijau,365,233,112,139,150,57,147,61,3,4,True,0.20353974718566353
2025-01-08 18:10:26,Fail to pick,365,233,0,0,0,0,0,0,0,0,False,0
2025-01-08 18:10:26,persegiHijau,365,231,112,139,87,12,87,9,0,3,False,0.13894533336569684
2025-01-08 18:10:26,Fail to pick,365,231,0,0,0,0,0,0,0,0,False,0
2025-01-08 18:10:27,persegiHijau,373,223,115,135,176,80,180,77,4,3,True,0.47902591946886164
2025-01-08 18:10:27,Fail to pick,373,223,0,0,0,0,0,0,0,0,False,0
2025-01-08 18:10:27,persegiHijau,369,231,112,137,171,40,171,35,0,5,True,0.21562605921574032
2025-01-08 18:10:27,Fail to pick,369,231,0,0,0,0,0,0,0,0,False,0
2025-01-08 18:10:27,persegiHijau,341,243,113,137,161,45,161,41,0,4,True,0.2105905915693338
2025-01-08 18:10:27,persegiHijau,366,229,113,138,154,91,157,95,3,4,True,0.1692676598273654
2025-01-08 18:10:27,persegiHijau,366,229,114,136,71,94,70,90,1,4,False,0.4572539775573513
2025-01-08 18:10:27,Hijau,366,229,tensor(114.5048),tensor(136.8033),136,33,131,37,5,4,True,0.0
2025-01-08 18:10:27,Fail to pick,366,229,0,0,0,0,0,0,0,0,False,0
2025-01-08 18:10:27,persegiHijau,375,227,115,133,87,55,88,56,1,1,True,0.2826244565350454
2025-01-08 18:10:27,Fail to pick,375,227,0,0,0,0,0,0,0,0,False,0
2025-01-08 18:10:27,persegiHijau,367,233,111,136,3,71,2,70,1,1,True,0.43891540244709504
2025-01-08 18:10:27,Fail to pick,367,233,0,0,0,0,0,0,0,0,False,0
2025-01-08 18:10:27,persegiHijau,365,225,112,136,161,97,158,92,3,5,True,0.4065491143429617
2025-01-08 18:10:27,Fail to pick,365,225,0,0,0,0,0,0,0,0,False,0
2025-01-08 18:10:27,persegiHijau,335,243,120,136,130,61,129,65,1,4,False,0.4098354980829696
2025-01-08 18:10:27,persegiHijau,357,226,113,136,62,23,64,18,2,5,True,0.3179016906843866
2025-01-08 18:10:28,persegiHijau,359,233,115,137,108,97,110,94,2,3,True,0.28418479176108935
2025-01-08 18:10:28,Fail to pick,359,233,0,0,0,0,0,0,0,0,False,0
2025-01-08 18:10:28,persegiHijau,335,242,120,139,118,58,117,54,1,4,False,0.41659339609792245
2025-01-08 18:10:28,persegiHijau,335,236,120,137,180,73,184,70,4,3,True,0.3131174374223743
2025-01-08 18:10:28,Fail to pick,335,236,0,0,0,0,0,0,0,0,False,0
2025-01-08 18:10:28,persegiHijau,355,239,114,136,70,59,70,57,0,2,False,0.1735187283501966
2025-01-08 18:10:28,persegiHijau,347,243,115,140,169,97,172,97,3,0,True,0.1547494166382864
2025-01-08 18:10:28,Hijau,347,243,tensor(115.2593),tensor(140.1802),132,32,127,30,5,2,True,0.0
2025-01-08 18:10:28,Fail to pick,347,243,0,0,0,0,0,0,0,0,False,0
2025-01-08 18:10:28,persegiHijau,372,229,116,138,128,69,127,73,1,4,True,0.2849880889959674
2025-01-08 18:10:28,persegiHijau,374,236,116,139,176,68,180,68,4,0,True,0.465491425638376
2025-01-08 18:10:28,Fail to pick,374,236,0,0,0,0,0,0,0,0,False,0
2025-01-08 18:10:28,persegiHijau,365,235,113,137,87,33,87,32,0,1,True,0.49695301933859237
2025-01-08 18:10:28,Fail to pick,365,235,0,0,0,0,0,0,0,0,False,0
2025-01-08 18:10:28,persegiHijau,337,246,118,140,77,55,79,51,2,4,True,0.1969229826265409
2025-01-08 18:10:29,persegiHijau,347,247,116,137,29,25,24,25,5,0,True,0.43575294571387324
2025-01-08 18:10:29,persegiHijau,359,236,114,139,141,53,137,48,4,5,True,0.4792938225140988
2025-01-08 18:10:29,persegiHijau,365,234,111,136,6,32,8,27,2,5,True,0.20312196532043286
2025-01-08 18:10:29,Fail to pick,365,234,0,0,0,0,0,0,0,0,False,0
2025-01-08 18:10:29,persegiHijau,368,235,109,137,145,54,148,55,3,1,False,0.48486853110273476
2025-01-08 18:10:29,Fail to pick,368,235,0,0,0,0,0,0,0,0,False,0
2025-01-08 18:10:29,persegiHijau,368,238,114,136,41,95,45,98,4,3,True,0.4798182734812535
2025-01-08 18:10:29,Fail to pick,368,238,0,0,0,0,0,0,0,0,False,0
2025-01-08 18:10:29,persegiHijau,359,236,112,138,188,94,191,95,3,1,True,0.10277595715250279
2025-01-08 18:10:29,Hijau,359,236,tensor(112.1151),tensor(138.2539),134,33,137,31,3,2,True,0.0
2025-01-08 18:10:29,Fail to pick,359,236,0,0,0,0,0,0,0,0,False,0
2025-01-08 18:10:29,persegiHijau,360,235,114,138,174,87,170,90,4,3,True,0.17127660088108537
2025-01-08 18:10:29,Fail to pick,360,235,0,0,0,0,0,0,0,0,False,0
2025-01-08 18:10:29,persegiHijau,337,239,117,136,124,7,121,11,3,4,True,0.3306962962165928
2025-01-08 18:10:29,persegiHijau,369,232,111,136,167,80,168,75,1,5,True,0.37504782351272403
2025-01-08 18:10:29,persegiHijau,369,236,110,136,62,65,65,62,3,3,True,0.38432134749156466
2025-01-08 18:10:29,Fail to pick,369,236,0,0,0,0,0,0,0,0,False,0
2025-01-08 18:10:33,persegiHijau,390,213,129,134,63,41,64,36,1,5,True,0.4684154691806417
2025-01-08 18:10:33,Hijau,390,213,tensor(129.0738),tensor(134.7455),140,36,141,40,1,4,True,0.0004944801330566406
2025-01-08 18:10:33,persegiHijau,358,227,127,142,129,15,126,16,3,1,False,0.4558779080025358
2025-01-08 18:10:33,persegiHijau,387,215,126,138,43,75,38,76,5,1,True,0.36401354018690135
2025-01-08 18:10:33,persegiHijau,393,249,132,139,56,67,54,66,2,1,True,0.4880821156068472
2025-01-08 18:10:34,persegiHijau,398,245,132,139,155,50,157,49,2,1,False,0.11640398864885629
2025-01-08 18:10:34,Fail to pick,398,245,0,0,0,0,0,0,0,0,False,0
2025-01-08 18:10:34,persegiHijau,386,218,131,136,83,8,83,8,0,0,True,0.3174935825526047
2025-01-08 18:10:34,persegiHijau,386,216,131,138,86,7,85,8,1,1,True,0.10668751218444616
2025-01-08 18:10:34,Fail to pick,386,216,0,0,0,0,0,0,0,0,False,0
2025-01-08 18:10:34,persegiHijau,388,216,125,135,158,97,155,96,3,1,True,0.2470663460422801
2025-01-08 18:10:34,Fail to pick,388,216,0,0,0,0,0,0,0,0,False,0
2025-01-08 18:10:34,persegiHijau,393,213,129,136,19,15,17,10,2,5,True,0.14406832350550083
2025-01-08 18:10:34,Fail to pick,393,213,0,0,0,0,0,0,0,0,False,0
2025-01-08 18:10:34,persegiHijau,390,213,131,141,120,45,116,47,4,2,True,0.16331374736614124
2025-01-08 18:10:34,Hijau,390,213,tensor(131.0509),tensor(141.5276),140,36,142,37,2,1,True,0.0
2025-01-08 18:10:34,Fail to pick,390,213,0,0,0,0,0,0,0,0,False,0
2025-01-08 18:10:34,persegiHijau,396,215,132,137,82,82,81,85,1,3,False,0.12180634640714048
2025-01-08 18:10:34,Fail to pick,396,215,0,0,0,0,0,0,0,0,False,0
2025-01-08 18:10:34,persegiHijau,392,213,131,134,96,36,94,35,2,1,True,0.48665652339236387
2025-01-08 18:10:34,Fail to pick,392,213,0,0,0,0,0,0,0,0,False,0
2025-01-08 18:10:34,persegiHijau,393,212,131,138,186,11,188,14,2,3,True,0.3488522582057905
2025-01-08 18:10:34,Fail to pick,393,212,0,0,0,0,0,0,0,0,False,0
2025-01-08 18:10:35,persegiHijau,394,216,133,137,147,28,146,27,1,1,False,0.42451117294297647
2025-01-08 18:10:35,Fail to pick,394,216,0,0,0,0,0,0,0,0,False,0
2025-01-08 18:10:35,persegiHijau,393,246,131,140,184,30,187,27,3,3,False,0.2183457757610804
2025-01-08 18:10:35,persegiHijau,390,212,128,141,50,53,48,53,2,0,True,0.4987295468929699
2025-01-08 18:10:35,persegiHijau,389,247,134,138,165,95,169,96,4,1,True,0.3850780159796171
2025-01-08 18:10:35,persegiHijau,396,245,130,138,184,13,183,12,1,1,True,0.19149770765177965
2025-01-08 18:10:35,Fail to pick,396,245,0,0,0,0,0,0,0,0,False,0
2025-01-08 18:10:35,persegiHijau,388,218,128,138,30,65,27,61,3,4,True,0.3704214890844718
2025-01-08 18:10:35,persegiHijau,391,211,132,135,77,69,75,68,2,1,True,0.24120492288190049
2025-01-08 18:10:35,Hijau,391,211,tensor(132.3550),tensor(135.3912),141,36,138,31,3,5,True,0.0
2025-01-08 18:10:35,Fail to pick,391,211,0,0,0,0,0,0,0,0,False,0
2025-01-08 18:10:35,persegiHijau,386,218,133,135,179,34,174,35,5,1,True,0.2568733196542664
2025-01-08 18:10:35,Fail to pick,386,218,0,0,0,0,0,0,0,0,False,0
2025-01-08 18:10:35,persegiHijau,395,216,132,136,96,19,94,16,2,3,True,0.12063210099800457
2025-01-08 18:10:35,Fail to pick,395,216,0,0,0,0,0,0,0,0,False,0
2025-01-08 18:10:36,persegiHijau,377,233,131,138,71,74,69,74,2,0,True,0.2827565034995093
2025-01-08 18:10:36,persegiHijau,391,214,133,137,25,25,26,28,1,3,True,0.46115055756537227
2025-01-08 18:10:36,persegiHijau,393,217,132,138,12,22,15,18,3,4,True,0.11398362688209387
2025-01-08 18:10:36,Fail to pick,393,217,0,0,0,0,0,0,0,0,False,0
2025-01-08 18:10:36,persegiHijau,389,218,127,136,60,45,62,41,2,4,True,0.4977573567708967
2025-01-08 18:10:36,Fail to pick,389,218,0,0,0,0,0,0,0,0,False,0
2025-01-08 18:10:36,persegiHijau,401,217,127,134,114,73,114,69,0,4,True,0.4055559334565212
2025-01-08 18:10:36,persegiHijau,387,213,130,137,23,8,20,10,3,2,True,0.4441292886436552
2025-01-08 18:10:36,persegiHijau,392,216,133,136,177,72,177,74,0,2,True,0.47650904429708174
2025-01-08 18:10:36,Fail to pick,392,216,0,0,0,0,0,0,0,0,False,0
2025-01-08 18:10:37,persegiHijau,383,256,119,129,24,17,19,13,5,4,True,0.48127933117803545
2025-01-08 18:10:37,persegiHijau,393,219,118,126,60,7,57,9,3,2,True,0.18737410440037136
2025-01-08 18:10:37,persegiHijau,382,220,116,128,121,14,117,14,4,0,True,0.44996069766344027
2025-01-08 18:10:37,Hijau,382,220,tensor(116.4252),tensor(128.6650),138,35,134,36,4,1,True,0.0
2025-01-08 18:10:38,persegiHijau,392,220,118,126,37,88,38,84,1,4,True,0.23245924609329333
2025-01-08 18:10:38,persegiHijau,358,234,113,132,30,27,30,23,0,4,True,0.4588477315009528
2025-01-08 18:10:38,persegiHijau,386,219,116,126,128,67,132,69,4,2,True,0.19035010630265173
2025-01-08 18:10:38,persegiHijau,363,235,115,137,18,50,22,50,4,0,True,0.2148036109687695
2025-01-08 18:10:38,persegiHijau,390,221,118,128,32,21,35,16,3,5,True,0.27020877410907
2025-01-08 18:10:38,persegiHijau,386,251,121,132,147,14,147,9,0,5,True,0.28638049779579744
2025-01-08 18:10:38,persegiHijau,385,220,119,128,169,83,170,85,1,2,True,0.3462361518986685
2025-01-08 18:10:38,persegiHijau,390,221,118,129,27,64,28,63,1,1,True,0.20339581797373907
2025-01-08 18:10:38,Fail to pick,390,221,0,0,0,0,0,0,0,0,False,0
2025-01-08 18:10:38,persegiHijau,380,222,117,130,57,42,54,38,3,4,True,0.22405734144959047
2025-01-08 18:10:38,persegiHijau,382,218,116,129,176,77,179,80,3,3,True,0.12160999475858954
2025-01-08 18:10:38,Hijau,382,218,tensor(116.4540),tensor(129.3002),139,35,137,34,2,1,True,0.0005011558532714844
2025-01-08 18:10:38,Fail to pick,382,218,0,0,0,0,0,0,0,0,False,0
2025-01-08 18:10:39,persegiHijau,391,250,118,131,151,18,149,13,2,5,True,0.14670184473665585
2025-01-08 18:10:39,persegiHijau,386,218,117,125,0,48,-4,45,4,3,True,0.29557240549451624
2025-01-08 18:10:39,persegiHijau,393,225,116,126,55,65,59,64,4,1,True,0.49858111993118726
2025-01-08 18:10:39,Fail to pick,393,225,0,0,0,0,0,0,0,0,False,0
2025-01-08 18:10:39,persegiHijau,391,220,118,128,192,47,192,51,0,4,True,0.28467701152557234
2025-01-08 18:10:39,Fail to pick,391,220,0,0,0,0,0,0,0,0,False,0
2025-01-08 18:10:39,persegiHijau,385,217,119,127,91,10,95,6,4,4,True,0.33542871970426713
2025-01-08 18:10:39,Fail to pick,385,217,0,0,0,0,0,0,0,0,False,0
2025-01-08 18:10:39,persegiHijau,388,219,120,126,86,20,84,17,2,3,True,0.4333172093525711
2025-01-08 18:10:39,Fail to pick,388,219,0,0,0,0,0,0,0,0,False,0
2025-01-08 18:10:39,persegiHijau,380,221,115,128,110,5,111,8,1,3,True,0.3754955073552063
2025-01-08 18:10:39,Fail to pick,380,221,0,0,0,0,0,0,0,0,False,0
2025-01-08 18:10:39,persegiHijau,386,219,118,125,138,21,140,20,2,1,True,0.3472279312614155
2025-01-08 18:10:39,Fail to pick,386,219,0,0,0,0,0,0,0,0,False,0
2025-01-08 18:10:39,persegiHijau,382,251,120,131,33,75,28,70,5,5,True,0.4519837328679156
2025-01-08 18:10:39,Hijau,382,251,tensor(120.7129),tensor(131.1550),130,35,134,38,4,3,True,0.0
2025-01-08 18:10:40,persegiHijau,379,220,115,128,96,66,100,61,4,5,True,0.14715739728893326
2025-01-08 18:10:40,persegiHijau,383,218,117,127,130,47,133,43,3,4,True,0.32202218548165784
2025-01-08 18:10:40,Fail to pick,383,218,0,0,0,0,0,0,0,0,False,0
2025-01-08 18:10:40,persegiHijau,384,219,115,127,123,67,122,67,1,0,True,0.4821126717894597
2025-01-08 18:10:40,Fail to pick,384,219,0,0,0,0,0,0,0,0,False,0
2025-01-08 18:10:40,persegiHijau,382,218,114,125,180,87,183,88,3,1,True,0.3015830071630182
2025-01-08 18:10:40,Fail to pick,382,218,0,0,0,0,0,0,0,0,False,0
2025-01-08 18:10:40,persegiHijau,385,226,117,126,40,13,41,8,1,5,True,0.21623785083445757
2025-01-08 18:10:40,Fail to pick,385,226,0,0,0,0,0,0,0,0,False,0
2025-01-08 18:10:40,persegiHijau,380,219,116,126,34,94,31,98,3,4,False,0.20177391734136663
2025-01-08 18:10:40,Fail to pick,380,219,0,0,0,0,0,0,0,0,False,0
2025-01-08 18:10:40,persegiHijau,383,220,116,127,148,27,152,23,4,4,True,0.20243500927122896
2025-01-08 18:10:40,Fail to pick,383,220,0,0,0,0,0,0,0,0,False,0
2025-01-08 18:10:40,persegiHijau,379,220,115,127,3,12,0,12,3,0,True,0.3631594144005196
2025-01-08 18:10:40,Fail to pick,379,220,0,0,0,0,0,0,0,0,False,0
2025-01-08 18:10:40,persegiHijau,379,222,116,128,139,15,137,13,2,2,False,0.39166970073836693
2025-01-08 18:10:40,Hijau,379,222,tensor(116.7157),tensor(128.7880),138,35,137,30,1,5,True,0.0
2025-01-08 18:10:40,Fail to pick,379,222,0,0,0,0,0,0,0,0,False,0
2025-01-08 18:10:41,persegiHijau,384,218,119,126,102,73,101,75,1,2,True,0.19866464266431327
2025-01-08 18:10:41,Fail to pick,384,218,0,0,0,0,0,0,0,0,False,0
2025-01-08 18:10:41,persegiHijau,389,251,117,128,100,4,104,2,4,2,True,0.49461233049185416
2025-01-08 18:10:41,persegiHijau,373,247,113,127,111,52,109,54,2,2,True,0.2561049686095652
2025-01-08 18:10:41,persegiHijau,385,218,115,123,109,32,109,29,0,3,True,0.48311234252605884
2025-01-08 18:10:45,persegiHijau,224,191,142,139,57,24,61,19,4,5,True,0.43251841825769866
2025-01-08 18:10:45,Hijau,224,191,tensor(142.2649),tensor(139.0681),146,20,145,17,1,3,True,0.0004994869232177734
2025-01-08 18:10:45,persegiHijau,226,196,141,139,82,51,78,46,4,5,False,0.30155381262515957
2025-01-08 18:10:45,Fail to pick,226,196,0,0,0,0,0,0,0,0,False,0
2025-01-08 18:10:45,persegiHijau,227,191,142,141,2,36,4,34,2,2,True,0.15261343057486712
2025-01-08 18:10:45,Fail to pick,227,191,0,0,0,0,0,0,0,0,False,0
2025-01-08 18:10:45,persegiHijau,228,188,142,143,170,85,172,86,2,1,True,0.10271358239566629
2025-01-08 18:10:45,Fail to pick,228,188,0,0,0,0,0,0,0,0,False,0
2025-01-08 18:10:45,persegiHijau,226,195,142,136,21,44,22,41,1,3,True,0.3394557508367193
2025-01-08 18:10:45,Fail to pick,226,195,0,0,0,0,0,0,0,0,False,0
2025-01-08 18:10:45,persegiHijau,226,190,144,143,121,34,124,36,3,2,True,0.3595375246456026
2025-01-08 18:10:45,Fail to pick,226,190,0,0,0,0,0,0,0,0,False,0
2025-01-08 18:10:47,persegiHijau,281,327,118,121,159,46,154,41,5,5,True,0.2953863177486281
2025-01-08 18:10:47,persegiHijau,270,326,115,123,27,12,24,7,3,5,True,0.23235525049822875
2025-01-08 18:10:47,Hijau,270,326,tensor(115.1500),tensor(123.3809),109,25,113,26,4,1,True,0.0
2025-01-08 18:10:47,persegiHijau,280,327,118,121,170,6,168,1,2,5,True,0.2753168010008363
2025-01-08 18:10:47,persegiHijau,283,325,116,120,165,16,167,13,2,3,True,0.44086165347443595
2025-01-08 18:10:47,Fail to pick,283,325,0,0,0,0,0,0,0,0,False,0
2025-01-08 18:10:47,persegiHijau,281,327,117,121,116,25,111,23,5,2,True,0.48519538132958917
2025-01-08 18:10:47,Fail to pick,281,327,0,0,0,0,0,0,0,0,False,0
2025-01-08 18:10:47,persegiHijau,280,332,116,123,0,30,-5,33,5,3,True,0.18096390504880772
2025-01-08 18:10:47,Fail to pick,280,332,0,0,0,0,0,0,0,0,False,0
2025-01-08 18:10:47,persegiHijau,278,330,117,122,121,76,125,71,4,5,True,0.4886784694266577
2025-01-08 18:10:47,Fail to pick,278,330,0,0,0,0,0,0,0,0,False,0
2025-01-08 18:10:47,persegiHijau,282,325,119,120,94,79,98,76,4,3,True,0.4265234106597665
2025-01-08 18:10:47,Fail to pick,282,325,0,0,0,0,0,0,0,0,False,0
2025-01-08 18:10:47,persegiHijau,279,328,119,121,65,94,64,93,1,1,True,0.37853262624082984
2025-01-08 18:10:47,Fail to pick,279,328,0,0,0,0,0,0,0,0,False,0
2025-01-08 18:10:48,persegiHijau,276,328,118,121,0,2,0,2,0,0,True,0.3127975811906324
2025-01-08 18:10:48,Fail to pick,276,328,0,0,0,0,0,0,0,0,False,0
2025-01-08 18:10:48,persegiHijau,281,327,118,121,166,24,163,23,3,1,True,0.45813069712962273
2025-01-08 18:10:48,Fail to pick,281,327,0,0,0,0,0,0,0,0,False,0
2025-01-08 18:10:48,persegiHijau,283,326,122,122,50,70,54,67,4,3,True,0.3413616839802876
2025-01-08 18:10:48,Hijau,283,326,tensor(122.4491),tensor(122.1149),109,26,113,25,4,1,True,0.0004992485046386719
2025-01-08 18:10:48,Fail to pick,283,326,0,0,0,0,0,0,0,0,False,0
2025-01-08 18:10:48,persegiHijau,277,328,115,122,68,26,68,21,0,5,True,0.4706678592829848
2025-01-08 18:10:48,Fail to pick,277,328,0,0,0,0,0,0,0,0,False,0
2025-01-08 18:10:48,persegiHijau,273,330,114,123,198,69,197,67,1,2,False,0.2721009508369925
2025-01-08 18:10:48,Fail to pick,273,330,0,0,0,0,0,0,0,0,False,0
2025-01-08 18:10:48,persegiHijau,276,332,114,121,173,91,174,90,1,1,True,0.33013811782186614
2025-01-08 18:10:48,Fail to pick,276,332,0,0,0,0,0,0,0,0,False,0
2025-01-08 18:10:48,persegiHijau,281,327,116,122,186,86,181,87,5,1,True,0.27048562988809877
2025-01-08 18:10:48,Fail to pick,281,327,0,0,0,0,0,0,0,0,False,0
2025-01-08 18:10:48,persegiHijau,277,331,115,121,26,58,24,62,2,4,True,0.29075526773994687
2025-01-08 18:10:48,Fail to pick,277,331,0,0,0,0,0,0,0,0,False,0
2025-01-08 18:10:48,persegiHijau,278,326,117,123,18,65,15,61,3,4,True,0.40311792509513866
2025-01-08 18:10:48,Fail to pick,278,326,0,0,0,0,0,0,0,0,False,0
2025-01-08 18:10:48,persegiHijau,283,331,119,121,181,36,180,32,1,4,True,0.1784714477066417
2025-01-08 18:10:48,Fail to pick,283,331,0,0,0,0,0,0,0,0,False,0
2025-01-08 18:10:49,persegiHijau,281,327,120,120,183,79,186,82,3,3,True,0.24806857478457447
2025-01-08 18:10:49,Fail to pick,281,327,0,0,0,0,0,0,0,0,False,0
2025-01-08 18:10:49,persegiHijau,280,332,119,121,7,56,4,53,3,3,True,0.21283714955967242
2025-01-08 18:10:49,Fail to pick,280,332,0,0,0,0,0,0,0,0,False,0
2025-01-08 18:10:49,persegiHijau,280,330,117,123,149,77,153,74,4,3,True,0.43813175581597463
2025-01-08 18:10:49,Hijau,280,330,tensor(117.2648),tensor(123.2609),108,25,106,21,2,4,True,0.0
2025-01-08 18:10:49,Fail to pick,280,330,0,0,0,0,0,0,0,0,False,0
2025-01-08 18:10:49,persegiHijau,279,329,118,123,34,77,31,79,3,2,True,0.3036680479686077
2025-01-08 18:10:49,Fail to pick,279,329,0,0,0,0,0,0,0,0,False,0
2025-01-08 18:10:49,persegiHijau,274,331,116,123,28,56,29,54,1,2,True,0.2538958427283078
2025-01-08 18:10:49,Fail to pick,274,331,0,0,0,0,0,0,0,0,False,0
2025-01-08 18:10:49,persegiHijau,280,329,119,122,139,17,135,18,4,1,True,0.3687975972823363
2025-01-08 18:10:49,Fail to pick,280,329,0,0,0,0,0,0,0,0,False,0
2025-01-08 18:10:49,persegiHijau,281,328,118,123,196,52,200,52,4,0,True,0.12386858137973555
2025-01-08 18:10:49,Fail to pick,281,328,0,0,0,0,0,0,0,0,False,0
2025-01-08 18:10:49,persegiHijau,280,333,120,121,169,56,173,53,4,3,True,0.17381142772258001
2025-01-08 18:10:49,Fail to pick,280,333,0,0,0,0,0,0,0,0,False,0
2025-01-08 18:10:49,persegiHijau,280,336,119,120,162,59,159,60,3,1,True,0.34486861462466545
2025-01-08 18:10:49,Fail to pick,280,336,0,0,0,0,0,0,0,0,False,0
2025-01-08 18:10:50,persegiHijau,272,331,117,123,106,82,104,85,2,3,False,0.36602819926262997
2025-01-08 18:10:50,Fail to pick,272,331,0,0,0,0,0,0,0,0,False,0
2025-01-08 18:10:50,persegiHijau,276,330,117,123,15,0,17,2,2,2,False,0.20824796656722142
2025-01-08 18:10:50,Fail to pick,276,330,0,0,0,0,0,0,0,0,False,0
2025-01-08 18:10:50,persegiHijau,280,330,120,123,59,76,61,74,2,2,True,0.3523582032870759
2025-01-08 18:10:50,Fail to pick,280,330,0,0,0,0,0,0,0,0,False,0
2025-01-08 18:10:50,persegiHijau,278,331,116,123,51,92,54,87,3,5,True,0.12765313276881654
2025-01-08 18:10:50,Hijau,278,331,tensor(116.6545),tensor(123.8015),108,25,110,23,2,2,True,0.0
2025-01-08 18:10:50,Fail to pick,278,331,0,0,0,0,0,0,0,0,False,0
2025-01-08 18:10:50,persegiHijau,276,329,118,124,5,13,4,8,1,5,True,0.3291290510720585
2025-01-08 18:10:50,Fail to pick,276,329,0,0,0,0,0,0,0,0,False,0
2025-01-08 18:10:50,persegiHijau,278,333,117,123,197,71,198,72,1,1,True,0.27690078435511944
2025-01-08 18:10:50,Fail to pick,278,333,0,0,0,0,0,0,0,0,False,0
2025-01-08 18:10:50,persegiHijau,280,330,120,123,41,96,37,92,4,4,True,0.3745354437721625
2025-01-08 18:10:50,Fail to pick,280,330,0,0,0,0,0,0,0,0,False,0
2025-01-08 18:10:50,persegiHijau,280,332,119,124,140,14,141,18,1,4,True,0.2692777207149411
2025-01-08 18:10:50,Fail to pick,280,332,0,0,0,0,0,0,0,0,False,0
2025-01-08 18:10:50,persegiHijau,284,330,116,123,2,32,4,28,2,4,True,0.4933091528507777
2025-01-08 18:10:50,Fail to pick,284,330,0,0,0,0,0,0,0,0,False,0
2025-01-08 18:10:51,persegiHijau,280,333,115,121,15,50,11,48,4,2,True,0.22131956734693292
2025-01-08 18:10:51,Fail to pick,280,333,0,0,0,0,0,0,0,0,False,0
2025-01-08 18:10:51,persegiHijau,275,331,115,122,48,0,43,-2,5,2,True,0.33651814133248714
2025-01-08 18:10:51,Fail to pick,275,331,0,0,0,0,0,0,0,0,False,0
2025-01-08 18:10:51,persegiHijau,283,330,119,123,126,62,130,65,4,3,True,0.15489528525211133
2025-01-08 18:10:51,Fail to pick,283,330,0,0,0,0,0,0,0,0,False,0
2025-01-08 18:10:51,persegiHijau,283,331,116,124,169,3,167,4,2,1,True,0.23622412844876506
2025-01-08 18:10:51,Hijau,283,331,tensor(116.9801),tensor(124.3831),108,26,110,23,2,3,True,0.0
2025-01-08 18:10:51,Fail to pick,283,331,0,0,0,0,0,0,0,0,False,0
2025-01-08 18:10:51,persegiHijau,280,330,115,126,173,29,172,32,1,3,True,0.12863202180876462
2025-01-08 18:10:51,Fail to pick,280,330,0,0,0,0,0,0,0,0,False,0
2025-01-08 18:10:51,persegiHijau,278,329,117,122,80,95,84,92,4,3,True,0.20612703733093862
2025-01-08 18:10:51,Fail to pick,278,329,0,0,0,0,0,0,0,0,False,0
2025-01-08 18:10:51,persegiHijau,289,331,117,124,56,27,53,23,3,4,True,0.12910332263888177
2025-01-08 18:10:51,persegiHijau,280,331,116,121,100,24,101,19,1,5,True,0.3742749614003609
2025-01-08 18:10:51,Fail to pick,280,331,0,0,0,0,0,0,0,0,False,0
2025-01-08 18:10:51,persegiHijau,286,328,117,119,71,13,68,11,3,2,True,0.1384449276637164
2025-01-08 18:10:51,Fail to pick,286,328,0,0,0,0,0,0,0,0,False,0
2025-01-08 18:10:52,persegiHijau,279,332,117,122,145,1,143,3,2,2,True,0.3849170820189788
2025-01-08 18:10:52,Fail to pick,279,332,0,0,0,0,0,0,0,0,False,0
2025-01-08 18:10:52,persegiHijau,285,328,120,119,52,32,55,31,3,1,True,0.3928668086474867
2025-01-08 18:10:52,Fail to pick,285,328,0,0,0,0,0,0,0,0,False,0
2025-01-08 18:10:52,persegiHijau,252,317,115,124,55,26,51,24,4,2,True,0.21976656308155104
2025-01-08 18:10:52,persegiHijau,280,328,121,123,105,69,101,70,4,1,True,0.18428879573988724
2025-01-08 18:10:52,persegiHijau,280,330,118,123,124,91,126,95,2,4,True,0.15432859279374816
2025-01-08 18:10:52,Hijau,280,330,tensor(118.7289),tensor(123.7603),108,25,106,28,2,3,True,0.0004992485046386719
2025-01-08 18:10:52,Fail to pick,280,330,0,0,0,0,0,0,0,0,False,0
2025-01-08 18:10:52,persegiHijau,279,332,119,123,102,51,98,51,4,0,True,0.3887724582897797
2025-01-08 18:10:52,Fail to pick,279,332,0,0,0,0,0,0,0,0,False,0
2025-01-08 18:10:52,persegiHijau,282,330,119,121,10,52,6,52,4,0,True,0.2307018772606163
2025-01-08 18:10:52,Fail to pick,282,330,0,0,0,0,0,0,0,0,False,0
2025-01-08 18:10:52,persegiHijau,281,330,120,125,177,30,175,32,2,2,True,0.2481556937923647
2025-01-08 18:10:52,Fail to pick,281,330,0,0,0,0,0,0,0,0,False,0
2025-01-08 18:10:52,persegiHijau,281,329,120,123,81,22,76,22,5,0,True,0.15741258052423227
2025-01-08 18:10:52,Fail to pick,281,329,0,0,0,0,0,0,0,0,False,0
2025-01-08 18:10:52,persegiHijau,281,331,121,121,109,18,109,19,0,1,True,0.17422691148746255
2025-01-08 18:10:52,Fail to pick,281,331,0,0,0,0,0,0,0,0,False,0
2025-01-08 18:10:53,persegiHijau,281,333,121,119,2,58,6,57,4,1,True,0.36764616113607207
2025-01-08 18:10:53,Fail to pick,281,333,0,0,0,0,0,0,0,0,False,0
2025-01-08 18:10:57,persegiHijau,280,335,117,116,120,57,120,58,0,1,True,0.48182044218244025
2025-01-08 18:10:57,Hijau,280,335,tensor(117.0979),tensor(116.3895),106,25,110,22,4,3,True,0.0004987716674804688
2025-01-08 18:10:57,Fail to pick,280,335,0,0,0,0,0,0,0,0,False,0
2025-01-08 18:10:57,persegiHijau,278,332,116,118,149,12,149,14,0,2,True,0.27739311302255054
2025-01-08 18:10:57,Fail to pick,278,332,0,0,0,0,0,0,0,0,False,0
2025-01-08 18:10:57,persegiHijau,278,334,115,116,30,52,33,53,3,1,True,0.18388163536000404
2025-01-08 18:10:57,Fail to pick,278,334,0,0,0,0,0,0,0,0,False,0
2025-01-08 18:10:57,persegiHijau,281,331,117,117,11,77,14,78,3,1,True,0.44165340661298014
2025-01-08 18:10:57,Fail to pick,281,331,0,0,0,0,0,0,0,0,False,0
2025-01-08 18:10:57,persegiHijau,286,334,116,117,168,9,165,8,3,1,True,0.40164511184009255
2025-01-08 18:10:57,Fail to pick,286,334,0,0,0,0,0,0,0,0,False,0
2025-01-08 18:10:57,persegiHijau,279,333,116,117,13,20,10,15,3,5,True,0.3609680714837513
2025-01-08 18:10:57,Fail to pick,279,333,0,0,0,0,0,0,0,0,False,0
2025-01-08 18:10:57,persegiHijau,281,332,120,117,125,30,120,33,5,3,True,0.11226403355383448
2025-01-08 18:10:57,Fail to pick,281,332,0,0,0,0,0,0,0,0,False,0
2025-01-08 18:10:57,persegiHijau,278,332,117,120,7,78,9,73,2,5,True,0.31497258090758606
2025-01-08 18:10:57,Fail to pick,278,332,0,0,0,0,0,0,0,0,False,0
2025-01-08 18:10:57,persegiHijau,279,329,119,118,192,61,188,62,4,1,True,0.376576271286583
2025-01-08 18:10:57,Fail to pick,279,329,0,0,0,0,0,0,0,0,False,0
2025-01-08 18:10:57,persegiHijau,301,342,120,114,73,97,76,97,3,0,True,0.21366347847052083
2025-01-08 18:10:58,persegiHijau,295,347,120,116,144,76,142,80,2,4,True,0.15962214039257971
2025-01-08 18:10:58,Hijau,295,347,tensor(120.4221),tensor(116.8495),103,27,105,26,2,1,True,0.0
2025-01-08 18:10:58,Fail to pick,295,347,0,0,0,0,0,0,0,0,False,0
2025-01-08 18:10:58,persegiHijau,300,344,123,119,121,16,119,13,2,3,True,0.15339326678756626
2025-01-08 18:10:58,Fail to pick,300,344,0,0,0,0,0,0,0,0,False,0
2025-01-08 18:10:58,persegiHijau,293,340,120,116,41,19,38,18,3,1,True,0.11457741225064547
2025-01-08 18:10:58,Fail to pick,293,340,0,0,0,0,0,0,0,0,False,0
2025-01-08 18:10:58,persegiHijau,305,346,118,117,41,85,45,88,4,3,True,0.16161070232935912
2025-01-08 18:10:58,persegiHijau,278,328,115,119,0,98,2,93,2,5,True,0.24705379387484516
2025-01-08 18:10:58,persegiHijau,298,346,122,117,144,30,142,34,2,4,True,0.37724737675325415
2025-01-08 18:10:58,persegiHijau,280,332,119,119,130,92,131,87,1,5,True,0.23502692190802496
2025-01-08 18:10:58,persegiHijau,296,348,120,117,155,93,154,95,1,2,False,0.10725538853966216
2025-01-08 18:10:58,persegiHijau,295,342,119,116,172,70,171,68,1,2,True,0.20254648687635435
2025-01-08 18:10:58,Fail to pick,295,342,0,0,0,0,0,0,0,0,False,0
2025-01-08 18:10:58,persegiHijau,276,332,118,119,66,65,69,66,3,1,True,0.24007617362259423
2025-01-08 18:10:59,persegiHijau,277,331,116,118,89,18,88,20,1,2,True,0.2805526620993411
2025-01-08 18:10:59,Hijau,277,331,tensor(116.7986),tensor(118.3540),108,25,103,29,5,4,True,0.0
2025-01-08 18:10:59,Fail to pick,277,331,0,0,0,0,0,0,0,0,False,0
2025-01-08 18:10:59,persegiHijau,249,320,113,124,190,52,194,56,4,4,True,0.37879920068610085
2025-01-08 18:10:59,persegiHijau,278,326,116,119,14,22,16,22,2,0,True,0.47970356427387595
2025-01-08 18:10:59,persegiHijau,293,339,119,114,91,11,87,15,4,4,True,0.16859291504295393
2025-01-08 18:10:59,persegiHijau,276,332,116,119,166,5,167,8,1,3,True,0.4719256698853822
2025-01-08 18:10:59,persegiHijau,274,330,117,118,85,15,83,16,2,1,True,0.12277725003232454
2025-01-08 18:10:59,Fail to pick,274,330,0,0,0,0,0,0,0,0,False,0
2025-01-08 18:10:59,persegiHijau,276,331,118,120,147,81,147,82,0,1,True,0.10491421512062878
2025-01-08 18:10:59,Fail to pick,276,331,0,0,0,0,0,0,0,0,False,0
2025-01-08 18:10:59,persegiHijau,296,342,123,115,17,70,20,66,3,4,True,0.3959368218536704
2025-01-08 18:10:59,persegiHijau,296,349,118,116,145,96,147,92,2,4,True,0.21916675214655246
2025-01-08 18:10:59,Fail to pick,296,349,0,0,0,0,0,0,0,0,False,0
2025-01-08 18:11:00,persegiHijau,276,331,118,116,16,54,19,53,3,1,True,0.23226113010705063
2025-01-08 18:11:00,Hijau,276,331,tensor(118.0354),tensor(116.9644),108,25,108,20,0,5,True,0.0
2025-01-08 18:11:00,persegiHijau,274,335,118,115,192,25,196,21,4,4,True,0.47533953442390253
2025-01-08 18:11:00,Fail to pick,274,335,0,0,0,0,0,0,0,0,False,0
2025-01-08 18:11:00,persegiHijau,291,350,118,115,65,17,62,12,3,5,True,0.4448240944613505
2025-01-08 18:11:00,persegiHijau,277,335,115,117,79,1,77,5,2,4,True,0.33786603073734056
2025-01-08 18:11:00,persegiHijau,274,333,115,117,79,97,78,100,1,3,False,0.38431256198840413
2025-01-08 18:11:00,Fail to pick,274,333,0,0,0,0,0,0,0,0,False,0
2025-01-08 18:11:00,persegiHijau,297,348,119,115,197,41,196,37,1,4,True,0.45725393830731076
2025-01-08 18:11:00,persegiHijau,293,339,118,114,111,11,114,12,3,1,True,0.16629973726561903
2025-01-08 18:11:00,Fail to pick,293,339,0,0,0,0,0,0,0,0,False,0
2025-01-08 18:11:00,persegiHijau,277,331,119,117,158,61,160,59,2,2,True,0.15205352157731933
2025-01-08 18:11:00,persegiHijau,278,327,115,117,123,25,124,28,1,3,False,0.2744542016461423
2025-01-08 18:11:00,Fail to pick,278,327,0,0,0,0,0,0,0,0,False,0
2025-01-08 18:11:01,persegiHijau,297,345,120,117,183,12,183,14,0,2,True,0.2998817935364382
2025-01-08 18:11:01,Hijau,297,345,tensor(120.8775),tensor(117.6424),104,27,101,30,3,3,True,0.0
2025-01-08 18:11:01,persegiHijau,277,334,117,118,152,41,152,45,0,4,True,0.3160554888140876
2025-01-08 18:11:01,persegiHijau,269,333,118,117,128,98,124,94,4,4,True,0.21610621784803152
2025-01-08 18:11:01,Fail to pick,269,333,0,0,0,0,0,0,0,0,False,0
2025-01-08 18:11:01,persegiHijau,276,331,119,118,159,43,156,40,3,3,True,0.3628632777084103
2025-01-08 18:11:01,Fail to pick,276,331,0,0,0,0,0,0,0,0,False,0
2025-01-08 18:11:01,persegiHijau,278,330,117,119,17,4,14,5,3,1,True,0.3624748268704674
2025-01-08 18:11:01,Fail to pick,278,330,0,0,0,0,0,0,0,0,False,0
2025-01-08 18:11:01,persegiHijau,274,330,120,118,32,5,34,4,2,1,True,0.47831455119170907
2025-01-08 18:11:01,Fail to pick,274,330,0,0,0,0,0,0,0,0,False,0
2025-01-08 18:11:01,persegiHijau,276,333,118,115,161,72,165,70,4,2,True,0.40592063933930034
2025-01-08 18:11:01,Fail to pick,276,333,0,0,0,0,0,0,0,0,False,0
2025-01-08 18:11:01,persegiHijau,301,346,124,120,39,47,41,49,2,2,True,0.2060256056679658
2025-01-08 18:11:01,persegiHijau,272,334,116,117,164,91,165,92,1,1,True,0.19722532783446278
2025-01-08 18:11:02,persegiHijau,271,333,116,118,122,94,125,95,3,1,True,0.3706454626645945
2025-01-08 18:11:02,Fail to pick,271,333,0,0,0,0,0,0,0,0,False,0
2025-01-08 18:11:02,persegiHijau,305,349,122,115,43,86,47,84,4,2,True,0.371246386232138
2025-01-08 18:11:02,Hijau,305,349,tensor(122.8544),tensor(115.9142),103,28,103,28,0,0,True,0.000499725341796875
2025-01-08 18:11:02,persegiHijau,301,348,123,117,46,84,42,80,4,4,True,0.11209048487980251
2025-01-08 18:11:02,Fail to pick,301,348,0,0,0,0,0,0,0,0,False,0
2025-01-08 18:11:02,persegiHijau,302,349,121,116,143,21,142,25,1,4,True,0.23966387284005453
2025-01-08 18:11:02,Fail to pick,302,349,0,0,0,0,0,0,0,0,False,0
2025-01-08 18:11:02,persegiHijau,279,327,116,118,181,41,181,40,0,1,True,0.4938665428307376
2025-01-08 18:11:02,persegiHijau,276,329,117,119,107,17,103,20,4,3,True,0.14936929135483157
2025-01-08 18:11:02,Fail to pick,276,329,0,0,0,0,0,0,0,0,False,0
2025-01-08 18:11:02,persegiHijau,273,334,118,117,50,65,49,60,1,5,True,0.4593557805074564
2025-01-08 18:11:02,Fail to pick,273,334,0,0,0,0,0,0,0,0,False,0
2025-01-08 18:11:02,persegiHijau,274,332,119,119,88,56,89,58,1,2,True,0.4529663641254258
2025-01-08 18:11:02,Fail to pick,274,332,0,0,0,0,0,0,0,0,False,0
2025-01-08 18:11:02,persegiHijau,271,330,115,120,197,58,194,59,3,1,True,0.17348951096906123
2025-01-08 18:11:02,Fail to pick,271,330,0,0,0,0,0,0,0,0,False,0
2025-01-08 18:11:03,persegiHijau,272,331,116,119,69,82,66,84,3,2,True,0.2599248767498109
2025-01-08 18:11:03,Fail to pick,272,331,0,0,0,0,0,0,0,0,False,0
2025-01-08 18:11:03,persegiHijau,297,340,123,115,156,19,151,14,5,5,True,0.39704060643802186
2025-01-08 18:11:03,persegiHijau,297,346,124,119,52,32,47,35,5,3,True,0.20812318910431205
2025-01-08 18:11:03,Hijau,297,346,tensor(124.7593),tensor(119.1407),103,27,102,29,1,2,True,0.0004994869232177734
2025-01-08 18:11:03,Fail to pick,297,346,0,0,0,0,0,0,0,0,False,0
2025-01-08 18:11:03,persegiHijau,297,349,120,117,43,2,47,2,4,0,True,0.3755398952315382
2025-01-08 18:11:03,Fail to pick,297,349,0,0,0,0,0,0,0,0,False,0
2025-01-08 18:11:03,persegiHijau,276,328,117,118,79,46,77,43,2,3,True,0.28065956271609027
2025-01-08 18:11:03,persegiHijau,274,328,118,117,155,41,158,40,3,1,True,0.42748565835571395
2025-01-08 18:11:03,Fail to pick,274,328,0,0,0,0,0,0,0,0,False,0
2025-01-08 18:11:03,persegiHijau,268,330,117,119,145,67,142,71,3,4,True,0.20580824864942457
2025-01-08 18:11:03,Fail to pick,268,330,0,0,0,0,0,0,0,0,False,0
2025-01-08 18:11:03,persegiHijau,275,327,118,117,34,89,34,91,0,2,True,0.45659186424414966
2025-01-08 18:11:03,Fail to pick,275,327,0,0,0,0,0,0,0,0,False,0
2025-01-08 18:11:03,persegiHijau,271,328,117,118,107,84,109,81,2,3,True,0.25648286682795224
2025-01-08 18:11:03,Fail to pick,271,328,0,0,0,0,0,0,0,0,False,0
2025-01-08 18:11:03,persegiHijau,278,332,117,118,109,58,106,62,3,4,True,0.41603291240556717
2025-01-08 18:11:03,Fail to pick,278,332,0,0,0,0,0,0,0,0,False,0
2025-01-08 18:11:08,persegiHijau,314,348,133,124,191,72,186,67,5,5,True,0.283720850738879
2025-01-08 18:11:08,Hijau,314,348,tensor(133.0840),tensor(124.4709),103,29,106,24,3,5,True,0.0
2025-01-08 18:11:08,persegiHijau,286,329,127,122,194,35,189,39,5,4,True,0.2394303449899139
2025-01-08 18:11:08,persegiHijau,318,354,132,123,59,63,62,64,3,1,True,0.43265837827605014
2025-01-08 18:11:08,persegiHijau,291,333,124,121,73,2,68,3,5,1,True,0.25923163629603907
2025-01-08 18:11:08,persegiHijau,322,350,131,121,145,78,147,82,2,4,True,0.324818680396883
2025-01-08 18:11:08,persegiHijau,284,327,124,123,181,54,182,54,1,0,True,0.23805337493617001
2025-01-08 18:11:09,persegiHijau,314,350,129,122,68,34,68,32,0,2,True,0.1350968872650119
2025-01-08 18:11:09,persegiHijau,293,336,120,124,193,84,196,85,3,1,False,0.21225506833004598
2025-01-08 18:11:09,persegiHijau,283,328,122,123,185,81,187,76,2,5,True,0.33898851683169284
2025-01-08 18:11:09,persegiHijau,308,346,129,125,146,58,148,53,2,5,True,0.2022727357750982
2025-01-08 18:11:09,Hijau,308,346,tensor(129.5741),tensor(125.3933),103,28,102,28,1,0,True,0.0
2025-01-08 18:11:09,persegiHijau,304,344,130,125,65,78,62,73,3,5,True,0.34124665949094424
2025-01-08 18:11:09,Fail to pick,304,344,0,0,0,0,0,0,0,0,False,0
2025-01-08 18:11:09,persegiHijau,305,346,132,125,132,6,128,3,4,3,True,0.2337843255092197
2025-01-08 18:11:09,Fail to pick,305,346,0,0,0,0,0,0,0,0,False,0
2025-01-08 18:11:09,persegiHijau,294,328,124,127,160,98,157,98,3,0,True,0.2734664807536178
2025-01-08 18:11:09,persegiHijau,316,350,125,126,168,80,172,83,4,3,True,0.38962716704340783
2025-01-08 18:11:11,persegiHijau,447,461,116,120,30,62,25,65,5,3,True,0.48021479798882716
2025-01-08 18:11:11,Hijau,447,461,tensor(116.3913),tensor(120.6962),71,41,73,40,2,1,True,0.0004990100860595703
2025-01-08 18:11:11,persegiHijau,449,458,113,125,136,28,135,23,1,5,True,0.3327788355300584
2025-01-08 18:11:11,Fail to pick,449,458,0,0,0,0,0,0,0,0,False,0
2025-01-08 18:11:11,persegiHijau,455,464,116,121,111,97,115,94,4,3,True,0.2387221854738853
2025-01-08 18:11:11,Fail to pick,455,464,0,0,0,0,0,0,0,0,False,0
2025-01-08 18:11:11,persegiHijau,414,489,132,124,26,19,22,20,4,1,True,0.4038939689989858
2025-01-08 18:11:11,persegiHijau,471,520,122,120,50,78,48,82,2,4,True,0.1651707317125003
2025-01-08 18:11:11,persegiHijau,489,531,120,123,37,59,40,58,3,1,True,0.27146509407305397
2025-01-08 18:11:12,persegiHijau,490,540,122,119,103,23,100,27,3,4,True,0.38790016255448834
2025-01-08 18:11:12,Fail to pick,490,540,0,0,0,0,0,0,0,0,False,0
2025-01-08 18:11:12,persegiHijau,513,529,118,123,55,75,59,77,4,2,True,0.19298090475096036
2025-01-08 18:11:12,Hijau,513,529,tensor(118.4150),tensor(123.5527),53,47,53,44,0,3,True,0.0004985332489013672
2025-01-08 18:11:12,persegiHijau,511,520,121,116,82,31,83,35,1,4,True,0.3282143572126841
2025-01-08 18:11:12,Fail to pick,511,520,0,0,0,0,0,0,0,0,False,0
2025-01-08 18:11:12,persegiHijau,500,519,118,114,187,55,187,50,0,5,True,0.31832001862018355
2025-01-08 18:11:12,persegiHijau,497,537,121,117,10,68,8,67,2,1,True,0.3559256896333328
2025-01-08 18:11:14,persegiHijau,495,542,124,119,114,59,114,56,0,3,True,0.1107294572010408
2025-01-08 18:11:14,Hijau,495,542,tensor(124.9943),tensor(119.0905),49,45,53,42,4,3,True,0.0
2025-01-08 18:11:14,Fail to pick,495,542,0,0,0,0,0,0,0,0,False,0
2025-01-08 18:11:14,persegiHijau,485,541,118,116,14,88,15,90,1,2,True,0.29810499767480364
2025-01-08 18:11:14,persegiHijau,459,467,116,115,154,20,158,20,4,0,False,0.4630080786623364
2025-01-08 18:11:19,persegiHijau,458,469,118,111,83,38,84,41,1,3,True,0.4206065133885938
2025-01-08 18:11:19,Hijau,458,469,tensor(118.1581),tensor(111.5367),69,42,72,40,3,2,True,0.0005042552947998047
2025-01-08 18:11:19,Fail to pick,458,469,0,0,0,0,0,0,0,0,False,0
2025-01-08 18:11:19,persegiHijau,457,472,117,111,21,89,23,87,2,2,True,0.4246556459020653
2025-01-08 18:11:19,Fail to pick,457,472,0,0,0,0,0,0,0,0,False,0
2025-01-08 18:11:19,persegiHijau,439,458,118,115,192,17,195,15,3,2,True,0.140701000288464
2025-01-08 18:11:19,persegiHijau,468,469,119,112,140,40,139,40,1,0,True,0.4303300755800078
2025-01-08 18:11:19,persegiHijau,474,472,121,111,97,23,95,26,2,3,True,0.1318106615936571
2025-01-08 18:11:19,Fail to pick,474,472,0,0,0,0,0,0,0,0,False,0
2025-01-08 18:11:19,persegiHijau,461,469,118,110,112,97,108,94,4,3,True,0.2419658360729865
2025-01-08 18:11:19,persegiHijau,438,456,117,115,142,80,137,84,5,4,True,0.4802126287722174
2025-01-08 18:11:19,persegiHijau,464,467,121,111,38,41,37,43,1,2,True,0.4160101929712219
2025-01-08 18:11:19,persegiHijau,476,474,122,110,130,90,128,92,2,2,True,0.3898819011533261
2025-01-08 18:11:20,persegiHijau,445,449,119,112,97,87,95,82,2,5,False,0.10747210869404787
2025-01-08 18:11:20,persegiHijau,441,454,122,115,109,3,113,4,4,1,False,0.17803710061184172
2025-01-08 18:11:20,Hijau,441,454,tensor(122.5714),tensor(115.1746),73,40,69,42,4,2,True,0.0
2025-01-08 18:11:20,Fail to pick,441,454,0,0,0,0,0,0,0,0,False,0
2025-01-08 18:11:20,persegiHijau,459,466,117,113,36,9,34,13,2,4,True,0.48051539163533763
2025-01-08 18:11:20,persegiHijau,429,458,117,116,63,38,58,37,5,1,True,0.21443889288664653
2025-01-08 18:11:20,persegiHijau,465,467,120,112,78,3,78,0,0,3,True,0.22346489535743097
2025-01-08 18:11:20,persegiHijau,439,452,119,113,186,90,182,94,4,4,True,0.23106872556552266
2025-01-08 18:11:20,persegiHijau,440,456,117,114,153,44,149,39,4,5,True,0.2703564311579375
2025-01-08 18:11:20,Fail to pick,440,456,0,0,0,0,0,0,0,0,False,0
2025-01-08 18:11:20,persegiHijau,466,470,118,112,3,9,-1,6,4,3,True,0.30242736926284947
2025-01-08 18:11:20,persegiHijau,443,452,121,114,42,83,44,83,2,0,True,0.49109270974690455
2025-01-08 18:11:20,persegiHijau,472,469,119,109,107,34,107,38,0,4,True,0.2590131082861772
2025-01-08 18:11:21,persegiHijau,474,477,120,107,76,91,72,92,4,1,True,0.49099142615569713
2025-01-08 18:11:21,Fail to pick,474,477,0,0,0,0,0,0,0,0,False,0
2025-01-08 18:11:21,persegiHijau,477,473,119,107,67,8,65,8,2,0,True,0.2609921557754607
2025-01-08 18:11:21,Hijau,477,473,tensor(119.2544),tensor(107.7682),68,44,69,46,1,2,True,0.0005059242248535156
2025-01-08 18:11:21,Fail to pick,477,473,0,0,0,0,0,0,0,0,False,0
2025-01-08 18:11:21,persegiHijau,472,479,120,109,24,99,25,95,1,4,True,0.4750156853836133
2025-01-08 18:11:21,Fail to pick,472,479,0,0,0,0,0,0,0,0,False,0
2025-01-08 18:11:21,persegiHijau,441,453,119,111,164,9,165,12,1,3,True,0.3062729804037121
2025-01-08 18:11:21,persegiHijau,476,470,123,110,81,43,82,44,1,1,True,0.20812017844944863
2025-01-08 18:11:21,persegiHijau,469,469,122,109,153,48,149,47,4,1,True,0.48330337921743705
2025-01-08 18:11:21,Fail to pick,469,469,0,0,0,0,0,0,0,0,False,0
2025-01-08 18:11:21,persegiHijau,466,467,122,110,120,75,123,78,3,3,True,0.2648456973382221
2025-01-08 18:11:21,Fail to pick,466,467,0,0,0,0,0,0,0,0,False,0
2025-01-08 18:11:21,persegiHijau,477,475,120,109,99,0,99,-3,0,3,True,0.30592781698718874
2025-01-08 18:11:21,persegiHijau,470,478,124,109,106,18,102,16,4,2,True,0.3374398839142788
2025-01-08 18:11:21,Fail to pick,470,478,0,0,0,0,0,0,0,0,False,0
2025-01-08 18:11:22,persegiHijau,440,454,123,115,166,93,166,95,0,2,True,0.28474884765128083
2025-01-08 18:11:22,persegiHijau,472,475,125,111,88,52,88,49,0,3,True,0.4442355144953677
2025-01-08 18:11:22,persegiHijau,466,476,122,112,178,62,179,58,1,4,True,0.22282275952777178
2025-01-08 18:11:22,Hijau,466,476,tensor(122.6858),tensor(112.0717),67,43,62,41,5,2,True,0.0
2025-01-08 18:11:22,Fail to pick,466,476,0,0,0,0,0,0,0,0,False,0
2025-01-08 18:11:22,persegiHijau,480,475,121,111,99,33,96,32,3,1,True,0.1771791696895837
2025-01-08 18:11:22,persegiHijau,442,457,122,114,70,41,71,40,1,1,True,0.3158729903392121
2025-01-08 18:11:22,persegiHijau,465,474,122,108,92,67,95,66,3,1,True,0.1106147951785692
2025-01-08 18:11:22,persegiHijau,431,458,118,115,0,24,1,24,1,0,True,0.35481288483470597
2025-01-08 18:11:22,persegiHijau,457,472,117,114,148,4,150,8,2,4,True,0.2656894466025873
2025-01-08 18:11:22,persegiHijau,462,467,118,110,42,30,37,30,5,0,True,0.3696852267295718
2025-01-08 18:11:22,Fail to pick,462,467,0,0,0,0,0,0,0,0,False,0
2025-01-08 18:11:22,persegiHijau,461,467,118,111,22,1,24,5,2,4,True,0.31594945803177654
2025-01-08 18:11:22,Fail to pick,461,467,0,0,0,0,0,0,0,0,False,0
2025-01-08 18:11:23,persegiHijau,479,474,119,108,150,46,152,46,2,0,True,0.2866063510963304
2025-01-08 18:11:23,persegiHijau,437,460,118,114,181,34,180,35,1,1,True,0.13436188547823932
2025-01-08 18:11:23,Hijau,437,460,tensor(118.9166),tensor(114.7261),72,40,67,39,5,1,True,0.0
2025-01-08 18:11:23,persegiHijau,469,477,121,107,161,20,157,15,4,5,True,0.37219096149150577
2025-01-08 18:11:23,persegiHijau,475,475,122,109,184,54,179,57,5,3,True,0.46213989516699006
2025-01-08 18:11:23,Fail to pick,475,475,0,0,0,0,0,0,0,0,False,0
2025-01-08 18:11:23,persegiHijau,469,471,120,108,143,33,138,28,5,5,True,0.3079373508745432
2025-01-08 18:11:23,Fail to pick,469,471,0,0,0,0,0,0,0,0,False,0
2025-01-08 18:11:23,persegiHijau,479,477,119,107,89,75,86,76,3,1,True,0.3770532407812973
2025-01-08 18:11:23,persegiHijau,466,470,120,109,155,73,151,77,4,4,True,0.4971879049219631
2025-01-08 18:11:23,persegiHijau,470,474,121,108,155,39,155,40,0,1,True,0.47039458249435606
2025-01-08 18:11:23,Fail to pick,470,474,0,0,0,0,0,0,0,0,False,0
2025-01-08 18:11:23,persegiHijau,469,470,121,110,31,92,33,87,2,5,True,0.45902640434117126
2025-01-08 18:11:23,Fail to pick,469,470,0,0,0,0,0,0,0,0,False,0
2025-01-08 18:11:24,persegiHijau,480,475,121,108,62,68,65,71,3,3,True,0.23224235126885093
2025-01-08 18:11:24,persegiHijau,473,475,121,107,174,81,177,85,3,4,True,0.27654645417123225
2025-01-08 18:11:24,Fail to pick,473,475,0,0,0,0,0,0,0,0,False,0
2025-01-08 18:11:24,persegiHijau,437,456,119,113,149,4,144,6,5,2,True,0.104110081292019
2025-01-08 18:11:24,Hijau,437,456,tensor(119.8578),tensor(113.3967),73,40,68,39,5,1,True,0.0
2025-01-08 18:11:24,persegiHijau,431,461,120,116,74,21,71,16,3,5,True,0.4467853682792705
2025-01-08 18:11:24,Fail to pick,431,461,0,0,0,0,0,0,0,0,False,0
2025-01-08 18:11:24,persegiHijau,474,474,120,110,3,40,1,43,2,3,True,0.3210717694561668
2025-01-08 18:11:24,persegiHijau,471,473,121,109,109,19,113,22,4,3,True,0.40205455555321834
2025-01-08 18:11:24,Fail to pick,471,473,0,0,0,0,0,0,0,0,False,0
2025-01-08 18:11:24,persegiHijau,445,459,117,115,79,47,78,50,1,3,True,0.17218325635244258
2025-01-08 18:11:24,persegiHijau,480,476,119,108,167,28,165,27,2,1,True,0.3262499073836791
2025-01-08 18:11:24,persegiHijau,436,456,118,116,148,87,147,90,1,3,True,0.19431748015732225
2025-01-08 18:11:24,persegiHijau,439,453,119,116,167,76,167,79,0,3,True,0.4903526481561118
2025-01-08 18:11:24,Fail to pick,439,453,0,0,0,0,0,0,0,0,False,0
2025-01-08 18:11:25,persegiHijau,434,462,117,114,99,35,101,34,2,1,True,0.19431959975736182
2025-01-08 18:11:25,Fail to pick,434,462,0,0,0,0,0,0,0,0,False,0
2025-01-08 18:11:25,persegiHijau,438,455,120,112,15,0,13,2,2,2,True,0.18114897058389398
2025-01-08 18:11:25,Fail to pick,438,455,0,0,0,0,0,0,0,0,False,0
2025-01-08 18:11:29,persegiHijau,486,480,121,108,143,32,139,27,4,5,False,0.4796012383770277
2025-01-08 18:11:29,Hijau,486,480,tensor(121.5152),tensor(108.9122),66,45,70,41,4,4,True,0.0
2025-01-08 18:11:30,persegiHijau,483,477,121,109,118,38,115,37,3,1,True,0.4750038789551374
2025-01-08 18:11:30,Fail to pick,483,477,0,0,0,0,0,0,0,0,False,0
2025-01-08 18:11:30,persegiHijau,482,480,121,110,185,9,188,11,3,2,True,0.47373780316370995
2025-01-08 18:11:30,Fail to pick,482,480,0,0,0,0,0,0,0,0,False,0
2025-01-08 18:11:31,persegiHijau,299,402,111,116,17,0,21,-4,4,4,True,0.3223533752888085
2025-01-08 18:11:31,Hijau,299,402,tensor(111.4110),tensor(116.0024),88,27,88,26,0,1,True,0.0
2025-01-08 18:11:31,persegiHijau,320,418,114,113,23,88,21,83,2,5,True,0.48988706502772594
2025-01-08 18:11:32,persegiHijau,331,422,118,113,114,25,112,25,2,0,True,0.16404639332036436
2025-01-08 18:11:32,persegiHijau,323,414,116,114,147,67,147,66,0,1,True,0.4127456112596255
2025-01-08 18:11:32,Fail to pick,323,414,0,0,0,0,0,0,0,0,False,0
2025-01-08 18:11:32,persegiHijau,335,423,119,112,16,49,13,51,3,2,True,0.30280631586783635
2025-01-08 18:11:32,persegiHijau,332,421,114,113,137,6,138,7,1,1,False,0.2860054721739752
2025-01-08 18:11:32,Fail to pick,332,421,0,0,0,0,0,0,0,0,False,0
2025-01-08 18:11:32,persegiHijau,337,418,117,110,169,21,169,24,0,3,True,0.182493587349282
2025-01-08 18:11:32,Fail to pick,337,418,0,0,0,0,0,0,0,0,False,0
2025-01-08 18:11:32,persegiHijau,337,418,117,109,86,56,90,55,4,1,False,0.14803867603526225
2025-01-08 18:11:32,Fail to pick,337,418,0,0,0,0,0,0,0,0,False,0
2025-01-08 18:11:32,persegiHijau,296,387,109,115,131,36,134,31,3,5,True,0.26527487926345916
2025-01-08 18:11:32,persegiHijau,293,391,112,114,113,7,114,2,1,5,True,0.19322509723649245
2025-01-08 18:11:32,Fail to pick,293,391,0,0,0,0,0,0,0,0,False,0
2025-01-08 18:11:32,persegiHijau,345,418,118,111,104,62,104,65,0,3,True,0.21988317098197144
2025-01-08 18:11:32,Hijau,345,418,tensor(118.5195),tensor(111.2489),83,31,87,34,4,3,True,0.0
2025-01-08 18:11:33,persegiHijau,339,418,115,110,133,45,136,41,3,4,True,0.17524867882617534
2025-01-08 18:11:33,Fail to pick,339,418,0,0,0,0,0,0,0,0,False,0
2025-01-08 18:11:33,persegiHijau,345,420,117,110,67,90,62,94,5,4,True,0.2751492676222259
2025-01-08 18:11:33,Fail to pick,345,420,0,0,0,0,0,0,0,0,False,0
2025-01-08 18:11:33,persegiHijau,343,423,117,106,185,93,187,93,2,0,True,0.19755958615445085
2025-01-08 18:11:33,Fail to pick,343,423,0,0,0,0,0,0,0,0,False,0
2025-01-08 18:11:33,persegiHijau,337,422,118,107,189,50,187,51,2,1,True,0.3467986849242478
2025-01-08 18:11:33,Fail to pick,337,422,0,0,0,0,0,0,0,0,False,0
2025-01-08 18:11:33,persegiHijau,338,422,118,110,171,12,172,11,1,1,True,0.20973903371036992
2025-01-08 18:11:33,Fail to pick,338,422,0,0,0,0,0,0,0,0,False,0
2025-01-08 18:11:33,persegiHijau,329,417,115,109,150,90,151,88,1,2,True,0.14442473608178674
2025-01-08 18:11:33,Fail to pick,329,417,0,0,0,0,0,0,0,0,False,0
2025-01-08 18:11:33,persegiHijau,340,421,117,109,158,6,153,2,5,4,True,0.37274419567886385
2025-01-08 18:11:33,persegiHijau,342,420,121,111,34,74,38,75,4,1,True,0.13863983155458814
2025-01-08 18:11:33,Fail to pick,342,420,0,0,0,0,0,0,0,0,False,0
2025-01-08 18:11:33,persegiHijau,337,410,117,115,5,15,4,12,1,3,True,0.30638727549830375
2025-01-08 18:11:33,persegiHijau,320,417,115,114,76,66,71,64,5,2,True,0.4818258714905298
2025-01-08 18:11:33,Hijau,320,417,tensor(115.9946),tensor(114.2208),84,29,85,26,1,3,True,0.0
2025-01-08 18:11:34,persegiHijau,339,421,113,105,121,38,118,37,3,1,True,0.397869317348725
2025-01-08 18:11:34,persegiHijau,335,421,116,109,154,79,157,76,3,3,True,0.1436458784023111
2025-01-08 18:11:34,Fail to pick,335,421,0,0,0,0,0,0,0,0,False,0
2025-01-08 18:11:34,persegiHijau,287,391,107,109,46,45,47,46,1,1,True,0.451486390406328
2025-01-08 18:11:34,persegiHijau,343,418,119,107,129,90,127,91,2,1,True,0.13607538415672044
2025-01-08 18:11:34,persegiHijau,337,421,117,105,156,2,158,1,2,1,True,0.2572510448189035
2025-01-08 18:11:34,Fail to pick,337,421,0,0,0,0,0,0,0,0,False,0
2025-01-08 18:11:34,persegiHijau,330,426,116,106,53,73,49,75,4,2,True,0.35374939069605293
2025-01-08 18:11:34,Hijau,330,426,tensor(116.1619),tensor(106.9339),81,30,84,26,3,4,True,0.0
2025-01-08 18:11:34,Fail to pick,330,426,0,0,0,0,0,0,0,0,False,0
2025-01-08 18:11:35,persegiHijau,339,425,117,104,29,79,32,80,3,1,True,0.20111251496930632
2025-01-08 18:11:35,Fail to pick,339,425,0,0,0,0,0,0,0,0,False,0
2025-01-08 18:11:35,persegiHijau,340,423,116,106,45,3,48,1,3,2,True,0.2951136932292391
2025-01-08 18:11:35,Fail to pick,340,423,0,0,0,0,0,0,0,0,False,0
2025-01-08 18:11:35,persegiHijau,341,421,118,106,157,11,155,14,2,3,True,0.12076657088599206
2025-01-08 18:11:35,Fail to pick,341,421,0,0,0,0,0,0,0,0,False,0
2025-01-08 18:11:35,persegiHijau,326,417,120,106,195,36,197,40,2,4,False,0.24845397136581365
2025-01-08 18:11:35,persegiHijau,336,426,121,107,14,0,9,-2,5,2,True,0.3062120899744335
2025-01-08 18:11:35,persegiHijau,338,423,119,106,137,99,137,101,0,2,True,0.2629918548389736
2025-01-08 18:11:35,Fail to pick,338,423,0,0,0,0,0,0,0,0,False,0
2025-01-08 18:11:35,persegiHijau,342,422,116,106,68,74,72,69,4,5,True,0.3971048809717176
2025-01-08 18:11:35,Fail to pick,342,422,0,0,0,0,0,0,0,0,False,0
2025-01-08 18:11:35,persegiHijau,333,427,117,106,18,7,21,5,3,2,True,0.24370039438674795
2025-01-08 18:11:35,Fail to pick,333,427,0,0,0,0,0,0,0,0,False,0
2025-01-08 18:11:35,persegiHijau,341,421,117,104,24,62,24,60,0,2,True,0.46112152501500336
2025-01-08 18:11:35,Fail to pick,341,421,0,0,0,0,0,0,0,0,False,0
2025-01-08 18:11:36,persegiHijau,339,423,117,106,68,70,63,68,5,2,True,0.3134069637733299
2025-01-08 18:11:36,Hijau,339,423,tensor(117.6888),tensor(106.8186),82,31,77,31,5,0,True,0.0
2025-01-08 18:11:36,Fail to pick,339,423,0,0,0,0,0,0,0,0,False,0
2025-01-08 18:11:36,persegiHijau,341,420,116,103,177,89,177,92,0,3,True,0.4814702914174903
2025-01-08 18:11:36,Fail to pick,341,420,0,0,0,0,0,0,0,0,False,0
2025-01-08 18:11:36,persegiHijau,345,417,119,112,62,38,61,35,1,3,True,0.24795090521403118
2025-01-08 18:11:36,Fail to pick,345,417,0,0,0,0,0,0,0,0,False,0
2025-01-08 18:11:41,persegiHijau,294,418,146,131,157,37,152,33,5,4,True,0.3005851883491534
2025-01-08 18:11:41,Hijau,294,418,tensor(146.5618),tensor(131.5736),83,27,85,24,2,3,True,0.0
2025-01-08 18:11:41,persegiHijau,295,416,144,130,116,68,111,71,5,3,True,0.3520465893270025
2025-01-08 18:11:41,Fail to pick,295,416,0,0,0,0,0,0,0,0,False,0
2025-01-08 18:11:41,persegiHijau,304,416,144,128,31,21,26,17,5,4,True,0.4261411884987255
2025-01-08 18:11:41,Fail to pick,304,416,0,0,0,0,0,0,0,0,False,0
2025-01-08 18:11:41,persegiHijau,302,415,142,133,164,73,160,76,4,3,False,0.4739508371787585
2025-01-08 18:11:41,Fail to pick,302,415,0,0,0,0,0,0,0,0,False,0
2025-01-08 18:11:41,persegiHijau,327,435,142,127,146,73,145,73,1,0,True,0.3626245278010788
2025-01-08 18:11:41,persegiHijau,335,439,144,123,22,19,19,18,3,1,True,0.21092825504919005
2025-01-08 18:11:41,Fail to pick,335,439,0,0,0,0,0,0,0,0,False,0
2025-01-08 18:11:43,persegiHijau,397,425,113,109,61,53,60,52,1,1,True,0.21474030751366568
2025-01-08 18:11:43,Hijau,397,425,tensor(113.5635),tensor(109.1914),81,36,82,38,1,2,True,0.0005040168762207031
2025-01-08 18:11:43,persegiHijau,396,426,113,109,39,31,40,27,1,4,True,0.34046133045552623
2025-01-08 18:11:43,Fail to pick,396,426,0,0,0,0,0,0,0,0,False,0
2025-01-08 18:11:43,persegiHijau,404,427,118,109,124,86,124,86,0,0,True,0.33908384799123215
2025-01-08 18:11:43,Fail to pick,404,427,0,0,0,0,0,0,0,0,False,0
2025-01-08 18:11:43,persegiHijau,403,429,118,112,69,39,68,43,1,4,True,0.22484132513289967
2025-01-08 18:11:43,Fail to pick,403,429,0,0,0,0,0,0,0,0,False,0
2025-01-08 18:11:43,persegiHijau,392,419,117,110,152,82,147,77,5,5,True,0.30532820132830585
2025-01-08 18:11:43,persegiHijau,386,422,115,112,106,78,104,82,2,4,True,0.39564417915964734
2025-01-08 18:11:43,Fail to pick,386,422,0,0,0,0,0,0,0,0,False,0
2025-01-08 18:11:44,persegiHijau,389,422,118,110,68,11,65,7,3,4,False,0.29288345969831037
2025-01-08 18:11:44,Fail to pick,389,422,0,0,0,0,0,0,0,0,False,0
2025-01-08 18:11:44,persegiHijau,388,418,117,109,160,50,160,45,0,5,True,0.11377552793622621
2025-01-08 18:11:44,Fail to pick,388,418,0,0,0,0,0,0,0,0,False,0
2025-01-08 18:11:44,persegiHijau,365,405,116,112,54,79,57,81,3,2,True,0.3958452568485704
2025-01-08 18:11:44,persegiHijau,391,421,116,108,52,42,52,39,0,3,True,0.28943089549284506
2025-01-08 18:11:44,persegiHijau,354,401,111,114,114,58,113,53,1,5,True,0.2108545157488386
2025-01-08 18:11:44,Hijau,354,401,tensor(111.9269),tensor(114.2255),88,32,90,33,2,1,True,0.0
2025-01-08 18:11:44,persegiHijau,391,418,116,110,197,5,197,4,0,1,True,0.13572214617034875
2025-01-08 18:11:44,persegiHijau,404,423,118,108,152,59,151,62,1,3,True,0.16628870448621108
2025-01-08 18:11:44,persegiHijau,397,431,115,111,11,80,9,83,2,3,True,0.2833266883239044
2025-01-08 18:11:44,Fail to pick,397,431,0,0,0,0,0,0,0,0,False,0
2025-01-08 18:11:44,persegiHijau,389,423,117,110,112,72,111,67,1,5,True,0.270652766177465
2025-01-08 18:11:44,Fail to pick,389,423,0,0,0,0,0,0,0,0,False,0
2025-01-08 18:11:44,persegiHijau,403,429,118,110,88,80,92,78,4,2,True,0.26417861448841706
2025-01-08 18:11:45,persegiHijau,403,428,117,111,148,3,145,2,3,1,True,0.4177340333409223
2025-01-08 18:11:45,Fail to pick,403,428,0,0,0,0,0,0,0,0,False,0
2025-01-08 18:11:45,persegiHijau,402,428,117,109,66,63,69,61,3,2,True,0.3833102686929707
2025-01-08 18:11:45,Fail to pick,402,428,0,0,0,0,0,0,0,0,False,0
2025-01-08 18:11:45,persegiHijau,397,429,116,112,140,23,140,22,0,1,True,0.3487746797831644
2025-01-08 18:11:45,Fail to pick,397,429,0,0,0,0,0,0,0,0,False,0
2025-01-08 18:11:45,persegiHijau,362,399,116,111,7,25,9,28,2,3,True,0.28135921626691546
2025-01-08 18:11:45,persegiHijau,376,418,115,109,194,1,189,-3,5,4,True,0.3779017306357021
2025-01-08 18:11:45,Hijau,376,418,tensor(115.3899),tensor(109.6906),83,34,79,30,4,4,True,0.000499725341796875
2025-01-08 18:11:45,persegiHijau,399,432,117,113,192,82,195,83,3,1,True,0.20693678939534463
2025-01-08 18:11:45,persegiHijau,404,424,119,110,24,58,26,61,2,3,True,0.29048500037612396
2025-01-08 18:11:45,Fail to pick,404,424,0,0,0,0,0,0,0,0,False,0
2025-01-08 18:11:45,persegiHijau,391,421,116,110,152,98,153,100,1,2,True,0.26359146516402165
2025-01-08 18:11:45,persegiHijau,403,424,118,109,31,8,28,3,3,5,True,0.3396798129824684
2025-01-08 18:11:46,persegiHijau,390,423,118,109,165,38,162,34,3,4,True,0.19930832005752627
2025-01-08 18:11:46,persegiHijau,406,426,116,111,29,2,29,5,0,3,False,0.2751531943017653
2025-01-08 18:11:46,persegiHijau,389,420,118,110,65,79,69,79,4,0,True,0.1477241541032025
2025-01-08 18:11:46,persegiHijau,397,419,115,109,170,19,167,17,3,2,True,0.2391133548993997
2025-01-08 18:11:46,Fail to pick,397,419,0,0,0,0,0,0,0,0,False,0
2025-01-08 18:11:46,persegiHijau,360,404,115,114,19,49,19,53,0,4,True,0.10208257550437777
2025-01-08 18:11:46,persegiHijau,354,403,111,116,67,35,68,30,1,5,True,0.24916590132150387
2025-01-08 18:11:46,Fail to pick,354,403,0,0,0,0,0,0,0,0,False,0
2025-01-08 18:11:46,persegiHijau,389,427,119,110,120,43,118,42,2,1,True,0.437554544180609
2025-01-08 18:11:46,Hijau,389,427,tensor(119.8109),tensor(110.6633),81,36,78,33,3,3,True,0.0
2025-01-08 18:11:46,persegiHijau,360,407,115,115,130,48,133,44,3,4,True,0.3498720512760851
2025-01-08 18:11:46,persegiHijau,399,426,115,110,185,23,187,24,2,1,True,0.1842685125907449
2025-01-08 18:11:47,persegiHijau,402,425,117,110,69,88,68,92,1,4,True,0.3547827960182868
2025-01-08 18:11:47,Fail to pick,402,425,0,0,0,0,0,0,0,0,False,0
2025-01-08 18:11:47,persegiHijau,358,403,113,114,59,95,62,99,3,4,True,0.2170421248782919
2025-01-08 18:11:47,persegiHijau,394,421,115,108,46,45,41,41,5,4,True,0.20822842282743403
2025-01-08 18:11:47,persegiHijau,391,424,116,108,166,1,165,-1,1,2,True,0.4540794662314278
2025-01-08 18:11:47,Fail to pick,391,424,0,0,0,0,0,0,0,0,False,0
2025-01-08 18:11:47,persegiHijau,362,399,115,111,166,60,170,63,4,3,True,0.38815390122723914
2025-01-08 18:11:47,persegiHijau,386,420,116,110,5,51,4,47,1,4,True,0.18489600659074565
2025-01-08 18:11:52,persegiHijau,394,420,121,111,31,83,33,87,2,4,True,0.21319215251751458
2025-01-08 18:11:52,Hijau,394,420,tensor(121.6436),tensor(111.6451),83,36,78,34,5,2,True,0.0
2025-01-08 18:11:52,Fail to pick,394,420,0,0,0,0,0,0,0,0,False,0
2025-01-08 18:11:52,persegiHijau,406,422,121,109,144,79,145,74,1,5,True,0.11312954690308184
2025-01-08 18:11:52,persegiHijau,364,402,120,116,121,51,117,52,4,1,True,0.22576904626248373
2025-01-08 18:11:52,persegiHijau,352,407,114,116,57,78,53,76,4,2,True,0.41307228719744604
2025-01-08 18:11:52,persegiHijau,365,399,117,113,109,68,113,65,4,3,True,0.10055622245215178
2025-01-08 18:11:52,persegiHijau,363,400,118,111,120,96,116,96,4,0,False,0.4085861435970032
2025-01-08 18:11:52,Fail to pick,363,400,0,0,0,0,0,0,0,0,False,0
2025-01-08 18:11:52,persegiHijau,393,420,119,110,13,38,10,35,3,3,True,0.16835509588545444
2025-01-08 18:11:53,persegiHijau,363,411,116,113,44,12,42,12,2,0,True,0.22782564357784457
2025-01-08 18:11:53,persegiHijau,361,405,116,115,16,78,15,74,1,4,False,0.2252680635080814
2025-01-08 18:11:53,Fail to pick,361,405,0,0,0,0,0,0,0,0,False,0
2025-01-08 18:11:55,persegiHijau,265,603,118,113,62,93,61,92,1,1,True,0.30217612031507746
2025-01-08 18:11:55,Hijau,265,603,tensor(118.4207),tensor(113.8875),32,24,34,21,2,3,True,0.0
2025-01-08 18:11:56,persegiHijau,266,601,119,114,14,51,9,50,5,1,True,0.48420375588417197
2025-01-08 18:11:56,Fail to pick,266,601,0,0,0,0,0,0,0,0,False,0
2025-01-08 18:11:56,persegiHijau,256,600,119,113,179,18,176,19,3,1,True,0.34408094810254064
2025-01-08 18:11:56,persegiHijau,270,602,119,112,103,35,106,37,3,2,True,0.11712232479171272
2025-01-08 18:11:56,persegiHijau,262,599,118,115,71,35,66,34,5,1,True,0.1486339326880622
2025-01-08 18:11:56,Fail to pick,262,599,0,0,0,0,0,0,0,0,False,0
2025-01-08 18:11:56,persegiHijau,263,597,119,114,7,64,8,67,1,3,True,0.4954703045332335
2025-01-08 18:11:56,Fail to pick,263,597,0,0,0,0,0,0,0,0,False,0
2025-01-08 18:11:56,persegiHijau,266,599,121,112,165,92,161,95,4,3,True,0.22650719538955433
2025-01-08 18:11:56,Fail to pick,266,599,0,0,0,0,0,0,0,0,False,0
2025-01-08 18:11:56,persegiHijau,261,597,118,111,18,5,17,9,1,4,True,0.42562062454629535
2025-01-08 18:11:56,Fail to pick,261,597,0,0,0,0,0,0,0,0,False,0
2025-01-08 18:11:56,persegiHijau,232,593,114,112,146,97,143,99,3,2,True,0.16318957286327634
2025-01-08 18:11:56,persegiHijau,262,598,117,113,167,19,166,22,1,3,False,0.193019001036323
2025-01-08 18:11:56,persegiHijau,270,593,119,116,94,64,94,62,0,2,True,0.4184314898786876
2025-01-08 18:11:56,Hijau,270,593,tensor(119.3969),tensor(116.9517),35,25,35,26,0,1,True,0.0
2025-01-08 18:11:56,Fail to pick,270,593,0,0,0,0,0,0,0,0,False,0
2025-01-08 18:11:57,persegiHijau,259,594,115,115,64,18,65,20,1,2,True,0.18423187089798743
2025-01-08 18:11:57,persegiHijau,273,605,119,108,118,42,121,46,3,4,False,0.15431462019609313
2025-01-08 18:11:57,persegiHijau,283,604,121,107,129,93,131,97,2,4,True,0.24553605694395564
2025-01-08 18:11:57,persegiHijau,251,603,116,108,120,96,119,97,1,1,True,0.1364769129490455
2025-01-08 18:11:57,persegiHijau,257,600,119,109,78,84,75,81,3,3,True,0.21807678890693905
2025-01-08 18:11:57,Fail to pick,257,600,0,0,0,0,0,0,0,0,False,0
2025-01-08 18:11:57,persegiHijau,254,599,118,110,72,81,75,77,3,4,False,0.4802423101123874
2025-01-08 18:11:57,Fail to pick,254,599,0,0,0,0,0,0,0,0,False,0
2025-01-08 18:11:57,persegiHijau,270,609,119,107,187,69,183,64,4,5,True,0.17112380554385415
2025-01-08 18:11:57,persegiHijau,254,599,118,111,149,51,151,52,2,1,True,0.49859947707138697
2025-01-08 18:11:57,persegiHijau,254,603,116,110,112,1,109,2,3,1,True,0.298627839271432
2025-01-08 18:11:57,Fail to pick,254,603,0,0,0,0,0,0,0,0,False,0
2025-01-08 18:11:58,persegiHijau,260,598,119,109,111,53,111,53,0,0,True,0.3104140150187711
2025-01-08 18:11:58,Hijau,260,598,tensor(119.2081),tensor(109.1266),33,24,36,21,3,3,True,0.0
2025-01-08 18:11:58,Fail to pick,260,598,0,0,0,0,0,0,0,0,False,0
2025-01-08 18:11:58,persegiHijau,256,597,119,112,37,80,37,76,0,4,True,0.19950088659076762
2025-01-08 18:11:58,Fail to pick,256,597,0,0,0,0,0,0,0,0,False,0
2025-01-08 18:11:58,persegiHijau,252,602,116,109,30,93,30,92,0,1,True,0.11564833811113268
2025-01-08 18:11:58,Fail to pick,252,602,0,0,0,0,0,0,0,0,False,0
2025-01-08 18:12:02,persegiHijau,252,603,121,108,65,98,65,96,0,2,True,0.2844601863882279
2025-01-08 18:12:02,Hijau,252,603,tensor(121.7622),tensor(108.6211),32,23,32,20,0,3,True,0.0
2025-01-08 18:12:02,Fail to pick,252,603,0,0,0,0,0,0,0,0,False,0
2025-01-08 18:12:02,persegiHijau,270,610,124,105,62,57,65,55,3,2,True,0.11672178764467223
2025-01-08 18:12:03,persegiHijau,254,600,124,108,72,46,69,43,3,3,True,0.2170505794391005
2025-01-08 18:12:03,persegiHijau,256,601,125,107,79,48,78,51,1,3,False,0.1986750102940744
2025-01-08 18:12:03,Fail to pick,256,601,0,0,0,0,0,0,0,0,False,0
2025-01-08 18:12:03,persegiHijau,253,603,121,107,192,91,189,94,3,3,True,0.25094922693704647
2025-01-08 18:12:03,Fail to pick,253,603,0,0,0,0,0,0,0,0,False,0
2025-01-08 18:12:03,persegiHijau,279,606,122,107,61,66,64,67,3,1,False,0.11940451344403745
2025-01-08 18:12:03,persegiHijau,260,599,123,109,95,31,91,29,4,2,True,0.4143507606528162
2025-01-08 18:12:03,persegiHijau,264,601,120,109,63,83,63,87,0,4,True,0.3437599196876395
2025-01-08 18:12:03,Fail to pick,264,601,0,0,0,0,0,0,0,0,False,0
2025-01-08 18:12:03,persegiHijau,261,596,123,112,165,9,163,12,2,3,True,0.1966202545620684
2025-01-08 18:12:03,Fail to pick,261,596,0,0,0,0,0,0,0,0,False,0
2025-01-08 18:12:03,persegiHijau,269,599,125,110,9,34,12,35,3,1,True,0.3543776576022615
2025-01-08 18:12:03,Hijau,269,599,tensor(125.1892),tensor(110.7873),33,24,32,26,1,2,True,0.0
2025-01-08 18:12:03,Fail to pick,269,599,0,0,0,0,0,0,0,0,False,0
2025-01-08 18:12:04,persegiHijau,260,600,122,109,91,51,86,55,5,4,True,0.1020933490892364
2025-01-08 18:12:04,Fail to pick,260,600,0,0,0,0,0,0,0,0,False,0
2025-01-08 18:12:04,persegiHijau,263,604,122,110,23,88,21,86,2,2,True,0.24199278906218807
2025-01-08 18:12:04,Fail to pick,263,604,0,0,0,0,0,0,0,0,False,0
2025-01-08 18:12:04,persegiHijau,268,600,124,112,6,33,1,34,5,1,True,0.23042981874061727
2025-01-08 18:12:04,Fail to pick,268,600,0,0,0,0,0,0,0,0,False,0
2025-01-08 18:12:04,persegiHijau,262,601,122,111,59,96,62,99,3,3,True,0.37494480965810806
2025-01-08 18:12:04,Fail to pick,262,601,0,0,0,0,0,0,0,0,False,0
2025-01-08 18:12:04,persegiHijau,259,601,123,110,26,69,24,69,2,0,False,0.3833334511063997
2025-01-08 18:12:04,Fail to pick,259,601,0,0,0,0,0,0,0,0,False,0
2025-01-08 18:12:04,persegiHijau,261,600,121,109,102,80,100,80,2,0,True,0.23357553981999848
2025-01-08 18:12:04,Fail to pick,261,600,0,0,0,0,0,0,0,0,False,0
2025-01-08 18:12:04,persegiHijau,266,603,122,111,158,17,156,13,2,4,False,0.2779722755977223
2025-01-08 18:12:04,Fail to pick,266,603,0,0,0,0,0,0,0,0,False,0
2025-01-08 18:12:04,persegiHijau,268,602,123,111,87,54,91,55,4,1,True,0.4487700146053596
2025-01-08 18:12:04,Fail to pick,268,602,0,0,0,0,0,0,0,0,False,0
2025-01-08 18:12:04,persegiHijau,253,602,121,109,39,63,41,65,2,2,True,0.2886425727845322
2025-01-08 18:12:04,persegiHijau,274,607,123,107,189,28,189,28,0,0,True,0.1986328787977136
2025-01-08 18:12:05,Hijau,274,607,tensor(123.3832),tensor(107.9807),31,25,32,28,1,3,True,0.0004994869232177734
2025-01-08 18:12:05,persegiHijau,255,599,123,108,73,98,74,102,1,4,True,0.4330342203454708
2025-01-08 18:12:05,persegiHijau,257,599,123,110,124,66,122,70,2,4,True,0.3037346648124457
2025-01-08 18:12:05,Fail to pick,257,599,0,0,0,0,0,0,0,0,False,0
2025-01-08 18:12:05,persegiHijau,256,600,118,111,192,16,190,17,2,1,True,0.17036518156076824
2025-01-08 18:12:05,Fail to pick,256,600,0,0,0,0,0,0,0,0,False,0
2025-01-08 18:12:05,persegiHijau,259,599,120,110,116,65,113,66,3,1,True,0.40758129848711455
2025-01-08 18:12:05,Fail to pick,259,599,0,0,0,0,0,0,0,0,False,0
2025-01-08 18:12:05,persegiHijau,283,606,124,108,9,26,10,30,1,4,True,0.18953615238721755
2025-01-08 18:12:05,persegiHijau,262,602,121,107,180,44,175,45,5,1,True,0.3769812444102424
2025-01-08 18:12:05,persegiHijau,260,601,120,110,11,69,9,66,2,3,True,0.17310017736039435
2025-01-08 18:12:05,Fail to pick,260,601,0,0,0,0,0,0,0,0,False,0
2025-01-08 18:12:05,persegiHijau,260,598,124,112,3,5,4,0,1,5,True,0.16035891255122406
2025-01-08 18:12:05,Fail to pick,260,598,0,0,0,0,0,0,0,0,False,0
2025-01-08 18:12:05,persegiHijau,261,598,122,110,77,58,75,61,2,3,True,0.45411039034740963
2025-01-08 18:12:05,Fail to pick,261,598,0,0,0,0,0,0,0,0,False,0
2025-01-08 18:12:06,persegiHijau,256,600,120,108,182,51,186,48,4,3,True,0.40352855786562725
2025-01-08 18:12:06,Hijau,256,600,tensor(120.5087),tensor(108.0817),33,23,32,24,1,1,True,0.0
2025-01-08 18:12:06,Fail to pick,256,600,0,0,0,0,0,0,0,0,False,0
2025-01-08 18:12:06,persegiHijau,278,606,121,106,154,78,152,79,2,1,True,0.4607221199401482
2025-01-08 18:12:06,persegiHijau,267,598,123,111,177,39,180,38,3,1,True,0.3487466851527127
2025-01-08 18:12:06,persegiHijau,267,601,122,111,181,32,177,32,4,0,True,0.2546045371860811
2025-01-08 18:12:06,Fail to pick,267,601,0,0,0,0,0,0,0,0,False,0
2025-01-08 18:12:06,persegiHijau,273,607,124,106,147,89,145,85,2,4,True,0.3953962599982116
2025-01-08 18:12:06,Fail to pick,273,607,0,0,0,0,0,0,0,0,False,0
2025-01-08 18:12:06,persegiHijau,253,598,121,110,198,67,197,66,1,1,False,0.27859149599046545
2025-01-08 18:12:06,persegiHijau,257,599,123,112,123,96,124,95,1,1,True,0.3240955350756589
2025-01-08 18:12:06,Fail to pick,257,599,0,0,0,0,0,0,0,0,False,0
2025-01-08 18:12:06,persegiHijau,276,605,122,108,94,25,98,20,4,5,True,0.22989307438260842
2025-01-08 18:12:06,persegiHijau,258,600,120,115,97,91,95,94,2,3,True,0.15531495857266164
2025-01-08 18:12:07,persegiHijau,262,597,120,111,150,11,146,14,4,3,True,0.4899165126758446
2025-01-08 18:12:07,Fail to pick,262,597,0,0,0,0,0,0,0,0,False,0
2025-01-08 18:12:07,persegiHijau,256,599,121,109,94,8,90,12,4,4,False,0.38529036936994276
2025-01-08 18:12:07,Hijau,256,599,tensor(121.7621),tensor(109.9014),33,23,29,27,4,4,True,0.0
2025-01-08 18:12:07,Fail to pick,256,599,0,0,0,0,0,0,0,0,False,0
2025-01-08 18:12:07,persegiHijau,262,596,120,111,197,25,196,21,1,4,True,0.41341450341244856
2025-01-08 18:12:07,Fail to pick,262,596,0,0,0,0,0,0,0,0,False,0
2025-01-08 18:12:07,persegiHijau,259,599,121,109,2,91,-2,95,4,4,True,0.44615884211723555
2025-01-08 18:12:07,Fail to pick,259,599,0,0,0,0,0,0,0,0,False,0
2025-01-08 18:12:07,persegiHijau,257,598,120,111,150,67,149,63,1,4,True,0.4277488570196112
2025-01-08 18:12:07,Fail to pick,257,598,0,0,0,0,0,0,0,0,False,0
2025-01-08 18:12:07,persegiHijau,255,599,120,109,98,58,96,53,2,5,True,0.16290932575523087
2025-01-08 18:12:07,Fail to pick,255,599,0,0,0,0,0,0,0,0,False,0
2025-01-08 18:12:07,persegiHijau,273,605,123,109,76,74,79,78,3,4,False,0.35187503893343697
2025-01-08 18:12:07,persegiHijau,254,600,122,109,165,89,166,86,1,3,True,0.4097758232967197
2025-01-08 18:12:07,persegiHijau,282,605,124,108,58,27,57,27,1,0,True,0.2464709261508168
2025-01-08 18:12:08,persegiHijau,266,601,121,111,158,16,162,12,4,4,True,0.3247126537648054
2025-01-08 18:12:08,persegiHijau,260,602,122,109,3,63,-2,58,5,5,True,0.42131825735374584
2025-01-08 18:12:08,Fail to pick,260,602,0,0,0,0,0,0,0,0,False,0
2025-01-08 18:12:08,persegiHijau,265,601,122,111,17,34,16,35,1,1,True,0.4573585011462663
2025-01-08 18:12:08,Hijau,265,601,tensor(122.3892),tensor(111.4283),33,24,33,22,0,2,True,0.000499725341796875
2025-01-08 18:12:08,Fail to pick,265,601,0,0,0,0,0,0,0,0,False,0
2025-01-08 18:12:08,persegiHijau,285,607,127,107,112,66,114,66,2,0,True,0.4842555988305578
2025-01-08 18:12:08,persegiHijau,262,602,122,110,198,2,198,3,0,1,True,0.168571954252699
2025-01-08 18:12:08,persegiHijau,284,609,126,105,74,67,75,64,1,3,True,0.2263232682796812
2025-01-08 18:12:08,persegiHijau,280,608,126,107,38,91,33,91,5,0,True,0.22798784068399203
2025-01-08 18:12:08,Fail to pick,280,608,0,0,0,0,0,0,0,0,False,0
2025-01-08 18:12:08,persegiHijau,229,596,119,113,22,98,21,93,1,5,True,0.25797485418352856
2025-01-08 18:12:08,persegiHijau,257,602,123,109,37,88,38,85,1,3,True,0.16857189479201934
2025-01-08 18:12:13,persegiHijau,232,644,117,100,69,81,69,80,0,1,True,0.19497555890837376
2025-01-08 18:12:13,Hijau,232,644,tensor(117.1978),tensor(100.8066),21,21,16,16,5,5,True,0.0
2025-01-08 18:12:13,persegiHijau,235,644,118,99,88,82,92,85,4,3,True,0.1523726669304818
2025-01-08 18:12:13,Fail to pick,235,644,0,0,0,0,0,0,0,0,False,0
2025-01-08 18:12:14,persegiHijau,227,651,120,98,194,88,189,91,5,3,True,0.22470411260031875
2025-01-08 18:12:14,Fail to pick,227,651,0,0,0,0,0,0,0,0,False,0
2025-01-08 18:12:14,persegiHijau,279,613,125,104,108,9,103,5,5,4,True,0.43783655807975663
2025-01-08 18:12:14,persegiHijau,288,609,128,106,3,67,1,68,2,1,True,0.2255557410167091
2025-01-08 18:12:14,Fail to pick,288,609,0,0,0,0,0,0,0,0,False,0
2025-01-08 18:12:14,persegiHijau,286,608,131,108,195,99,192,95,3,4,True,0.18521177412298107
2025-01-08 18:12:14,Fail to pick,286,608,0,0,0,0,0,0,0,0,False,0
2025-01-08 18:12:14,persegiHijau,274,611,128,106,58,13,53,14,5,1,True,0.3640905476229861
2025-01-08 18:12:14,Hijau,274,611,tensor(128.3232),tensor(106.8693),30,25,33,22,3,3,True,0.0
2025-01-08 18:12:14,persegiHijau,277,606,131,108,78,70,76,72,2,2,True,0.12909624845990508
2025-01-08 18:12:14,Fail to pick,277,606,0,0,0,0,0,0,0,0,False,0
2025-01-08 18:12:14,persegiHijau,276,610,130,109,161,72,164,67,3,5,True,0.18494767756633476
2025-01-08 18:12:14,Fail to pick,276,610,0,0,0,0,0,0,0,0,False,0
2025-01-08 18:12:15,persegiHijau,276,610,129,109,111,92,114,89,3,3,True,0.41087202166760783
2025-01-08 18:12:15,Fail to pick,276,610,0,0,0,0,0,0,0,0,False,0
2025-01-08 18:12:15,persegiHijau,270,604,130,110,102,7,102,6,0,1,True,0.4289671529135729
2025-01-08 18:12:15,Fail to pick,270,604,0,0,0,0,0,0,0,0,False,0
2025-01-08 18:12:15,persegiHijau,258,605,126,109,43,81,47,81,4,0,True,0.3396111076720072
2025-01-08 18:12:15,persegiHijau,269,600,126,112,150,48,147,47,3,1,True,0.17891049808388995
2025-01-08 18:12:15,persegiHijau,283,609,128,107,10,89,5,91,5,2,True,0.3963502731310625
2025-01-08 18:12:15,persegiHijau,275,607,130,108,196,28,192,28,4,0,True,0.14797303846015808
2025-01-08 18:12:15,Fail to pick,275,607,0,0,0,0,0,0,0,0,False,0
2025-01-08 18:12:15,persegiHijau,279,608,127,106,63,30,66,33,3,3,True,0.27698866154152413
2025-01-08 18:12:15,Fail to pick,279,608,0,0,0,0,0,0,0,0,False,0
2025-01-08 18:12:15,persegiHijau,274,608,125,108,192,84,192,88,0,4,True,0.4708746746862281
2025-01-08 18:12:15,Hijau,274,608,tensor(125.9834),tensor(108.5065),31,25,28,24,3,1,True,0.0004990100860595703
2025-01-08 18:12:15,Fail to pick,274,608,0,0,0,0,0,0,0,0,False,0
2025-01-08 18:12:15,persegiHijau,264,601,126,111,76,73,73,68,3,5,True,0.18068438721770264
2025-01-08 18:12:16,persegiHijau,267,600,126,110,121,82,125,82,4,0,True,0.35547804658550564
2025-01-08 18:12:16,Fail to pick,267,600,0,0,0,0,0,0,0,0,False,0
2025-01-08 18:12:16,persegiHijau,271,604,126,109,82,5,77,9,5,4,True,0.19023581279278076
2025-01-08 18:12:16,Fail to pick,271,604,0,0,0,0,0,0,0,0,False,0
2025-01-08 18:12:16,persegiHijau,271,595,126,113,199,61,194,59,5,2,True,0.36105777440903886
2025-01-08 18:12:16,Fail to pick,271,595,0,0,0,0,0,0,0,0,False,0
2025-01-08 18:12:16,persegiHijau,277,602,127,109,74,17,75,20,1,3,True,0.4520645561927219
2025-01-08 18:12:16,Fail to pick,277,602,0,0,0,0,0,0,0,0,False,0
2025-01-08 18:12:16,persegiHijau,268,603,125,112,173,32,170,36,3,4,True,0.2138485367273495
2025-01-08 18:12:16,Fail to pick,268,603,0,0,0,0,0,0,0,0,False,0
2025-01-08 18:12:16,persegiHijau,253,603,121,109,163,0,165,0,2,0,True,0.3679106874873882
2025-01-08 18:12:16,persegiHijau,262,605,123,110,99,72,102,68,3,4,True,0.3448838100412913
2025-01-08 18:12:16,Fail to pick,262,605,0,0,0,0,0,0,0,0,False,0
2025-01-08 18:12:16,persegiHijau,273,595,126,112,164,34,168,30,4,4,True,0.3449365000267174
2025-01-08 18:12:16,persegiHijau,262,603,123,110,142,38,143,37,1,1,True,0.1630322648103636
2025-01-08 18:12:16,Hijau,262,603,tensor(123.9971),tensor(110.6464),32,24,35,24,3,0,True,0.0
2025-01-08 18:12:17,persegiHijau,259,602,122,110,198,24,199,19,1,5,True,0.36093891261573763
2025-01-08 18:12:17,Fail to pick,259,602,0,0,0,0,0,0,0,0,False,0
2025-01-08 18:12:17,persegiHijau,259,601,123,110,3,98,-1,97,4,1,True,0.4218122246562419
2025-01-08 18:12:17,Fail to pick,259,601,0,0,0,0,0,0,0,0,False,0
2025-01-08 18:12:17,persegiHijau,259,604,122,110,142,75,142,72,0,3,False,0.14840185599673214
2025-01-08 18:12:17,Fail to pick,259,604,0,0,0,0,0,0,0,0,False,0
2025-01-08 18:12:17,persegiHijau,260,604,122,109,99,77,96,80,3,3,True,0.15984656796683605
2025-01-08 18:12:17,Fail to pick,260,604,0,0,0,0,0,0,0,0,False,0
2025-01-08 18:12:17,persegiHijau,272,620,121,108,137,42,132,45,5,3,True,0.13071403589419317
2025-01-08 18:12:26,persegiHijau,788,242,122,128,168,29,167,29,1,0,True,0.44303370722676005
2025-01-08 18:12:26,Hijau,788,242,tensor(122.1633),tensor(128.9435),132,72,134,72,2,0,True,0.0
2025-01-08 18:12:26,persegiHijau,786,238,120,126,136,38,136,37,0,1,True,0.38062496816710933
2025-01-08 18:12:26,Fail to pick,786,238,0,0,0,0,0,0,0,0,False,0
2025-01-08 18:12:26,persegiHijau,755,235,113,125,126,59,130,57,4,2,True,0.15359614700709995
2025-01-08 18:12:26,persegiHijau,768,223,120,127,131,11,132,6,1,5,True,0.48701403242424546
2025-01-08 18:12:26,persegiHijau,772,228,118,125,169,58,168,62,1,4,True,0.43166061687295576
2025-01-08 18:12:26,Fail to pick,772,228,0,0,0,0,0,0,0,0,False,0
2025-01-08 18:12:27,persegiHijau,780,241,116,126,187,10,186,9,1,1,True,0.1447443259832605
2025-01-08 18:12:27,persegiHijau,796,249,117,125,61,64,63,67,2,3,True,0.1491855080765049
2025-01-08 18:12:27,Hijau,796,249,tensor(117.4498),tensor(125.0943),130,73,126,72,4,1,True,0.0004990100860595703
2025-01-08 18:12:27,persegiHijau,795,242,122,127,102,84,100,84,2,0,True,0.44801073742253095
2025-01-08 18:12:27,Fail to pick,795,242,0,0,0,0,0,0,0,0,False,0
2025-01-08 18:12:27,persegiHijau,795,246,120,123,79,12,79,15,0,3,True,0.14875471100089835
2025-01-08 18:12:27,Fail to pick,795,246,0,0,0,0,0,0,0,0,False,0
2025-01-08 18:12:27,persegiHijau,791,244,121,125,76,69,72,68,4,1,True,0.1913695569491313
2025-01-08 18:12:27,Fail to pick,791,244,0,0,0,0,0,0,0,0,False,0
2025-01-08 18:12:27,persegiHijau,796,245,118,122,157,7,160,6,3,1,False,0.23685762972644328
2025-01-08 18:12:27,Fail to pick,796,245,0,0,0,0,0,0,0,0,False,0
2025-01-08 18:12:27,persegiHijau,794,245,122,122,39,51,41,48,2,3,False,0.2673356922805839
2025-01-08 18:12:27,Fail to pick,794,245,0,0,0,0,0,0,0,0,False,0
2025-01-08 18:12:27,persegiHijau,795,245,123,123,114,77,118,72,4,5,True,0.16779113509258395
2025-01-08 18:12:27,Fail to pick,795,245,0,0,0,0,0,0,0,0,False,0
2025-01-08 18:12:28,persegiHijau,779,232,119,123,194,75,191,78,3,3,True,0.42414978941222226
2025-01-08 18:12:28,persegiHijau,789,243,121,121,19,64,19,63,0,1,True,0.42104530624562675
2025-01-08 18:12:28,persegiHijau,792,240,121,122,96,67,96,68,0,1,True,0.39072240840775974
2025-01-08 18:12:28,Fail to pick,792,240,0,0,0,0,0,0,0,0,False,0
2025-01-08 18:12:28,persegiHijau,835,224,114,124,12,48,7,44,5,4,True,0.37562320966020646
2025-01-08 18:12:28,Hijau,835,224,tensor(114.0546),tensor(124.8881),137,77,134,73,3,4,True,0.0
2025-01-08 18:12:28,persegiHijau,831,227,114,123,179,40,177,37,2,3,True,0.11274949384352811
2025-01-08 18:12:28,Fail to pick,831,227,0,0,0,0,0,0,0,0,False,0
2025-01-08 18:12:28,persegiHijau,792,243,121,121,45,46,48,45,3,1,True,0.313827032108143
2025-01-08 18:12:28,persegiHijau,793,245,119,121,167,32,168,31,1,1,True,0.4640159120809747
2025-01-08 18:12:28,Fail to pick,793,245,0,0,0,0,0,0,0,0,False,0
2025-01-08 18:12:28,persegiHijau,793,241,124,121,117,3,113,0,4,3,True,0.361412578058383
2025-01-08 18:12:28,Fail to pick,793,241,0,0,0,0,0,0,0,0,False,0
2025-01-08 18:12:28,persegiHijau,794,246,120,122,149,73,152,71,3,2,True,0.24904970634327364
2025-01-08 18:12:28,Fail to pick,794,246,0,0,0,0,0,0,0,0,False,0
2025-01-08 18:12:28,persegiHijau,834,218,113,125,147,68,150,69,3,1,True,0.19825480757043235
2025-01-08 18:12:36,persegiHijau,738,446,120,119,26,42,24,46,2,4,True,0.13033148069297168
2025-01-08 18:12:36,Hijau,738,446,tensor(120.5942),tensor(119.6801),76,68,76,66,0,2,True,0.0004987716674804688
2025-01-08 18:12:36,persegiHijau,741,452,118,115,180,13,179,14,1,1,True,0.12683859853895743
2025-01-08 18:12:36,Fail to pick,741,452,0,0,0,0,0,0,0,0,False,0
2025-01-08 18:12:36,persegiHijau,772,452,116,116,196,53,200,48,4,5,False,0.22479900294865024
2025-01-08 18:12:36,persegiHijau,754,447,123,113,141,58,136,59,5,1,True,0.15972214248689026
2025-01-08 18:12:36,persegiHijau,720,433,117,119,182,17,180,16,2,1,True,0.1292808222757399
2025-01-08 18:12:37,persegiHijau,720,430,121,119,66,12,70,13,4,1,True,0.36496491653178265
2025-01-08 18:12:37,Fail to pick,720,430,0,0,0,0,0,0,0,0,False,0
2025-01-08 18:12:37,persegiHijau,721,435,115,118,106,0,106,-5,0,5,True,0.19799057679756876
2025-01-08 18:12:37,Fail to pick,721,435,0,0,0,0,0,0,0,0,False,0
2025-01-08 18:12:37,persegiHijau,724,431,118,116,190,37,186,35,4,2,True,0.10684531169215715
2025-01-08 18:12:37,Hijau,724,431,tensor(118.6422),tensor(116.4048),80,67,75,71,5,4,True,0.0004987716674804688
2025-01-08 18:12:37,Fail to pick,724,431,0,0,0,0,0,0,0,0,False,0
2025-01-08 18:12:37,persegiHijau,740,450,120,113,26,19,25,21,1,2,False,0.450563228459131
2025-01-08 18:12:37,persegiHijau,722,435,119,116,186,88,181,92,5,4,True,0.4797326636415238
2025-01-08 18:12:37,persegiHijau,747,451,118,111,77,81,77,81,0,0,False,0.2893539726907576
2025-01-08 18:12:37,persegiHijau,727,435,123,117,124,26,121,21,3,5,True,0.1640422063200616
2025-01-08 18:12:37,persegiHijau,744,447,120,113,181,42,178,42,3,0,True,0.10681782575786652
2025-01-08 18:12:37,persegiHijau,718,436,119,117,117,10,117,9,0,1,True,0.30361575760132664
2025-01-08 18:12:38,persegiHijau,724,439,117,114,153,32,155,28,2,4,True,0.4332597225620759
2025-01-08 18:12:38,Fail to pick,724,439,0,0,0,0,0,0,0,0,False,0
2025-01-08 18:12:38,persegiHijau,727,441,122,114,39,17,35,18,4,1,True,0.280694129650759
2025-01-08 18:12:38,Fail to pick,727,441,0,0,0,0,0,0,0,0,False,0
2025-01-08 18:12:38,persegiHijau,745,444,121,111,173,1,173,1,0,0,True,0.11985185542702288
2025-01-08 18:12:38,persegiHijau,730,436,121,115,121,73,122,72,1,1,True,0.22286214514584057
2025-01-08 18:12:38,Hijau,730,436,tensor(121.9840),tensor(115.8295),78,67,78,65,0,2,True,0.0005002021789550781
2025-01-08 18:12:38,persegiHijau,710,431,121,116,132,86,135,83,3,3,True,0.11251857339288836
2025-01-08 18:12:38,persegiHijau,711,432,119,113,99,90,102,85,3,5,True,0.3232857625108857
2025-01-08 18:12:38,Fail to pick,711,432,0,0,0,0,0,0,0,0,False,0
2025-01-08 18:12:38,persegiHijau,726,443,120,112,142,56,137,54,5,2,True,0.38544258839680223
2025-01-08 18:12:38,persegiHijau,723,438,115,114,66,84,65,87,1,3,True,0.48539650622812114
2025-01-08 18:12:38,Fail to pick,723,438,0,0,0,0,0,0,0,0,False,0
2025-01-08 18:12:38,persegiHijau,718,444,113,114,34,75,30,71,4,4,True,0.2122648064794897
2025-01-08 18:12:38,Fail to pick,718,444,0,0,0,0,0,0,0,0,False,0
2025-01-08 18:12:38,persegiHijau,739,450,116,113,47,38,47,40,0,2,True,0.13179798859371747
2025-01-08 18:12:39,persegiHijau,722,443,117,114,133,29,135,26,2,3,True,0.38927428440331946
2025-01-08 18:12:39,persegiHijau,732,439,120,115,44,3,44,3,0,0,True,0.4505041611571631
2025-01-08 18:12:39,persegiHijau,726,441,117,114,127,75,129,76,2,1,True,0.4541023397130828
2025-01-08 18:12:39,Fail to pick,726,441,0,0,0,0,0,0,0,0,False,0
2025-01-08 18:12:39,persegiHijau,743,456,120,114,93,28,88,27,5,1,True,0.3033244234887138
2025-01-08 18:12:39,Hijau,743,456,tensor(120.7112),tensor(114.8456),73,68,74,72,1,4,True,0.0
2025-01-08 18:12:39,persegiHijau,733,450,120,116,119,82,117,84,2,2,True,0.24389328855864104
2025-01-08 18:12:39,persegiHijau,731,457,120,117,21,11,16,11,5,0,True,0.3450085335069728
2025-01-08 18:12:39,Fail to pick,731,457,0,0,0,0,0,0,0,0,False,0
2025-01-08 18:12:39,persegiHijau,713,449,115,115,125,58,123,55,2,3,True,0.12760052193677507
2025-01-08 18:12:39,persegiHijau,725,444,119,117,132,44,136,47,4,3,False,0.12377425670518845
2025-01-08 18:12:39,persegiHijau,746,449,119,114,79,27,78,28,1,1,True,0.25058976934390587
2025-01-08 18:12:40,persegiHijau,742,438,122,116,84,54,83,55,1,1,True,0.48714306712497624
2025-01-08 18:12:40,persegiHijau,733,445,122,121,76,6,78,9,2,3,False,0.34436178229623016
2025-01-08 18:12:40,Fail to pick,733,445,0,0,0,0,0,0,0,0,False,0
2025-01-08 18:12:40,persegiHijau,724,449,119,120,172,80,174,83,2,3,True,0.30216647417962916
2025-01-08 18:12:40,Fail to pick,724,449,0,0,0,0,0,0,0,0,False,0
2025-01-08 18:12:40,persegiHijau,727,450,118,115,87,91,82,92,5,1,True,0.1994149234283464
2025-01-08 18:12:40,Hijau,727,450,tensor(118.4793),tensor(115.4341),75,67,73,71,2,4,True,0.0
2025-01-08 18:12:40,Fail to pick,727,450,0,0,0,0,0,0,0,0,False,0
2025-01-08 18:12:40,persegiHijau,737,448,122,121,175,90,172,87,3,3,True,0.19833534380003434
2025-01-08 18:12:40,persegiHijau,790,431,130,121,70,60,65,56,5,4,True,0.43721930000874376
2025-01-08 18:12:41,persegiHijau,752,442,121,119,115,87,117,88,2,1,True,0.10034517348640076
2025-01-08 18:12:41,persegiHijau,749,448,124,120,45,39,49,41,4,2,True,0.20333225549856096
2025-01-08 18:12:41,Fail to pick,749,448,0,0,0,0,0,0,0,0,False,0
2025-01-08 18:12:41,persegiHijau,756,457,120,119,99,72,102,75,3,3,True,0.2442537801748424
2025-01-08 18:12:41,Fail to pick,756,457,0,0,0,0,0,0,0,0,False,0
2025-01-08 18:12:41,persegiHijau,735,454,114,115,112,78,108,78,4,0,True,0.38871575736770814
2025-01-08 18:12:41,persegiHijau,730,454,114,118,114,39,110,40,4,1,True,0.1984221077249552
2025-01-08 18:12:41,Hijau,730,454,tensor(114.9434),tensor(118.6042),73,67,72,66,1,1,True,0.0
2025-01-08 18:12:41,Fail to pick,730,454,0,0,0,0,0,0,0,0,False,0
2025-01-08 18:12:41,persegiHijau,715,443,116,114,61,2,63,-2,2,4,True,0.27883951013673947
2025-01-08 18:12:41,persegiHijau,751,457,117,113,27,93,24,90,3,3,True,0.11273535716241666
2025-01-08 18:12:41,persegiHijau,745,460,119,111,112,85,107,83,5,2,True,0.1078297594854249
2025-01-08 18:12:41,Fail to pick,745,460,0,0,0,0,0,0,0,0,False,0
2025-01-08 18:12:54,persegiKuning,622,76,112,119,115,87,112,82,3,5,True,0.23493225110568133
2025-01-08 18:12:54,Kuning,622,76,tensor(112.0204),tensor(119.3328),178,57,179,54,1,3,True,0.0
2025-01-08 18:12:54,persegiMerah,633,81,112,119,103,18,106,21,3,3,True,0.18052382506410802
2025-01-08 18:12:55,persegiMerah,652,104,114,118,189,23,191,19,2,4,True,0.2951240592620942
2025-01-08 18:12:55,Merah,652,104,tensor(114.4385),tensor(118.2228),171,60,168,56,3,4,True,0.0
2025-01-08 18:12:56,persegiMerah,687,159,108,115,191,3,192,6,1,3,False,0.34133549243382555
2025-01-08 18:12:56,Merah,687,159,tensor(108.0623),tensor(115.7332),155,63,156,65,1,2,True,0.0
2025-01-08 18:12:58,persegiMerah,659,99,118,121,47,75,46,72,1,3,True,0.25045554061451636
2025-01-08 18:12:58,Merah,659,99,tensor(118.8314),tensor(121.2053),172,61,172,59,0,2,True,0.000499725341796875
2025-01-08 18:13:00,persegiMerah,664,101,116,122,159,23,159,23,0,0,True,0.24810019217888982
2025-01-08 18:13:00,Merah,664,101,tensor(116.4359),tensor(122.8163),171,61,170,63,1,2,True,0.0004990100860595703
2025-01-08 18:13:00,Fail to pick,664,101,0,0,0,0,0,0,0,0,False,0
2025-01-08 18:13:00,persegiMerah,657,103,116,118,63,40,59,35,4,5,True,0.14631273985742754
2025-01-08 18:13:00,Fail to pick,657,103,0,0,0,0,0,0,0,0,False,0
2025-01-08 18:13:00,persegiMerah,662,104,112,117,92,81,92,78,0,3,True,0.405312085412305
2025-01-08 18:13:00,Fail to pick,662,104,0,0,0,0,0,0,0,0,False,0
2025-01-08 18:13:00,persegiBiru,673,109,117,117,171,72,172,73,1,1,True,0.3876311974457166
2025-01-08 18:13:00,persegiBiru,668,108,121,120,151,99,152,98,1,1,True,0.3820715136697135
2025-01-08 18:13:00,Fail to pick,668,108,0,0,0,0,0,0,0,0,False,0
2025-01-08 18:13:02,persegiBiru,659,104,118,117,2,63,-2,61,4,2,True,0.3254244367811428
2025-01-08 18:13:02,Fail to pick,659,104,0,0,0,0,0,0,0,0,False,0
2025-01-08 18:13:02,persegiBiru,661,101,119,117,111,11,111,11,0,0,True,0.4941027006492681
2025-01-08 18:13:02,Biru,661,101,tensor(119.0087),tensor(117.9233),171,61,175,60,4,1,True,0.0
2025-01-08 18:13:02,Fail to pick,661,101,0,0,0,0,0,0,0,0,False,0
2025-01-08 18:13:02,persegiBiru,658,103,119,117,174,80,178,81,4,1,True,0.31257786104210294
2025-01-08 18:13:02,Fail to pick,658,103,0,0,0,0,0,0,0,0,False,0
2025-01-08 18:13:02,persegiBiru,660,104,117,117,126,38,122,38,4,0,True,0.2484518382845379
2025-01-08 18:13:02,Fail to pick,660,104,0,0,0,0,0,0,0,0,False,0
2025-01-08 18:13:03,persegiBiru,659,107,114,114,88,98,85,93,3,5,True,0.30987276884057674
2025-01-08 18:13:03,Fail to pick,659,107,0,0,0,0,0,0,0,0,False,0
2025-01-08 18:13:03,persegiBiru,660,106,116,115,93,31,88,35,5,4,True,0.2563942841418339
2025-01-08 18:13:03,Fail to pick,660,106,0,0,0,0,0,0,0,0,False,0
2025-01-08 18:13:03,persegiBiru,649,97,119,117,110,26,109,23,1,3,True,0.38783956519541174
2025-01-08 18:13:03,persegiKuning,640,85,112,115,123,52,125,50,2,2,True,0.32323500615625705
2025-01-08 18:13:03,Kuning,640,85,tensor(112.6287),tensor(115.2773),176,59,179,55,3,4,True,0.0004990100860595703
2025-01-08 18:13:10,persegiKuning,759,96,111,128,158,34,158,31,0,3,True,0.24557645836373487
2025-01-08 18:13:10,Kuning,759,96,tensor(111.6359),tensor(128.5859),173,70,171,70,2,0,True,0.0
2025-01-08 18:13:10,persegiKuning,698,76,111,120,150,17,149,12,1,5,True,0.4282057274901889
2025-01-08 18:13:10,persegiKuning,697,79,105,124,155,10,151,11,4,1,True,0.4191406133233041
2025-01-08 18:13:10,Fail to pick,697,79,0,0,0,0,0,0,0,0,False,0
2025-01-08 18:13:11,persegiKuning,720,81,107,120,71,23,73,19,2,4,True,0.17562975307562068
2025-01-08 18:13:12,persegiKuning,703,86,110,121,192,10,188,11,4,1,True,0.3522033366544953
2025-01-08 18:13:12,Kuning,703,86,tensor(110.7144),tensor(121.4746),176,65,176,65,0,0,True,0.0005004405975341797
2025-01-08 18:13:14,persegiMerah,793,188,114,119,101,66,101,65,0,1,True,0.4423814496400976
2025-01-08 18:13:14,Merah,793,188,tensor(114.3203),tensor(119.8505),147,73,151,68,4,5,True,0.0005066394805908203
2025-01-08 18:13:16,persegiBiru,774,94,108,117,157,16,161,12,4,4,True,0.16235601792279117
2025-01-08 18:13:16,Biru,774,94,tensor(108.7749),tensor(117.4056),173,71,171,67,2,4,True,0.0004956722259521484
2025-01-08 18:13:18,persegiMerah,733,101,118,114,96,83,97,87,1,4,True,0.36614992482369246
2025-01-08 18:13:18,Merah,733,101,tensor(118.1337),tensor(114.8655),171,67,173,62,2,5,True,0.0
2025-01-08 18:13:18,persegiBiru,774,101,118,113,82,89,85,89,3,0,True,0.2227672226833086
2025-01-08 18:13:19,persegiBiru,767,101,114,113,159,81,163,79,4,2,True,0.212260330143438
2025-01-08 18:13:19,Fail to pick,767,101,0,0,0,0,0,0,0,0,False,0
2025-01-08 18:13:19,persegiBiru,753,96,113,111,130,48,126,44,4,4,True,0.45006128693375425
2025-01-08 18:13:19,Biru,753,96,tensor(113.4267),tensor(111.2620),173,69,173,73,0,4,True,0.0
2025-01-08 18:13:19,persegiBiru,763,101,123,112,1,65,3,60,2,5,True,0.10662792142433677
2025-01-08 18:13:19,persegiBiru,766,104,115,112,99,66,97,67,2,1,False,0.34505565046406017
2025-01-08 18:13:19,Fail to pick,766,104,0,0,0,0,0,0,0,0,False,0
2025-01-08 18:13:19,persegiBiru,765,103,112,114,166,51,163,51,3,0,True,0.39680789714469866
2025-01-08 18:13:19,Fail to pick,765,103,0,0,0,0,0,0,0,0,False,0
2025-01-08 18:13:19,persegiBiru,765,95,116,110,195,26,193,30,2,4,True,0.11922432086164002
2025-01-08 18:13:19,Fail to pick,765,95,0,0,0,0,0,0,0,0,False,0
2025-01-08 18:13:19,persegiBiru,766,106,113,113,78,6,82,1,4,5,True,0.19059408520546253
2025-01-08 18:13:20,persegiBiru,755,93,117,112,22,79,25,81,3,2,False,0.3447371091583066
2025-01-08 18:13:24,persegiMerah,749,98,133,133,148,62,146,62,2,0,True,0.4801333119015201
2025-01-08 18:13:24,Merah,749,98,tensor(133.6044),tensor(133.0791),172,69,173,65,1,4,True,0.0
2025-01-08 18:13:24,Fail to pick,749,98,0,0,0,0,0,0,0,0,False,0
2025-01-08 18:13:24,persegiMerah,737,98,129,130,23,51,25,48,2,3,True,0.3052587021582728
2025-01-08 18:13:25,persegiMerah,734,82,127,134,176,40,176,38,0,2,True,0.4870328309531845
2025-01-08 18:13:25,persegiMerah,733,94,123,132,121,94,121,98,0,4,True,0.17350730142000897
2025-01-08 18:13:25,persegiMerah,751,92,132,138,71,65,74,66,3,1,True,0.25042795109340743
2025-01-08 18:13:26,persegiMerah,738,89,131,130,95,34,94,31,1,3,True,0.11065734013041349
2025-01-08 18:13:26,Merah,738,89,tensor(131.1729),tensor(130.7651),175,68,170,72,5,4,True,0.0
2025-01-08 18:13:26,persegiMerah,750,98,129,136,62,50,66,47,4,3,False,0.3796194656141033
2025-01-08 18:13:26,persegiMerah,751,97,126,135,6,85,5,80,1,5,True,0.2990691226437126
2025-01-08 18:13:26,Fail to pick,751,97,0,0,0,0,0,0,0,0,False,0
2025-01-08 18:13:27,persegiMerah,735,101,124,132,191,31,189,31,2,0,True,0.27255778512838835
2025-01-08 18:13:27,persegiMerah,735,89,128,131,136,2,132,1,4,1,True,0.4071566349441874
2025-01-08 18:13:27,persegiMerah,738,90,129,134,23,88,19,88,4,0,True,0.37416052664638655
2025-01-08 18:13:27,Fail to pick,738,90,0,0,0,0,0,0,0,0,False,0
2025-01-08 18:13:27,persegiMerah,746,98,133,136,64,94,59,89,5,5,True,0.11511539338996038
2025-01-08 18:13:27,Fail to pick,746,98,0,0,0,0,0,0,0,0,False,0
2025-01-08 18:13:27,persegiMerah,744,97,129,134,150,75,151,76,1,1,False,0.31273321825453126
2025-01-08 18:13:27,Merah,744,97,tensor(129.6190),tensor(134.4474),173,68,168,63,5,5,True,0.0004992485046386719
2025-01-08 18:13:27,Fail to pick,744,97,0,0,0,0,0,0,0,0,False,0
2025-01-08 18:13:27,persegiMerah,751,95,133,137,142,56,143,57,1,1,False,0.23455356425104165
2025-01-08 18:13:27,Fail to pick,751,95,0,0,0,0,0,0,0,0,False,0
2025-01-08 18:13:27,persegiMerah,743,95,133,139,110,28,107,27,3,1,False,0.449614690494603
2025-01-08 18:13:27,Fail to pick,743,95,0,0,0,0,0,0,0,0,False,0
2025-01-08 18:13:27,persegiMerah,757,100,131,135,196,95,200,95,4,0,True,0.1020465125263542
2025-01-08 18:13:28,persegiMerah,742,92,132,133,83,17,84,18,1,1,True,0.2941919629837476
2025-01-08 18:13:28,persegiMerah,742,92,132,133,4,13,6,9,2,4,True,0.28848734873843884
2025-01-08 18:13:28,Fail to pick,742,92,0,0,0,0,0,0,0,0,False,0
2025-01-08 18:13:28,persegiMerah,708,68,124,133,189,76,188,73,1,3,True,0.38021083950721457
2025-01-08 18:13:28,Merah,708,68,tensor(124.7380),tensor(133.0412),181,65,183,62,2,3,True,0.0005044937133789062
2025-01-08 18:13:28,persegiMerah,739,89,133,134,76,12,71,14,5,2,True,0.4176681697506376
2025-01-08 18:13:29,persegiMerah,733,85,127,135,60,88,64,83,4,5,True,0.3066266242784472
2025-01-08 18:13:29,Fail to pick,733,85,0,0,0,0,0,0,0,0,False,0
2025-01-08 18:13:29,persegiMerah,736,92,127,131,79,93,78,89,1,4,True,0.2046879769657068
2025-01-08 18:13:29,Fail to pick,736,92,0,0,0,0,0,0,0,0,False,0
2025-01-08 18:13:29,persegiMerah,742,93,131,132,76,0,72,-1,4,1,True,0.45952913998609646
2025-01-08 18:13:29,Fail to pick,742,93,0,0,0,0,0,0,0,0,False,0
2025-01-08 18:13:45,persegiHijau,734,544,126,120,77,1,78,4,1,3,True,0.4525557060645812
2025-01-08 18:13:45,Hijau,734,544,tensor(126.2854),tensor(120.8490),48,67,43,67,5,0,True,0.0
2025-01-08 18:13:45,persegiHijau,728,534,122,125,114,96,118,92,4,4,True,0.4144090920505802
2025-01-08 18:13:45,persegiHijau,733,531,124,124,145,23,149,21,4,2,True,0.26947504538275774
2025-01-08 18:13:45,Fail to pick,733,531,0,0,0,0,0,0,0,0,False,0
2025-01-08 18:13:45,persegiHijau,731,531,128,126,8,4,12,5,4,1,True,0.4755338757803822
2025-01-08 18:13:45,Fail to pick,731,531,0,0,0,0,0,0,0,0,False,0
2025-01-08 18:13:46,persegiHijau,727,526,120,128,128,59,124,54,4,5,False,0.10086001652757126
2025-01-08 18:13:46,Fail to pick,727,526,0,0,0,0,0,0,0,0,False,0
2025-01-08 18:13:46,persegiHijau,728,532,126,127,187,8,184,7,3,1,True,0.23324631872766807
2025-01-08 18:13:46,Fail to pick,728,532,0,0,0,0,0,0,0,0,False,0
2025-01-08 18:13:46,persegiHijau,725,539,123,124,26,79,29,74,3,5,True,0.33121778281372183
2025-01-08 18:13:46,Fail to pick,725,539,0,0,0,0,0,0,0,0,False,0
2025-01-08 18:13:46,persegiHijau,731,528,125,122,171,87,166,85,5,2,True,0.42965420959937195
2025-01-08 18:13:46,persegiHijau,726,527,122,124,159,56,161,58,2,2,True,0.48209414840770726
2025-01-08 18:13:46,Fail to pick,726,527,0,0,0,0,0,0,0,0,False,0
2025-01-08 18:13:46,persegiHijau,726,528,124,124,195,75,199,76,4,1,True,0.40491075116008124
2025-01-08 18:13:46,Hijau,726,528,tensor(124.1981),tensor(124.0987),53,67,55,67,2,0,True,0.0004966259002685547
2025-01-08 18:13:46,Fail to pick,726,528,0,0,0,0,0,0,0,0,False,0
2025-01-08 18:13:46,persegiHijau,717,523,128,121,148,90,149,89,1,1,True,0.22878772241450235
2025-01-08 18:13:46,Fail to pick,717,523,0,0,0,0,0,0,0,0,False,0
2025-01-08 18:13:46,persegiHijau,725,523,121,122,134,55,129,53,5,2,True,0.28634487787346885
2025-01-08 18:13:46,Fail to pick,725,523,0,0,0,0,0,0,0,0,False,0
2025-01-08 18:13:46,persegiHijau,712,524,128,120,196,96,200,99,4,3,True,0.14511400273958383
2025-01-08 18:13:47,persegiHijau,736,531,127,120,6,25,10,29,4,4,False,0.1713116219469285
2025-01-08 18:13:47,persegiHijau,721,524,123,120,147,88,149,86,2,2,True,0.3407425919919599
2025-01-08 18:13:47,persegiHijau,727,528,125,121,53,13,52,9,1,4,True,0.466586577248701
2025-01-08 18:13:47,Fail to pick,727,528,0,0,0,0,0,0,0,0,False,0
2025-01-08 18:13:47,persegiHijau,718,526,125,121,90,77,85,73,5,4,True,0.2980852885758418
2025-01-08 18:13:47,Fail to pick,718,526,0,0,0,0,0,0,0,0,False,0
2025-01-08 18:13:47,persegiHijau,710,528,127,123,172,74,173,70,1,4,True,0.18254535814682354
2025-01-08 18:13:47,Fail to pick,710,528,0,0,0,0,0,0,0,0,False,0
2025-01-08 18:13:47,persegiHijau,725,527,121,119,46,72,46,69,0,3,True,0.3291722253411702
2025-01-08 18:13:47,persegiHijau,726,526,122,119,187,43,186,39,1,4,False,0.1887227158640773
2025-01-08 18:13:47,Fail to pick,726,526,0,0,0,0,0,0,0,0,False,0
2025-01-08 18:13:47,persegiHijau,713,522,125,120,115,70,117,69,2,1,True,0.4351051245795122
2025-01-08 18:13:47,Hijau,713,522,tensor(125.3058),tensor(120.4560),55,66,52,62,3,4,True,0.0004990100860595703
2025-01-08 18:13:47,persegiHijau,723,524,123,119,50,99,53,103,3,4,True,0.17908594428659144
2025-01-08 18:13:48,persegiHijau,718,523,124,120,109,62,111,58,2,4,True,0.38198246288782844
2025-01-08 18:13:48,Fail to pick,718,523,0,0,0,0,0,0,0,0,False,0
2025-01-08 18:13:48,persegiHijau,718,534,126,124,51,78,46,81,5,3,True,0.19385746692612132
2025-01-08 18:13:48,persegiHijau,730,528,126,121,110,69,107,65,3,4,True,0.3395520394306538
2025-01-08 18:13:48,persegiHijau,725,535,124,120,82,81,80,81,2,0,False,0.21353572808526736
2025-01-08 18:13:48,Fail to pick,725,535,0,0,0,0,0,0,0,0,False,0
2025-01-08 18:13:48,persegiHijau,726,530,122,120,127,18,125,17,2,1,True,0.40134080268252303
2025-01-08 18:13:48,Fail to pick,726,530,0,0,0,0,0,0,0,0,False,0
2025-01-08 18:13:48,persegiHijau,733,542,123,117,6,45,4,46,2,1,True,0.3812035667116679
2025-01-08 18:13:48,Hijau,733,542,tensor(123.8952),tensor(117.9861),49,67,51,66,2,1,True,0.0
2025-01-08 18:13:49,persegiHijau,749,543,123,116,165,21,162,25,3,4,True,0.22197540069431132
2025-01-08 18:13:49,persegiHijau,738,540,127,116,52,34,52,37,0,3,True,0.1048705783802372
2025-01-08 18:13:49,persegiHijau,727,537,125,116,152,87,148,89,4,2,True,0.23692560535148216
2025-01-08 18:13:49,persegiHijau,743,540,127,116,161,18,160,21,1,3,True,0.4444886755589713
2025-01-08 18:13:57,persegiHijau,243,375,119,114,15,4,13,5,2,1,True,0.1956017209281531
2025-01-08 18:13:57,Hijau,243,375,tensor(119.4750),tensor(114.9683),95,22,95,19,0,3,True,0.0004987716674804688
2025-01-08 18:13:58,persegiHijau,227,354,119,114,5,95,6,91,1,4,True,0.10127296035749862
2025-01-08 18:13:58,persegiHijau,253,372,124,113,56,83,59,82,3,1,True,0.17686774300600075
2025-01-08 18:13:58,persegiHijau,216,364,115,115,172,11,168,10,4,1,False,0.13563400445354593
2025-01-08 18:13:58,persegiHijau,221,355,113,115,173,44,171,46,2,2,True,0.21464771274877395
2025-01-08 18:13:58,Fail to pick,221,355,0,0,0,0,0,0,0,0,False,0
2025-01-08 18:13:59,persegiHijau,224,352,116,113,31,0,34,0,3,0,True,0.2142614849901416
2025-01-08 18:13:59,Hijau,224,352,tensor(116.4337),tensor(113.8842),102,20,98,19,4,1,True,0.0
2025-01-08 18:13:59,Fail to pick,224,352,0,0,0,0,0,0,0,0,False,0
2025-01-08 18:13:59,persegiHijau,223,352,120,118,81,42,82,44,1,2,True,0.19477132360420937
2025-01-08 18:13:59,Fail to pick,223,352,0,0,0,0,0,0,0,0,False,0
2025-01-08 18:13:59,persegiHijau,242,369,122,115,180,76,175,76,5,0,True,0.3319472282637167
2025-01-08 18:13:59,persegiHijau,220,358,119,118,133,49,132,49,1,0,False,0.12655780649131373
2025-01-08 18:13:59,persegiHijau,220,358,118,119,89,69,88,65,1,4,True,0.19072282302759316
2025-01-08 18:13:59,Fail to pick,220,358,0,0,0,0,0,0,0,0,False,0
2025-01-08 18:13:59,persegiHijau,258,379,127,118,30,34,30,30,0,4,True,0.1815872780946144
2025-01-08 18:13:59,persegiHijau,246,376,123,114,94,98,90,93,4,5,True,0.3504888663093726
2025-01-08 18:13:59,persegiHijau,224,360,120,117,63,54,58,58,5,4,True,0.27626153540182696
2025-01-08 18:13:59,persegiHijau,222,353,117,113,103,52,102,50,1,2,True,0.31687952658035534
2025-01-08 18:13:59,Fail to pick,222,353,0,0,0,0,0,0,0,0,False,0
2025-01-08 18:13:59,persegiHijau,223,359,119,115,166,23,167,18,1,5,True,0.37807603375290677
2025-01-08 18:13:59,Fail to pick,223,359,0,0,0,0,0,0,0,0,False,0
2025-01-08 18:14:00,persegiHijau,217,360,118,113,58,29,61,24,3,5,True,0.33766386643294977
2025-01-08 18:14:00,Hijau,217,360,tensor(118.8669),tensor(113.4485),100,20,97,16,3,4,True,0.000499725341796875
2025-01-08 18:14:00,Fail to pick,217,360,0,0,0,0,0,0,0,0,False,0
2025-01-08 18:14:04,persegiHijau,263,336,133,125,141,47,138,47,3,0,True,0.49859149301499284
2025-01-08 18:14:04,Hijau,263,336,tensor(133.9958),tensor(125.6625),106,24,109,25,3,1,True,0.0005044937133789062
2025-01-08 18:14:04,persegiHijau,271,333,131,125,118,17,121,12,3,5,True,0.36018167999721373
2025-01-08 18:14:04,Fail to pick,271,333,0,0,0,0,0,0,0,0,False,0
2025-01-08 18:14:04,persegiHijau,266,335,129,121,139,30,136,25,3,5,True,0.36265546171354346
2025-01-08 18:14:04,Fail to pick,266,335,0,0,0,0,0,0,0,0,False,0
2025-01-08 18:14:04,persegiHijau,304,369,134,121,134,22,133,19,1,3,True,0.22989428697242065
2025-01-08 18:14:05,persegiHijau,298,361,131,123,188,69,189,71,1,2,True,0.25235489270325384
2025-01-08 18:14:05,Fail to pick,298,361,0,0,0,0,0,0,0,0,False,0
2025-01-08 18:14:08,persegiHijau,111,111,123,124,124,10,128,14,4,4,True,0.3535806754099282
2025-01-08 18:14:08,persegiHijau,114,113,122,120,75,25,73,29,2,4,True,0.3923279110389516
2025-01-08 18:14:08,Hijau,114,113,tensor(122.9655),tensor(120.8820),168,10,166,12,2,2,True,0.0004982948303222656
2025-01-08 18:14:08,Fail to pick,114,113,0,0,0,0,0,0,0,0,False,0
2025-01-08 18:14:08,persegiHijau,116,105,125,122,79,23,76,21,3,2,True,0.46064835712131347
2025-01-08 18:14:08,Fail to pick,116,105,0,0,0,0,0,0,0,0,False,0
2025-01-08 18:14:08,persegiHijau,88,92,111,118,101,73,97,77,4,4,True,0.28310758873364433
2025-01-08 18:14:09,persegiHijau,113,106,118,127,10,68,9,71,1,3,True,0.21530665964513337
2025-01-08 18:14:09,persegiHijau,118,112,124,117,163,4,166,5,3,1,True,0.3293221178385348
2025-01-08 18:14:09,Fail to pick,118,112,0,0,0,0,0,0,0,0,False,0
2025-01-08 18:14:09,persegiHijau,85,89,106,117,194,47,196,48,2,1,True,0.4911421301695946
2025-01-08 18:14:09,persegiHijau,80,87,109,117,150,94,146,92,4,2,True,0.2465856706911383
2025-01-08 18:14:09,Fail to pick,80,87,0,0,0,0,0,0,0,0,False,0
2025-01-08 18:14:09,persegiHijau,79,91,108,114,70,90,67,87,3,3,True,0.2110634035955851
2025-01-08 18:14:09,Fail to pick,79,91,0,0,0,0,0,0,0,0,False,0
2025-01-08 18:14:09,persegiHijau,111,115,122,116,196,6,200,6,4,0,True,0.275881501032168
2025-01-08 18:14:09,persegiHijau,85,89,102,118,151,72,152,75,1,3,True,0.13086467425717618
2025-01-08 18:14:09,Hijau,85,89,tensor(102.8793),tensor(118.3110),175,7,175,5,0,2,True,0.0004992485046386719
2025-01-08 18:14:09,persegiHijau,75,94,108,113,70,86,73,89,3,3,True,0.14189908462405657
2025-01-08 18:14:10,persegiHijau,84,91,106,116,71,75,68,73,3,2,False,0.38970023429009637
2025-01-08 18:14:10,Fail to pick,84,91,0,0,0,0,0,0,0,0,False,0
2025-01-08 18:14:10,persegiHijau,106,106,117,114,123,98,120,98,3,0,True,0.31429145515475765
2025-01-08 18:14:10,persegiHijau,81,89,108,115,189,72,190,70,1,2,True,0.3882783478179409
2025-01-08 18:14:10,persegiHijau,83,91,108,109,156,32,160,32,4,0,True,0.2617562381193877
2025-01-08 18:14:10,Fail to pick,83,91,0,0,0,0,0,0,0,0,False,0
2025-01-08 18:14:10,persegiHijau,116,114,123,112,86,23,83,19,3,4,False,0.20049669733485564
2025-01-08 18:14:10,persegiHijau,83,89,108,110,198,76,193,78,5,2,True,0.31924486922186934
2025-01-08 18:14:15,persegiHijau,88,95,112,119,73,61,72,57,1,4,True,0.15571925727646124
2025-01-08 18:14:15,Hijau,88,95,tensor(112.1093),tensor(119.5959),173,8,172,12,1,4,True,0.0005502700805664062
2025-01-08 18:14:15,Fail to pick,88,95,0,0,0,0,0,0,0,0,False,0
2025-01-08 18:14:15,persegiHijau,103,105,120,120,27,28,31,32,4,4,True,0.3824545965614069
2025-01-08 18:14:15,persegiHijau,93,93,120,118,161,70,156,66,5,4,True,0.21909427651084373
2025-01-08 18:14:15,persegiHijau,110,107,127,122,168,81,164,85,4,4,True,0.1831075540772965
2025-01-08 18:14:15,persegiHijau,104,104,119,121,86,64,82,64,4,0,False,0.2356369926536006
2025-01-08 18:14:15,Fail to pick,104,104,0,0,0,0,0,0,0,0,False,0
2025-01-08 18:14:15,persegiHijau,106,104,121,122,127,67,125,69,2,2,True,0.26813495194746256
2025-01-08 18:14:15,Fail to pick,106,104,0,0,0,0,0,0,0,0,False,0
2025-01-08 18:14:15,persegiHijau,96,94,113,114,17,84,12,80,5,4,True,0.1519098085938318
2025-01-08 18:14:16,persegiHijau,90,96,115,113,38,75,33,76,5,1,True,0.39624208096089386
2025-01-08 18:14:16,Fail to pick,90,96,0,0,0,0,0,0,0,0,False,0
2025-01-08 18:14:16,persegiHijau,104,104,122,123,198,33,194,32,4,1,True,0.45721592609672224
2025-01-08 18:14:16,persegiHijau,105,107,120,120,69,46,64,47,5,1,True,0.45087809005373136
2025-01-08 18:14:16,Hijau,105,107,tensor(120.1212),tensor(120.6594),170,9,166,12,4,3,True,0.0
2025-01-08 18:14:16,Fail to pick,105,107,0,0,0,0,0,0,0,0,False,0
2025-01-08 18:14:16,persegiHijau,92,94,118,118,8,31,9,28,1,3,True,0.3719206802521645
2025-01-08 18:14:16,persegiHijau,91,95,116,119,17,8,15,6,2,2,True,0.4479577076873825
2025-01-08 18:14:16,Fail to pick,91,95,0,0,0,0,0,0,0,0,False,0
2025-01-08 18:14:16,persegiHijau,104,102,119,123,127,16,129,11,2,5,True,0.22463653043013734
2025-01-08 18:14:16,persegiHijau,93,98,115,120,74,20,76,17,2,3,True,0.48920589312891904
2025-01-08 18:14:16,persegiHijau,117,110,127,123,42,46,43,43,1,3,True,0.3963147994303631
2025-01-08 18:14:16,segienamHijau,80,91,129,123,91,8,89,6,2,2,True,0.2610100785716526
2025-01-08 18:14:17,persegiHijau,102,110,123,122,25,3,21,0,4,3,True,0.4138255263414198
2025-01-08 18:14:17,persegiHijau,108,107,126,122,155,38,157,35,2,3,True,0.17912568330940226
2025-01-08 18:14:17,Fail to pick,108,107,0,0,0,0,0,0,0,0,False,0
2025-01-08 18:14:17,persegiHijau,82,98,115,123,194,75,195,73,1,2,True,0.36918449142232357
2025-01-08 18:14:17,Hijau,82,98,tensor(115.0741),tensor(123.5930),172,7,168,10,4,3,True,0.0004999637603759766
2025-01-08 18:14:17,persegiHijau,98,108,127,122,18,9,20,10,2,1,True,0.46467732749886836
2025-01-08 18:14:17,persegiHijau,91,97,119,118,36,51,32,50,4,1,True,0.43275790216890897
2025-01-08 18:14:17,persegiHijau,91,95,119,119,156,0,157,0,1,0,True,0.2613437290243603
2025-01-08 18:14:17,Fail to pick,91,95,0,0,0,0,0,0,0,0,False,0
2025-01-08 18:14:17,persegiHijau,104,104,123,122,168,2,163,4,5,2,True,0.22625746157357202
2025-01-08 18:14:17,persegiHijau,91,95,121,119,73,48,70,45,3,3,True,0.19108141140938129
2025-01-08 18:14:17,persegiHijau,92,98,120,119,90,77,85,77,5,0,True,0.2118669548229277
2025-01-08 18:14:17,Fail to pick,92,98,0,0,0,0,0,0,0,0,False,0
2025-01-08 18:14:18,persegiHijau,90,97,117,118,108,88,107,84,1,4,True,0.20339159475119195
2025-01-08 18:14:18,Fail to pick,90,97,0,0,0,0,0,0,0,0,False,0
2025-01-08 18:14:18,persegiHijau,96,98,120,118,73,48,76,45,3,3,True,0.3904486741058599
2025-01-08 18:14:18,Fail to pick,96,98,0,0,0,0,0,0,0,0,False,0
2025-01-08 18:14:18,persegiHijau,90,97,119,119,111,95,115,95,4,0,True,0.19641882564967475
2025-01-08 18:14:18,Fail to pick,90,97,0,0,0,0,0,0,0,0,False,0
2025-01-08 18:14:18,persegiHijau,92,96,121,119,73,88,69,86,4,2,True,0.3725262400754209
2025-01-08 18:14:18,Hijau,92,96,tensor(121.2909),tensor(119.9132),173,8,174,5,1,3,True,0.0004985332489013672
2025-01-08 18:14:18,Fail to pick,92,96,0,0,0,0,0,0,0,0,False,0
2025-01-08 18:14:18,persegiHijau,88,100,121,119,108,5,110,6,2,1,True,0.4913942382210976
2025-01-08 18:14:18,Fail to pick,88,100,0,0,0,0,0,0,0,0,False,0
2025-01-08 18:14:18,persegiHijau,114,112,130,118,38,66,39,68,1,2,True,0.45939251709518236
2025-01-08 18:14:18,persegiHijau,109,111,129,120,115,14,113,17,2,3,True,0.41436454602565986
2025-01-08 18:14:18,Fail to pick,109,111,0,0,0,0,0,0,0,0,False,0
2025-01-08 18:14:18,persegiHijau,98,110,127,120,22,47,21,46,1,1,True,0.12853200580698854
2025-01-08 18:14:18,persegiHijau,107,105,126,119,30,44,25,48,5,4,True,0.17790119177129765
2025-01-08 18:14:18,Fail to pick,107,105,0,0,0,0,0,0,0,0,False,0
2025-01-08 18:14:18,persegiHijau,91,98,122,118,82,49,86,48,4,1,True,0.42902956449037244
2025-01-08 18:14:19,persegiHijau,98,103,121,120,144,84,146,80,2,4,True,0.28267336407309257
2025-01-08 18:14:19,Fail to pick,98,103,0,0,0,0,0,0,0,0,False,0
2025-01-08 18:14:19,persegiHijau,109,114,129,120,171,74,168,73,3,1,True,0.3186512802413972
2025-01-08 18:14:19,persegiHijau,89,99,118,120,43,83,40,81,3,2,True,0.23696752723598538
2025-01-08 18:14:19,persegiHijau,108,108,127,120,183,15,187,19,4,4,True,0.33505650554602245
2025-01-08 18:14:19,persegiHijau,115,110,129,121,52,59,56,60,4,1,True,0.25229418730878816
2025-01-08 18:14:19,Hijau,115,110,tensor(129.9435),tensor(121.8454),169,10,168,9,1,1,True,0.0
2025-01-08 18:14:19,Fail to pick,115,110,0,0,0,0,0,0,0,0,False,0
2025-01-08 18:14:19,persegiHijau,111,114,130,118,126,70,126,73,0,3,True,0.4904619848211038
2025-01-08 18:14:19,Fail to pick,111,114,0,0,0,0,0,0,0,0,False,0
2025-01-08 18:14:19,persegiHijau,92,96,122,120,85,42,87,43,2,1,True,0.1657095346533659
2025-01-08 18:14:19,persegiHijau,91,94,118,119,149,94,148,92,1,2,True,0.4441772805085026
2025-01-08 18:14:19,Fail to pick,91,94,0,0,0,0,0,0,0,0,False,0
2025-01-08 18:14:19,persegiHijau,90,99,121,122,171,13,175,17,4,4,True,0.23944290641355437
2025-01-08 18:14:19,Fail to pick,90,99,0,0,0,0,0,0,0,0,False,0
2025-01-08 18:14:20,persegiHijau,95,95,119,119,29,39,26,37,3,2,True,0.41275221787752225
2025-01-08 18:14:20,Fail to pick,95,95,0,0,0,0,0,0,0,0,False,0
2025-01-08 18:14:20,persegiHijau,116,112,131,121,98,27,102,31,4,4,True,0.46203415937424275
2025-01-08 18:14:20,persegiHijau,89,96,124,118,176,78,176,80,0,2,True,0.28062256841163846
2025-01-08 18:14:20,persegiHijau,103,107,124,121,188,28,192,32,4,4,True,0.4800147498402726
2025-01-08 18:14:20,persegiHijau,113,111,134,121,57,55,61,55,4,0,True,0.48320175699214696
2025-01-08 18:14:20,Hijau,113,111,tensor(134.3003),tensor(121.0620),169,10,171,5,2,5,True,0.0
2025-01-08 18:14:20,persegiHijau,105,111,124,121,179,72,179,70,0,2,True,0.3816502704952365
2025-01-08 18:14:20,Fail to pick,105,111,0,0,0,0,0,0,0,0,False,0
2025-01-08 18:14:20,persegiHijau,100,104,121,120,19,29,20,26,1,3,True,0.26519236282172504
2025-01-08 18:14:20,Fail to pick,100,104,0,0,0,0,0,0,0,0,False,0
2025-01-08 18:14:20,persegiHijau,91,92,115,120,86,75,90,77,4,2,True,0.44891223827734683
2025-01-08 18:14:20,persegiHijau,93,97,117,116,193,80,195,80,2,0,True,0.32047334725967264
2025-01-08 18:14:20,Fail to pick,93,97,0,0,0,0,0,0,0,0,False,0
2025-01-08 18:14:21,persegiHijau,86,96,119,119,11,50,8,50,3,0,True,0.410311021692361
2025-01-08 18:14:21,Fail to pick,86,96,0,0,0,0,0,0,0,0,False,0
2025-01-08 18:14:21,persegiHijau,88,93,115,119,139,25,136,28,3,3,False,0.429065516497501
2025-01-08 18:14:21,Fail to pick,88,93,0,0,0,0,0,0,0,0,False,0
2025-01-08 18:14:21,persegiHijau,104,106,119,118,79,12,81,10,2,2,True,0.11297391651568343
2025-01-08 18:14:21,persegiHijau,88,93,113,118,105,56,107,51,2,5,True,0.4250045652063792
2025-01-08 18:14:21,persegiHijau,106,104,121,119,59,64,57,61,2,3,True,0.19570554822998815
2025-01-08 18:14:21,persegiHijau,89,92,111,113,134,99,130,97,4,2,True,0.10397433669095335
2025-01-08 18:14:21,Hijau,89,92,tensor(111.8005),tensor(113.5980),174,8,177,6,3,2,True,0.0
2025-01-08 18:14:21,persegiHijau,105,106,119,116,63,28,59,26,4,2,True,0.21740046297264992
2025-01-08 18:14:21,persegiHijau,84,93,113,119,89,14,92,13,3,1,True,0.1087394597293097
2025-01-08 18:14:21,persegiHijau,103,108,121,120,80,68,83,72,3,4,True,0.21936930233081187
2025-01-08 18:14:22,persegiHijau,85,90,112,119,176,35,177,35,1,0,True,0.21888728526282408
2025-01-08 18:14:22,persegiHijau,103,110,118,117,33,72,36,75,3,3,False,0.4807422352802494
2025-01-08 18:14:22,persegiHijau,89,95,115,119,103,26,102,27,1,1,True,0.25087074245354224
2025-01-08 18:14:22,persegiHijau,90,99,119,118,173,9,170,7,3,2,True,0.13614009849408837
2025-01-08 18:14:22,Fail to pick,90,99,0,0,0,0,0,0,0,0,False,0
2025-01-08 18:14:25,persegiHijau,148,42,132,84,132,92,129,89,3,3,True,0.3649367661611339
2025-01-08 18:14:25,Hijau,148,42,tensor(132.8395),tensor(84.7833),188,13,190,17,2,4,True,0.0
2025-01-08 18:14:25,persegiHijau,149,41,131,83,177,3,178,4,1,1,True,0.13192664498295456
2025-01-08 18:14:25,Fail to pick,149,41,0,0,0,0,0,0,0,0,False,0
2025-01-08 18:14:26,persegiHijau,117,33,110,67,25,22,29,22,4,0,True,0.14396246067072652
2025-01-08 18:14:26,persegiHijau,123,32,112,64,0,61,-5,65,5,4,True,0.36589826475884135
2025-01-08 18:14:26,Fail to pick,123,32,0,0,0,0,0,0,0,0,False,0
2025-01-08 18:14:26,persegiHijau,120,33,112,67,117,76,119,77,2,1,True,0.2221447189593486
2025-01-08 18:14:26,Fail to pick,120,33,0,0,0,0,0,0,0,0,False,0
2025-01-08 18:14:26,persegiHijau,139,39,131,78,167,2,162,4,5,2,True,0.3203311377028767
2025-01-08 18:14:26,persegiHijau,141,39,127,78,188,93,186,97,2,4,True,0.42627963180459927
2025-01-08 18:14:26,Fail to pick,141,39,0,0,0,0,0,0,0,0,False,0
2025-01-08 18:14:26,persegiHijau,136,36,122,72,57,55,53,50,4,5,True,0.29751229863066
2025-01-08 18:14:26,Fail to pick,136,36,0,0,0,0,0,0,0,0,False,0
2025-01-08 18:14:26,persegiHijau,119,30,113,60,12,41,14,43,2,2,True,0.37577838184963086
2025-01-08 18:14:26,Hijau,119,30,tensor(113.8965),tensor(60.1423),191,11,187,13,4,2,True,0.0
2025-01-08 18:14:27,persegiHijau,121,29,108,58,117,55,116,53,1,2,True,0.19706072327254673
2025-01-08 18:14:27,Fail to pick,121,29,0,0,0,0,0,0,0,0,False,0
2025-01-08 18:14:27,persegiHijau,116,30,111,60,104,70,102,70,2,0,True,0.41955547974757756
2025-01-08 18:14:27,Fail to pick,116,30,0,0,0,0,0,0,0,0,False,0
2025-01-08 18:14:27,persegiHijau,109,36,113,72,94,2,94,0,0,2,True,0.331885995415386
2025-01-08 18:14:27,Fail to pick,109,36,0,0,0,0,0,0,0,0,False,0
2025-01-08 18:14:27,persegiHijau,117,41,120,82,137,20,139,23,2,3,True,0.12093134587399645
2025-01-08 18:14:27,Fail to pick,117,41,0,0,0,0,0,0,0,0,False,0
2025-01-08 18:14:27,persegiHijau,117,36,112,72,11,35,8,33,3,2,True,0.2490063512272291
2025-01-08 18:14:27,Fail to pick,117,36,0,0,0,0,0,0,0,0,False,0
2025-01-08 18:14:27,persegiHijau,104,36,113,73,60,63,59,59,1,4,True,0.23616373577719052
2025-01-08 18:14:27,Hijau,104,36,tensor(113.3794),tensor(73.5472),190,9,194,7,4,2,True,0.0004999637603759766
2025-01-08 18:14:28,persegiHijau,126,29,104,58,55,67,51,71,4,4,True,0.4583179834171317
2025-01-08 18:14:28,persegiHijau,127,29,109,59,177,90,174,93,3,3,False,0.1087474617451151
2025-01-08 18:14:28,Fail to pick,127,29,0,0,0,0,0,0,0,0,False,0
2025-01-08 18:14:29,persegiHijau,158,37,129,74,158,7,161,6,3,1,False,0.3679114142848464
2025-01-08 18:14:29,Hijau,158,37,tensor(129.4085),tensor(74.1402),189,14,184,12,5,2,True,0.0
2025-01-08 18:14:29,persegiHijau,153,41,131,82,188,64,190,61,2,3,False,0.22500888761242127
2025-01-08 18:14:29,Fail to pick,153,41,0,0,0,0,0,0,0,0,False,0
2025-01-08 18:14:31,persegiHijau,878,49,115,98,105,27,106,25,1,2,True,0.39282736047360745
2025-01-08 18:14:31,Hijau,878,49,tensor(115.9211),tensor(98.3934),186,81,183,85,3,4,True,0.0
2025-01-08 18:14:32,persegiHijau,870,46,109,92,139,98,142,99,3,1,True,0.41110626038592
2025-01-08 18:14:32,Fail to pick,870,46,0,0,0,0,0,0,0,0,False,0
2025-01-08 18:14:32,persegiHijau,891,44,112,89,165,10,160,10,5,0,True,0.4445991681667095
2025-01-08 18:14:32,persegiHijau,855,35,110,71,0,1,4,3,4,2,True,0.3546479870146667
2025-01-08 18:14:32,persegiHijau,855,41,110,82,90,13,93,9,3,4,True,0.23958257227497748
2025-01-08 18:14:32,Fail to pick,855,41,0,0,0,0,0,0,0,0,False,0
2025-01-08 18:14:33,persegiHijau,831,16,94,32,31,92,26,95,5,3,True,0.21626907271308143
2025-01-08 18:14:33,persegiHijau,868,40,110,81,172,99,173,100,1,1,True,0.43347984520743454
2025-01-08 18:14:33,Hijau,868,40,tensor(110.9540),tensor(81.2526),188,80,187,80,1,0,True,0.0
2025-01-08 18:14:33,persegiHijau,869,40,112,81,30,61,28,57,2,4,True,0.14022161389864946
2025-01-08 18:14:33,Fail to pick,869,40,0,0,0,0,0,0,0,0,False,0
2025-01-08 18:14:33,persegiHijau,835,24,105,49,189,40,185,44,4,4,True,0.26573846116683797
2025-01-08 18:14:33,persegiHijau,833,25,104,50,115,85,117,86,2,1,True,0.2767692402851819
2025-01-08 18:14:33,Fail to pick,833,25,0,0,0,0,0,0,0,0,False,0
2025-01-08 18:14:33,persegiHijau,882,44,111,88,157,53,161,55,4,2,True,0.13746706059685931
2025-01-08 18:14:33,persegiHijau,871,40,110,81,179,8,178,3,1,5,True,0.11896157839440531
2025-01-08 18:14:33,persegiHijau,869,41,110,82,140,98,140,98,0,0,True,0.43092703984911673
2025-01-08 18:14:33,Fail to pick,869,41,0,0,0,0,0,0,0,0,False,0
2025-01-08 18:14:33,persegiHijau,873,41,110,82,73,57,75,59,2,2,True,0.14037057517089546
2025-01-08 18:14:33,Fail to pick,873,41,0,0,0,0,0,0,0,0,False,0
2025-01-08 18:14:34,persegiHijau,870,41,110,82,109,94,105,91,4,3,True,0.3408688061381301
2025-01-08 18:14:34,Fail to pick,870,41,0,0,0,0,0,0,0,0,False,0
2025-01-08 18:14:34,persegiHijau,877,41,113,82,121,33,124,29,3,4,False,0.24365423457675894
2025-01-08 18:14:34,Fail to pick,877,41,0,0,0,0,0,0,0,0,False,0
2025-01-08 18:14:40,persegiHijau,870,43,107,87,137,0,137,-2,0,2,True,0.3751982334631351
2025-01-08 18:14:40,Hijau,870,43,tensor(107.5524),tensor(87.7750),188,80,185,79,3,1,True,0.0005004405975341797
2025-01-08 18:14:40,Fail to pick,870,43,0,0,0,0,0,0,0,0,False,0
2025-01-08 18:14:40,persegiHijau,875,41,106,82,92,65,92,63,0,2,True,0.4705763666507433
2025-01-08 18:14:40,Fail to pick,875,41,0,0,0,0,0,0,0,0,False,0
2025-01-08 18:14:40,persegiHijau,842,23,102,47,23,5,21,5,2,0,True,0.3984573891105445
2025-01-08 18:14:40,persegiHijau,881,44,112,88,26,43,27,43,1,0,True,0.4776375046373962
2025-01-08 18:14:40,persegiHijau,877,42,111,84,150,79,148,77,2,2,True,0.2624075757427934
2025-01-08 18:14:40,Fail to pick,877,42,0,0,0,0,0,0,0,0,False,0
2025-01-08 18:14:40,persegiHijau,863,36,109,73,23,65,21,61,2,4,True,0.29631247010467054
2025-01-08 18:14:40,persegiHijau,877,46,113,92,92,70,96,70,4,0,True,0.25394659140271425
2025-01-08 18:14:41,persegiHijau,886,44,109,88,108,82,111,83,3,1,True,0.3983458032005275
2025-01-08 18:14:41,Hijau,886,44,tensor(109.3682),tensor(88.6329),187,82,183,77,4,5,True,0.0
2025-01-08 18:14:41,Fail to pick,886,44,0,0,0,0,0,0,0,0,False,0
2025-01-08 18:14:41,persegiHijau,881,45,108,90,198,18,194,15,4,3,True,0.4293158657424897
2025-01-08 18:14:41,Fail to pick,881,45,0,0,0,0,0,0,0,0,False,0
2025-01-08 18:14:41,persegiHijau,836,30,105,61,81,70,77,74,4,4,True,0.4964442628928296
2025-01-08 18:14:41,persegiHijau,878,45,111,91,181,63,182,64,1,1,True,0.17592144279379915
2025-01-08 18:14:41,persegiHijau,833,30,108,60,95,36,94,32,1,4,True,0.36777421517154607
2025-01-08 18:14:41,persegiHijau,873,40,113,80,160,46,158,46,2,0,True,0.12711003061725556
2025-01-08 18:14:41,persegiHijau,860,23,113,47,87,48,90,50,3,2,False,0.4489775813151342
2025-01-08 18:14:44,persegiHijau,687,334,119,119,62,83,66,78,4,5,True,0.25738941889463585
2025-01-08 18:14:44,Hijau,687,334,tensor(119.3692),tensor(119.7882),107,63,105,63,2,0,True,0.0
2025-01-08 18:14:44,persegiHijau,638,307,116,124,180,57,184,59,4,2,True,0.3313047432073758
2025-01-08 18:14:45,persegiHijau,638,310,115,119,83,56,83,55,0,1,False,0.398279128046263
2025-01-08 18:14:45,Fail to pick,638,310,0,0,0,0,0,0,0,0,False,0
2025-01-08 18:14:45,persegiHijau,652,298,119,121,74,56,69,54,5,2,True,0.11038087572138539
2025-01-08 18:14:45,persegiHijau,648,301,118,122,17,70,18,65,1,5,False,0.15252445436004192
2025-01-08 18:14:45,Fail to pick,648,301,0,0,0,0,0,0,0,0,False,0
2025-01-08 18:14:45,persegiHijau,648,301,117,121,140,5,144,7,4,2,True,0.4071532655970209
2025-01-08 18:14:45,Fail to pick,648,301,0,0,0,0,0,0,0,0,False,0
2025-01-08 18:14:45,persegiHijau,640,303,117,120,66,35,67,37,1,2,True,0.3847620425132121
2025-01-08 18:14:45,Fail to pick,640,303,0,0,0,0,0,0,0,0,False,0
2025-01-08 18:14:45,persegiHijau,650,303,119,122,196,65,200,62,4,3,True,0.43522609521029576
2025-01-08 18:14:45,persegiHijau,651,303,119,119,85,47,89,43,4,4,True,0.11870763908459883
2025-01-08 18:14:45,Fail to pick,651,303,0,0,0,0,0,0,0,0,False,0
2025-01-08 18:14:45,persegiHijau,638,302,119,123,198,53,198,54,0,1,True,0.3577226973420996
2025-01-08 18:14:45,persegiHijau,643,302,118,122,84,12,83,11,1,1,True,0.41614367987112144
2025-01-08 18:14:45,Fail to pick,643,302,0,0,0,0,0,0,0,0,False,0
2025-01-08 18:14:46,persegiHijau,645,296,121,121,187,26,187,25,0,1,True,0.36090883131572316
2025-01-08 18:14:46,Hijau,645,296,tensor(121.9979),tensor(121.7161),117,59,114,55,3,4,True,0.0
2025-01-08 18:14:46,Fail to pick,645,296,0,0,0,0,0,0,0,0,False,0
2025-01-08 18:14:46,persegiHijau,647,295,122,123,57,48,58,47,1,1,True,0.43409990309963786
2025-01-08 18:14:46,Fail to pick,647,295,0,0,0,0,0,0,0,0,False,0
2025-01-08 18:14:46,persegiHijau,640,295,119,124,171,32,175,30,4,2,True,0.17831235711336754
2025-01-08 18:14:46,Fail to pick,640,295,0,0,0,0,0,0,0,0,False,0
2025-01-08 18:14:46,persegiHijau,651,299,124,123,60,99,61,99,1,0,True,0.32286916474320365
2025-01-08 18:14:46,persegiHijau,651,299,124,121,127,72,127,73,0,1,True,0.3589648687103951
2025-01-08 18:14:46,Fail to pick,651,299,0,0,0,0,0,0,0,0,False,0
2025-01-08 18:14:46,persegiHijau,642,296,120,121,58,2,55,5,3,3,True,0.12338337363179895
2025-01-08 18:14:46,Fail to pick,642,296,0,0,0,0,0,0,0,0,False,0
2025-01-08 18:14:46,persegiHijau,646,298,120,122,99,92,102,96,3,4,True,0.13565152904767155
2025-01-08 18:14:46,Fail to pick,646,298,0,0,0,0,0,0,0,0,False,0
2025-01-08 18:14:46,persegiHijau,645,297,119,123,8,42,6,45,2,3,True,0.19519032301871359
2025-01-08 18:14:46,Fail to pick,645,297,0,0,0,0,0,0,0,0,False,0
2025-01-08 18:14:46,persegiHijau,654,299,117,123,121,97,123,101,2,4,True,0.29250621445293057
2025-01-08 18:14:46,Fail to pick,654,299,0,0,0,0,0,0,0,0,False,0
2025-01-08 18:14:46,persegiHijau,640,296,121,125,115,50,112,47,3,3,True,0.44219169382067947
2025-01-08 18:14:47,persegiHijau,645,295,118,123,3,80,6,83,3,3,True,0.3592320148852026
2025-01-08 18:14:47,Hijau,645,295,tensor(118.9677),tensor(123.2279),118,59,115,54,3,5,True,0.0
2025-01-08 18:14:47,Fail to pick,645,295,0,0,0,0,0,0,0,0,False,0
2025-01-08 18:14:47,persegiHijau,643,296,119,124,91,40,90,36,1,4,True,0.32335556431406276
2025-01-08 18:14:47,Fail to pick,643,296,0,0,0,0,0,0,0,0,False,0
2025-01-08 18:14:47,persegiHijau,648,296,125,123,51,58,55,62,4,4,True,0.42580674148657394
2025-01-08 18:14:47,Fail to pick,648,296,0,0,0,0,0,0,0,0,False,0
2025-01-08 18:14:47,persegiHijau,655,299,124,124,156,34,158,35,2,1,True,0.4521593506960395
2025-01-08 18:14:47,Fail to pick,655,299,0,0,0,0,0,0,0,0,False,0
2025-01-08 18:14:47,persegiHijau,637,304,118,123,97,94,96,97,1,3,True,0.45187872653985905
2025-01-08 18:14:47,persegiHijau,696,350,120,119,82,9,80,12,2,3,True,0.1434600013931902
2025-01-08 18:14:47,persegiHijau,689,356,123,119,102,68,97,66,5,2,True,0.11880071043990058
2025-01-08 18:14:47,Fail to pick,689,356,0,0,0,0,0,0,0,0,False,0
2025-01-08 18:14:48,persegiHijau,681,326,116,118,192,86,190,83,2,3,True,0.37851669053782
2025-01-08 18:14:48,Hijau,681,326,tensor(116.1395),tensor(118.4329),109,63,108,63,1,0,True,0.0
2025-01-08 18:14:48,persegiHijau,673,325,117,119,119,94,123,90,4,4,True,0.4226530284494201
2025-01-08 18:14:48,Fail to pick,673,325,0,0,0,0,0,0,0,0,False,0
2025-01-08 18:14:48,persegiHijau,675,328,116,118,37,0,36,1,1,1,True,0.2550971289150369
2025-01-08 18:14:48,Fail to pick,675,328,0,0,0,0,0,0,0,0,False,0
2025-01-08 18:14:48,persegiHijau,656,303,118,121,23,58,21,53,2,5,True,0.21611177011535998
2025-01-08 18:14:48,persegiHijau,654,303,120,122,51,44,48,47,3,3,True,0.1876246911603514
2025-01-08 18:14:48,Fail to pick,654,303,0,0,0,0,0,0,0,0,False,0
2025-01-08 18:14:48,persegiHijau,679,328,119,117,1,10,3,8,2,2,True,0.2836427508279533
2025-01-08 18:14:48,persegiHijau,680,322,122,121,160,96,162,92,2,4,True,0.46457992377083623
2025-01-08 18:14:48,Fail to pick,680,322,0,0,0,0,0,0,0,0,False,0
2025-01-08 18:14:48,persegiHijau,684,329,123,119,31,57,35,55,4,2,True,0.1824366987373478
2025-01-08 18:14:48,Fail to pick,684,329,0,0,0,0,0,0,0,0,False,0
2025-01-08 18:14:49,persegiHijau,684,328,125,119,160,40,160,43,0,3,False,0.19470651752572712
2025-01-08 18:14:49,Fail to pick,684,328,0,0,0,0,0,0,0,0,False,0
2025-01-08 18:14:49,persegiHijau,652,309,121,126,3,38,7,34,4,4,True,0.22579357275661055
2025-01-08 18:14:49,persegiHijau,665,307,119,117,183,57,185,54,2,3,True,0.36120156027408556
2025-01-08 18:14:49,Hijau,665,307,tensor(119.9225),tensor(117.4050),114,61,112,63,2,2,True,0.0
2025-01-08 18:14:49,persegiHijau,682,324,123,123,111,51,114,53,3,2,True,0.4942824129802883
2025-01-08 18:14:49,persegiHijau,679,325,121,122,182,92,177,87,5,5,True,0.2823061323698721
2025-01-08 18:14:49,Fail to pick,679,325,0,0,0,0,0,0,0,0,False,0
2025-01-08 18:14:49,persegiHijau,652,311,119,123,40,79,40,78,0,1,False,0.15500170451516324
2025-01-08 18:14:49,persegiHijau,679,331,119,116,174,70,178,69,4,1,False,0.432828466607299
2025-01-08 18:14:49,persegiHijau,680,328,117,117,169,26,171,25,2,1,False,0.149403749469586
2025-01-08 18:14:49,Fail to pick,680,328,0,0,0,0,0,0,0,0,False,0
2025-01-08 18:14:49,persegiHijau,677,357,117,116,120,95,115,94,5,1,True,0.3025362385716977
2025-01-08 18:14:49,persegiHijau,697,351,116,117,129,74,128,72,1,2,True,0.12575726305494192
2025-01-08 18:14:50,persegiHijau,690,328,116,119,179,3,182,4,3,1,True,0.19951519380579083
2025-01-08 18:14:50,persegiHijau,681,332,116,115,5,62,1,58,4,4,True,0.1386317276349389
2025-01-08 18:14:50,Fail to pick,681,332,0,0,0,0,0,0,0,0,False,0
2025-01-08 18:14:50,persegiHijau,675,330,115,113,149,31,151,29,2,2,True,0.17724858099146448
2025-01-08 18:14:50,Hijau,675,330,tensor(115.3604),tensor(113.2197),108,62,111,65,3,3,True,0.0
2025-01-08 18:14:50,Fail to pick,675,330,0,0,0,0,0,0,0,0,False,0
2025-01-08 18:14:50,persegiHijau,648,306,119,120,9,83,4,78,5,5,True,0.280356687238023
2025-01-08 18:14:50,persegiHijau,649,308,118,120,199,12,196,11,3,1,True,0.23022606956374503
2025-01-08 18:14:50,Fail to pick,649,308,0,0,0,0,0,0,0,0,False,0
2025-01-08 18:14:50,persegiHijau,676,332,117,114,176,95,179,99,3,4,False,0.29667159628292394
2025-01-08 18:14:50,persegiHijau,656,314,114,115,165,41,162,42,3,1,False,0.32639907828051806
2025-01-08 18:14:50,persegiHijau,653,305,115,118,190,98,188,98,2,0,True,0.42715616570980397
2025-01-08 18:14:50,Fail to pick,653,305,0,0,0,0,0,0,0,0,False,0
2025-01-08 18:14:50,persegiHijau,649,308,115,118,119,38,119,38,0,0,True,0.2861003174142339
2025-01-08 18:14:50,Fail to pick,649,308,0,0,0,0,0,0,0,0,False,0
2025-01-08 18:14:50,persegiHijau,661,310,115,114,3,88,2,89,1,1,True,0.24654484428190426
2025-01-08 18:14:51,persegiHijau,684,329,114,111,119,97,122,94,3,3,True,0.10733120424480425
2025-01-08 18:14:51,persegiHijau,651,313,117,116,146,3,143,5,3,2,True,0.3908362496409893
2025-01-08 18:14:55,persegiHijau,689,336,116,112,99,27,102,27,3,0,True,0.2224966475056589
2025-01-08 18:14:55,Hijau,689,336,tensor(116.9508),tensor(112.3668),106,63,105,60,1,3,True,0.0005054473876953125
2025-01-08 18:14:55,persegiHijau,687,337,120,113,51,8,48,11,3,3,True,0.28796459820021925
2025-01-08 18:14:55,Fail to pick,687,337,0,0,0,0,0,0,0,0,False,0
2025-01-08 18:14:55,persegiHijau,646,313,119,115,136,91,131,87,5,4,True,0.1622549527512542
2025-01-08 18:14:55,persegiHijau,672,335,122,120,162,46,159,49,3,3,True,0.3908845331757186
2025-01-08 18:14:55,persegiHijau,693,336,125,111,92,79,92,81,0,2,True,0.3873181717441909
2025-01-08 18:14:55,persegiHijau,673,337,117,112,58,70,53,68,5,2,True,0.24573048280496612
2025-01-08 18:14:55,persegiHijau,687,338,120,109,132,93,130,93,2,0,True,0.3216378783081948
2025-01-08 18:14:56,persegiHijau,692,334,119,112,27,21,30,19,3,2,True,0.37326122753970936
2025-01-08 18:14:56,Hijau,692,334,tensor(119.5857),tensor(112.8864),107,64,107,68,0,4,True,0.0004937648773193359
2025-01-08 18:14:56,Fail to pick,692,334,0,0,0,0,0,0,0,0,False,0
2025-01-08 18:14:56,persegiHijau,678,331,122,111,41,12,44,7,3,5,True,0.48508028081910715
2025-01-08 18:14:56,persegiHijau,689,337,118,112,169,40,168,37,1,3,True,0.4886529043982115
2025-01-08 18:14:56,persegiHijau,701,330,121,114,186,30,188,34,2,4,True,0.3756629681220772
2025-01-08 18:14:56,persegiHijau,688,335,117,116,65,11,60,7,5,4,True,0.21421708835361974
2025-01-08 18:14:56,persegiHijau,692,335,118,113,192,29,189,28,3,1,True,0.2922570555431331
2025-01-08 18:14:56,Fail to pick,692,335,0,0,0,0,0,0,0,0,False,0
2025-01-08 18:14:56,persegiHijau,690,334,120,113,172,64,176,62,4,2,False,0.42305432115150987
2025-01-08 18:14:56,Fail to pick,690,334,0,0,0,0,0,0,0,0,False,0
2025-01-08 18:14:56,persegiHijau,692,337,118,110,26,68,22,69,4,1,True,0.2104199002117756
2025-01-08 18:14:56,Fail to pick,692,337,0,0,0,0,0,0,0,0,False,0
2025-01-08 18:14:57,persegiHijau,690,336,120,113,13,63,16,63,3,0,True,0.4183278326635659
2025-01-08 18:14:57,Fail to pick,690,336,0,0,0,0,0,0,0,0,False,0
2025-01-08 18:14:57,persegiHijau,683,340,118,112,135,36,136,38,1,2,True,0.3636453235262932
2025-01-08 18:14:57,Fail to pick,683,340,0,0,0,0,0,0,0,0,False,0
2025-01-08 18:14:57,persegiHijau,686,337,122,114,149,65,150,61,1,4,True,0.1629852213971838
2025-01-08 18:14:57,Hijau,686,337,tensor(122.4633),tensor(114.7551),106,63,110,66,4,3,True,0.0004992485046386719
2025-01-08 18:14:57,Fail to pick,686,337,0,0,0,0,0,0,0,0,False,0
2025-01-08 18:14:57,persegiHijau,689,334,120,115,101,39,101,38,0,1,True,0.4321304831170133
2025-01-08 18:14:57,Fail to pick,689,334,0,0,0,0,0,0,0,0,False,0
2025-01-08 18:14:57,persegiHijau,682,332,119,115,117,45,118,42,1,3,True,0.14092711363089633
2025-01-08 18:14:57,Fail to pick,682,332,0,0,0,0,0,0,0,0,False,0
2025-01-08 18:14:57,persegiHijau,687,338,119,111,14,87,17,86,3,1,True,0.40001151433568227
2025-01-08 18:14:57,Fail to pick,687,338,0,0,0,0,0,0,0,0,False,0
2025-01-08 18:14:57,persegiHijau,687,337,119,113,125,66,122,65,3,1,True,0.2176054857873302
2025-01-08 18:14:57,Fail to pick,687,337,0,0,0,0,0,0,0,0,False,0
2025-01-08 18:14:57,persegiHijau,686,332,124,112,24,68,19,63,5,5,True,0.48136394349045675
2025-01-08 18:14:57,Fail to pick,686,332,0,0,0,0,0,0,0,0,False,0
2025-01-08 18:14:57,persegiHijau,681,340,120,121,122,51,118,46,4,5,True,0.2816149316195194
2025-01-08 18:14:57,Fail to pick,681,340,0,0,0,0,0,0,0,0,False,0
2025-01-08 18:14:58,persegiHijau,675,328,120,116,50,85,50,81,0,4,True,0.14835000890286906
2025-01-08 18:14:58,persegiHijau,691,336,117,113,34,83,32,86,2,3,True,0.41464794915879943
2025-01-08 18:14:58,persegiHijau,682,341,119,113,96,48,91,45,5,3,True,0.22265340427821148
2025-01-08 18:14:58,Fail to pick,682,341,0,0,0,0,0,0,0,0,False,0
2025-01-08 18:14:58,persegiHijau,691,336,118,111,173,14,169,12,4,2,True,0.1358098389938654
2025-01-08 18:14:58,Hijau,691,336,tensor(118.5067),tensor(111.3688),106,63,101,65,5,2,True,0.0004990100860595703
2025-01-08 18:14:58,Fail to pick,691,336,0,0,0,0,0,0,0,0,False,0
2025-01-08 18:14:58,persegiHijau,668,273,131,116,127,30,131,32,4,2,True,0.29820628806921134
2025-01-08 18:14:59,persegiHijau,649,294,118,115,28,51,25,54,3,3,True,0.33713259462708145
2025-01-08 18:14:59,persegiHijau,676,349,114,114,100,54,100,53,0,1,True,0.11944626209220117
2025-01-08 18:14:59,persegiHijau,687,336,119,113,158,12,155,13,3,1,True,0.4730956809781759
2025-01-08 18:14:59,persegiHijau,682,342,117,113,60,61,55,59,5,2,True,0.32510604148915967
2025-01-08 18:14:59,Fail to pick,682,342,0,0,0,0,0,0,0,0,False,0
2025-01-08 18:14:59,persegiHijau,689,335,123,111,130,34,133,29,3,5,True,0.23395492548395472
2025-01-08 18:14:59,Fail to pick,689,335,0,0,0,0,0,0,0,0,False,0
2025-01-08 18:14:59,persegiHijau,690,336,120,110,98,20,95,16,3,4,True,0.28300578956861566
2025-01-08 18:14:59,Hijau,690,336,tensor(120.0936),tensor(110.2646),106,63,108,60,2,3,True,0.0
2025-01-08 18:14:59,Fail to pick,690,336,0,0,0,0,0,0,0,0,False,0
2025-01-08 18:14:59,persegiHijau,694,332,124,109,148,82,143,79,5,3,False,0.4944595465004419
2025-01-08 18:14:59,Fail to pick,694,332,0,0,0,0,0,0,0,0,False,0
2025-01-08 18:14:59,persegiHijau,691,338,121,109,117,33,121,33,4,0,True,0.20624408336899572
2025-01-08 18:14:59,Fail to pick,691,338,0,0,0,0,0,0,0,0,False,0
2025-01-08 18:14:59,persegiHijau,690,332,122,112,101,58,96,59,5,1,False,0.29433037394209616
2025-01-08 18:14:59,Fail to pick,690,332,0,0,0,0,0,0,0,0,False,0
2025-01-08 18:15:00,persegiHijau,676,330,115,112,167,82,163,86,4,4,False,0.28132898663639105
2025-01-08 18:15:00,persegiHijau,679,327,120,113,30,98,25,96,5,2,True,0.2710052070350502
2025-01-08 18:15:00,Fail to pick,679,327,0,0,0,0,0,0,0,0,False,0
2025-01-08 18:15:00,persegiHijau,686,335,120,111,148,1,146,-2,2,3,True,0.4148600996477573
2025-01-08 18:15:00,Fail to pick,686,335,0,0,0,0,0,0,0,0,False,0
2025-01-08 18:15:00,persegiHijau,689,334,121,111,199,27,200,28,1,1,True,0.11438973021959496
2025-01-08 18:15:00,Fail to pick,689,334,0,0,0,0,0,0,0,0,False,0
2025-01-08 18:15:00,persegiHijau,683,337,119,111,173,37,175,38,2,1,True,0.13338972154837703
2025-01-08 18:15:00,Fail to pick,683,337,0,0,0,0,0,0,0,0,False,0
2025-01-08 18:15:00,persegiHijau,684,335,114,113,178,29,181,30,3,1,True,0.23917273075642825
2025-01-08 18:15:00,Fail to pick,684,335,0,0,0,0,0,0,0,0,False,0
2025-01-08 18:15:00,persegiHijau,689,330,123,109,123,19,120,21,3,2,True,0.19259966957957794
2025-01-08 18:15:00,Hijau,689,330,tensor(123.7089),tensor(109.7322),108,63,112,58,4,5,True,0.0
2025-01-08 18:15:00,Fail to pick,689,330,0,0,0,0,0,0,0,0,False,0
2025-01-08 18:15:00,persegiHijau,672,326,120,113,18,35,22,38,4,3,True,0.3364237934442833
2025-01-08 18:15:00,persegiHijau,674,349,119,114,4,91,5,86,1,5,True,0.367198152751231
2025-01-08 18:15:00,persegiHijau,630,300,120,116,50,84,54,84,4,0,True,0.41654475853345907
2025-01-08 18:15:01,persegiHijau,676,338,115,113,92,9,89,8,3,1,True,0.4744275820297348
2025-01-08 18:15:01,persegiHijau,692,331,116,111,23,52,21,53,2,1,True,0.44148357379527214
2025-01-08 18:15:01,persegiHijau,678,333,116,111,42,39,43,36,1,3,True,0.16985657890100758
2025-01-08 18:15:01,persegiHijau,686,340,118,112,55,62,50,65,5,3,True,0.2628156488996476
2025-01-08 18:15:01,Fail to pick,686,340,0,0,0,0,0,0,0,0,False,0
2025-01-08 18:15:01,persegiHijau,685,338,117,112,139,56,134,54,5,2,True,0.1980090573987428
2025-01-08 18:15:01,Fail to pick,685,338,0,0,0,0,0,0,0,0,False,0
2025-01-08 18:15:01,persegiHijau,635,297,120,117,120,70,123,73,3,3,True,0.12710156183387503
2025-01-08 18:15:01,persegiHijau,632,300,120,116,87,21,88,16,1,5,True,0.3901037441889047
2025-01-08 18:15:01,Hijau,632,300,tensor(120.4869),tensor(116.3086),116,58,111,59,5,1,True,0.0
2025-01-08 18:15:01,Fail to pick,632,300,0,0,0,0,0,0,0,0,False,0
2025-01-08 18:15:01,persegiHijau,672,331,117,110,86,49,88,49,2,0,True,0.21081890565373307
2025-01-08 18:15:01,persegiHijau,682,340,117,109,156,34,155,29,1,5,False,0.21378123173550675
2025-01-08 18:15:02,persegiHijau,687,337,121,110,193,68,192,72,1,4,True,0.1677891577445118
2025-01-08 18:15:02,Fail to pick,687,337,0,0,0,0,0,0,0,0,False,0
2025-01-08 18:15:02,persegiHijau,682,331,120,110,161,5,158,7,3,2,True,0.16214688012415202
2025-01-08 18:15:02,Fail to pick,682,331,0,0,0,0,0,0,0,0,False,0
2025-01-08 18:15:02,persegiHijau,626,291,114,112,133,99,134,102,1,3,True,0.15244790428636534
2025-01-08 18:15:02,persegiHijau,690,338,115,108,101,28,105,31,4,3,True,0.403008117972962
2025-01-08 18:15:02,persegiHijau,687,339,119,109,88,96,84,100,4,4,True,0.1734521877602982
2025-01-08 18:15:02,Fail to pick,687,339,0,0,0,0,0,0,0,0,False,0
2025-01-08 18:15:02,persegiHijau,673,329,120,112,175,33,174,32,1,1,True,0.10984396323631983
2025-01-08 18:15:02,persegiHijau,621,297,121,116,22,8,20,12,2,4,True,0.2991730416485266
2025-01-08 18:15:02,Hijau,621,297,tensor(121.1147),tensor(116.4113),117,57,119,56,2,1,True,0.0
2025-01-08 18:15:03,persegiHijau,698,323,116,114,94,68,95,68,1,0,True,0.35587728166359933
2025-01-08 18:15:03,persegiHijau,691,333,122,109,175,77,174,76,1,1,True,0.29764534859662306
2025-01-08 18:15:03,persegiHijau,677,328,120,110,45,81,43,81,2,0,True,0.22981506030565893
2025-01-08 18:15:03,persegiHijau,622,295,117,116,34,51,38,54,4,3,True,0.14468201537916153
2025-01-08 18:15:03,Hijau,622,295,tensor(117.5663),tensor(116.3141),118,57,116,56,2,1,True,0.0
2025-01-08 18:15:03,persegiHijau,685,326,121,109,19,1,19,-1,0,2,True,0.4817169629311695
2025-01-08 18:15:04,persegiHijau,645,301,120,115,9,82,9,78,0,4,True,0.34157112591409244
2025-01-08 18:15:29,persegiBiru,745,351,123,100,60,97,63,99,3,2,True,0.1998083950811078
2025-01-08 18:15:29,Biru,745,351,tensor(123.4957),tensor(100.3897),102,68,105,64,3,4,True,0.0
2025-01-08 18:15:29,persegiBiru,719,330,128,103,95,84,90,88,5,4,True,0.3563591586169562
2025-01-08 18:15:30,persegiBiru,734,332,126,105,37,56,38,58,1,2,True,0.1987595568856446
2025-01-08 18:15:30,persegiBiru,715,333,116,107,14,60,12,61,2,1,True,0.12171559010421151
2025-01-08 18:15:38,persegiBiru,719,332,126,107,41,1,43,3,2,2,True,0.1164718833477477
2025-01-08 18:15:38,Biru,719,332,tensor(126.8509),tensor(107.0472),107,66,110,62,3,4,True,0.0004982948303222656
2025-01-08 18:15:38,Fail to pick,719,332,0,0,0,0,0,0,0,0,False,0
2025-01-08 18:15:38,persegiKuning,722,325,114,107,58,1,62,-1,4,2,True,0.32059201036975504
2025-01-08 18:15:38,Fail to pick,722,325,0,0,0,0,0,0,0,0,False,0
2025-01-08 18:15:39,persegiBiru,709,330,120,107,55,31,54,31,1,0,True,0.18301328953283363
2025-01-08 18:15:39,persegiBiru,708,342,119,107,65,41,65,43,0,2,True,0.19417387681906334
2025-01-08 18:15:39,persegiBiru,710,327,120,108,144,82,139,79,5,3,True,0.2332184338507772
2025-01-08 18:15:42,persegiBiru,666,208,110,108,135,43,139,43,4,0,True,0.4115883100187715
2025-01-08 18:15:42,Biru,666,208,tensor(110.3864),tensor(108.2114),142,61,140,64,2,3,True,0.0004982948303222656
2025-01-08 18:15:42,persegiBiru,607,161,112,113,119,47,123,51,4,4,False,0.366717949345442
2025-01-08 18:15:42,persegiBiru,658,206,118,110,0,21,-1,17,1,4,False,0.3200789980614183
2025-01-08 18:15:42,persegiBiru,589,161,119,120,86,6,81,7,5,1,True,0.3825985567073126
2025-01-08 18:15:42,persegiBiru,656,198,123,108,178,47,173,45,5,2,False,0.19022552341212762
2025-01-08 18:15:42,persegiBiru,672,209,119,108,39,12,38,11,1,1,True,0.31877415573478585
2025-01-08 18:15:43,persegiBiru,654,194,126,111,18,27,13,24,5,3,True,0.39121824579764974
2025-01-08 18:15:43,persegiBiru,669,206,124,112,196,20,194,24,2,4,True,0.25727048941553843
2025-01-08 18:15:43,persegiBiru,658,192,121,111,68,66,70,61,2,5,True,0.31357272925298474
2025-01-08 18:15:43,Biru,658,192,tensor(121.1415),tensor(111.3484),146,60,148,62,2,2,True,0.0004992485046386719
2025-01-08 18:15:43,persegiBiru,647,186,116,114,95,46,93,46,2,0,True,0.22097986559103353
2025-01-08 18:15:43,persegiBiru,658,192,120,116,174,60,176,55,2,5,True,0.1403056065185856
2025-01-08 18:15:45,persegiBiru,669,202,123,108,145,68,149,67,4,1,True,0.32572818765676503
2025-01-08 18:15:45,Biru,669,202,tensor(123.0498),tensor(108.9275),143,61,142,59,1,2,True,0.0
2025-01-08 18:15:45,persegiBiru,617,152,113,109,131,2,130,6,1,4,True,0.27705503939034837
2025-01-08 18:15:53,persegiBiru,677,209,117,107,15,70,15,74,0,4,True,0.46767161694264836
2025-01-08 18:15:53,Biru,677,209,tensor(117.4614),tensor(107.9983),141,62,136,58,5,4,True,0.0
2025-01-08 18:15:53,persegiBiru,672,206,114,106,5,68,5,68,0,0,True,0.32747978968762537
2025-01-08 18:15:53,Fail to pick,672,206,0,0,0,0,0,0,0,0,False,0
2025-01-08 18:15:53,persegiBiru,669,209,119,104,118,22,122,18,4,4,True,0.15732959043401495
2025-01-08 18:15:53,Fail to pick,669,209,0,0,0,0,0,0,0,0,False,0
2025-01-08 18:15:53,persegiBiru,652,176,119,109,164,46,163,47,1,1,True,0.275947037216483
2025-01-08 18:15:54,persegiBiru,674,190,114,104,122,98,125,99,3,1,True,0.14668871086706134
2025-01-08 18:15:54,Biru,674,190,tensor(114.2598),tensor(104.4492),147,62,146,62,1,0,True,0.0
2025-01-08 18:15:54,persegiBiru,670,210,114,108,176,47,179,43,3,4,True,0.34664745239277694
2025-01-08 18:15:54,persegiBiru,673,213,120,109,24,34,23,34,1,0,True,0.3260085643151707
2025-01-08 18:15:54,Fail to pick,673,213,0,0,0,0,0,0,0,0,False,0
2025-01-08 18:15:55,persegiBiru,673,212,120,105,52,6,54,3,2,3,True,0.39991583330945624
2025-01-08 18:15:55,Fail to pick,673,212,0,0,0,0,0,0,0,0,False,0
2025-01-08 18:15:55,persegiBiru,670,211,116,106,145,0,149,3,4,3,True,0.3805694203101877
2025-01-08 18:15:55,Fail to pick,670,211,0,0,0,0,0,0,0,0,False,0
2025-01-08 18:15:55,persegiBiru,672,211,115,104,121,73,124,75,3,2,False,0.29630622885875135
2025-01-08 18:15:55,Fail to pick,672,211,0,0,0,0,0,0,0,0,False,0
2025-01-08 18:15:55,persegiBiru,667,212,116,106,191,57,191,52,0,5,True,0.11759223801136001
2025-01-08 18:15:55,Fail to pick,667,212,0,0,0,0,0,0,0,0,False,0
2025-01-08 18:15:55,persegiBiru,667,212,113,103,91,64,86,60,5,4,True,0.4622466186523685
2025-01-08 18:15:55,Biru,667,212,tensor(113.3719),tensor(103.1108),141,61,136,63,5,2,True,0.0
2025-01-08 18:15:55,Fail to pick,667,212,0,0,0,0,0,0,0,0,False,0
2025-01-08 18:15:55,persegiBiru,660,212,125,105,84,72,86,71,2,1,False,0.2033955179727132
2025-01-08 18:15:55,Fail to pick,660,212,0,0,0,0,0,0,0,0,False,0
2025-01-08 18:15:55,persegiBiru,662,211,119,104,39,51,39,49,0,2,True,0.4561255393995399
2025-01-08 18:15:55,Fail to pick,662,211,0,0,0,0,0,0,0,0,False,0
2025-01-08 18:15:56,persegiBiru,674,209,116,102,1,35,-3,36,4,1,False,0.15069846281728982
2025-01-08 18:15:56,persegiMerah,672,212,120,104,26,24,23,26,3,2,True,0.3556776311529546
2025-01-08 18:15:56,Fail to pick,672,212,0,0,0,0,0,0,0,0,False,0
2025-01-08 18:15:57,persegiBiru,674,210,115,103,175,85,179,87,4,2,True,0.3491809967557963
2025-01-08 18:15:57,Biru,674,210,tensor(115.0520),tensor(103.0881),141,62,138,60,3,2,True,0.0004985332489013672
2025-01-08 18:15:57,Fail to pick,674,210,0,0,0,0,0,0,0,0,False,0
2025-01-08 18:15:57,persegiBiru,572,152,108,106,14,31,16,31,2,0,True,0.4870333683064967
2025-01-08 18:16:08,persegiBiru,671,204,118,111,83,8,79,6,4,2,True,0.36265120530158745
2025-01-08 18:16:08,Biru,671,204,tensor(118.4219),tensor(111.2296),143,62,141,61,2,1,True,0.0004982948303222656
2025-01-08 18:16:09,persegiBiru,659,196,128,112,64,60,65,55,1,5,True,0.3075101863515288
2025-01-08 18:16:09,persegiBiru,635,183,123,108,8,44,9,44,1,0,True,0.36924246815438877
2025-01-08 18:16:09,persegiBiru,596,150,116,114,70,23,72,27,2,4,True,0.21233370606422938
2025-01-08 18:16:09,persegiBiru,617,159,114,112,90,79,85,83,5,4,False,0.4432312421857382
2025-01-08 18:16:09,persegiBiru,605,163,125,113,0,88,-4,92,4,4,True,0.31099979364333286
2025-01-08 18:16:09,persegiBiru,656,198,129,113,14,79,16,78,2,1,True,0.2638756821803544
2025-01-08 18:17:22,persegiKuning,372,403,115,120,35,99,31,97,4,2,True,0.2764665025679732
2025-01-08 18:17:22,Kuning,372,403,tensor(115.7787),tensor(120.8284),88,34,85,36,3,2,True,0.0004992485046386719
2025-01-08 18:17:22,persegiKuning,356,413,114,121,60,46,56,46,4,0,True,0.11989917760955807
2025-01-08 18:17:22,persegiKuning,364,428,118,122,111,54,107,49,4,5,True,0.24984040696502846
2025-01-08 18:17:28,persegiMerah,389,428,123,122,49,22,51,17,2,5,True,0.2822868421670405
2025-01-08 18:17:28,Merah,389,428,tensor(123.3547),tensor(122.3181),81,36,81,33,0,3,True,0.0
2025-01-08 18:17:28,persegiMerah,385,424,121,124,25,93,20,96,5,3,True,0.37939672994509543
2025-01-08 18:17:28,Fail to pick,385,424,0,0,0,0,0,0,0,0,False,0
2025-01-08 18:17:29,persegiMerah,377,437,123,125,135,4,130,4,5,0,True,0.25464842228112905
2025-01-08 18:17:31,persegiBiru,352,460,122,123,134,8,137,4,3,4,True,0.3242902006713042
2025-01-08 18:17:31,Biru,352,460,tensor(122.4979),tensor(123.2988),72,32,74,27,2,5,True,0.0
2025-01-08 18:17:31,persegiKuning,391,450,120,128,149,4,151,6,2,2,True,0.22344564809092124
2025-01-08 18:17:32,persegiBiru,379,424,121,115,92,39,96,42,4,3,True,0.2583947610434174
2025-01-08 18:17:33,persegiBiru,377,435,122,119,31,26,33,30,2,4,True,0.2621954036023123
2025-01-08 18:17:33,Biru,377,435,tensor(122.0218),tensor(119.2607),79,34,79,37,0,3,True,0.0004878044128417969
2025-01-08 18:21:14,persegiHijau,278,243,130,124,177,18,177,14,0,4,True,0.43367787284730475
2025-01-08 18:21:14,Hijau,278,243,tensor(130.0513),tensor(124.8989),132,25,130,27,2,2,True,0.0005002021789550781
2025-01-08 18:21:14,persegiHijau,277,240,129,127,88,88,88,90,0,2,True,0.10549736186660873
2025-01-08 18:21:14,Fail to pick,277,240,0,0,0,0,0,0,0,0,False,0
2025-01-08 18:21:14,persegiHijau,291,246,126,124,132,24,127,24,5,0,True,0.2776587750779864
2025-01-08 18:21:15,persegiHijau,283,242,126,126,100,20,103,17,3,3,True,0.36702815903897323
2025-01-08 18:21:15,Fail to pick,283,242,0,0,0,0,0,0,0,0,False,0
2025-01-08 18:21:15,persegiHijau,281,240,124,128,21,74,24,69,3,5,True,0.35637608170863644
2025-01-08 18:21:15,Fail to pick,281,240,0,0,0,0,0,0,0,0,False,0
2025-01-08 18:21:15,persegiHijau,280,242,125,123,55,44,54,41,1,3,True,0.27335883128304905
2025-01-08 18:21:15,Fail to pick,280,242,0,0,0,0,0,0,0,0,False,0
2025-01-08 18:21:15,persegiHijau,288,254,125,126,28,23,26,22,2,1,True,0.3363073212291168
2025-01-08 18:21:15,persegiHijau,279,245,128,124,80,27,78,27,2,0,True,0.12827794394459568
2025-01-08 18:21:15,Fail to pick,279,245,0,0,0,0,0,0,0,0,False,0
2025-01-08 18:21:15,persegiHijau,277,244,129,122,151,53,150,49,1,4,False,0.18708855307996491
2025-01-08 18:21:15,Fail to pick,277,244,0,0,0,0,0,0,0,0,False,0
2025-01-08 18:21:15,persegiHijau,283,243,128,123,178,36,176,37,2,1,False,0.1801552985915357
2025-01-08 18:21:15,Fail to pick,283,243,0,0,0,0,0,0,0,0,False,0
2025-01-08 18:21:15,persegiHijau,280,242,125,126,27,55,28,56,1,1,False,0.12285774634049798
2025-01-08 18:21:15,Hijau,280,242,tensor(125.9595),tensor(126.7969),132,25,127,27,5,2,True,0.0
2025-01-08 18:21:15,Fail to pick,280,242,0,0,0,0,0,0,0,0,False,0
2025-01-08 18:21:15,persegiHijau,294,250,124,125,167,98,164,94,3,4,True,0.4155118974861839
2025-01-08 18:21:16,persegiHijau,277,240,127,129,44,2,45,2,1,0,False,0.2961618205622959
2025-01-08 18:21:16,persegiHijau,278,241,129,127,169,16,171,16,2,0,True,0.2564209147055679
2025-01-08 18:21:16,Fail to pick,278,241,0,0,0,0,0,0,0,0,False,0
2025-01-08 18:21:16,persegiHijau,277,241,131,127,172,94,176,90,4,4,True,0.10542920331638772
2025-01-08 18:21:16,Fail to pick,277,241,0,0,0,0,0,0,0,0,False,0
2025-01-08 18:21:16,persegiHijau,281,245,126,123,14,17,17,16,3,1,True,0.4527786476773944
2025-01-08 18:21:16,Fail to pick,281,245,0,0,0,0,0,0,0,0,False,0
2025-01-08 18:21:16,persegiHijau,277,240,131,125,46,94,49,90,3,4,False,0.33679095716720187
2025-01-08 18:21:16,Fail to pick,277,240,0,0,0,0,0,0,0,0,False,0
2025-01-08 18:21:16,persegiHijau,277,240,131,126,133,16,130,12,3,4,True,0.12147837467591667
2025-01-08 18:21:16,Fail to pick,277,240,0,0,0,0,0,0,0,0,False,0
2025-01-08 18:21:16,persegiHijau,280,241,125,123,157,63,159,64,2,1,True,0.1539021791592543
2025-01-08 18:21:16,Fail to pick,280,241,0,0,0,0,0,0,0,0,False,0
2025-01-08 18:21:16,persegiHijau,277,241,129,124,103,18,100,18,3,0,True,0.3015629356232883
2025-01-08 18:21:16,Hijau,277,241,tensor(129.7352),tensor(124.6351),133,25,137,24,4,1,True,0.0004994869232177734
2025-01-08 18:21:16,Fail to pick,277,241,0,0,0,0,0,0,0,0,False,0
2025-01-08 18:21:17,persegiHijau,279,241,130,124,105,75,108,77,3,2,True,0.24577189820356163
2025-01-08 18:21:17,Fail to pick,279,241,0,0,0,0,0,0,0,0,False,0
2025-01-08 18:21:17,persegiHijau,278,242,127,124,128,52,130,53,2,1,True,0.3099529540747953
2025-01-08 18:21:17,Fail to pick,278,242,0,0,0,0,0,0,0,0,False,0
2025-01-08 18:21:17,persegiHijau,296,250,128,122,166,52,161,55,5,3,True,0.3784451493999538
2025-01-08 18:21:32,persegiHijau,215,430,121,126,186,65,181,66,5,1,True,0.2198021843389576
2025-01-08 18:21:32,Hijau,215,430,tensor(121.5095),tensor(126.7581),80,19,80,20,0,1,True,0.0004968643188476562
2025-01-08 18:21:32,persegiHijau,234,408,123,127,16,21,18,21,2,0,True,0.35630902479518334
2025-01-08 18:21:32,persegiHijau,242,400,126,116,19,13,18,8,1,5,True,0.21307392732928992
2025-01-08 18:21:32,Fail to pick,242,400,0,0,0,0,0,0,0,0,False,0
2025-01-08 18:21:32,persegiHijau,239,403,123,115,15,49,11,47,4,2,True,0.2233338348862872
2025-01-08 18:21:32,Fail to pick,239,403,0,0,0,0,0,0,0,0,False,0
2025-01-08 18:21:33,persegiHijau,243,402,126,116,174,99,171,94,3,5,False,0.12406510498566142
2025-01-08 18:21:33,Fail to pick,243,402,0,0,0,0,0,0,0,0,False,0
2025-01-08 18:21:33,persegiHijau,243,399,129,117,165,63,166,60,1,3,False,0.4597513723156149
2025-01-08 18:21:33,Fail to pick,243,399,0,0,0,0,0,0,0,0,False,0
2025-01-08 18:21:33,persegiHijau,241,402,125,116,193,23,190,20,3,3,True,0.28127790836023847
2025-01-08 18:21:33,Fail to pick,241,402,0,0,0,0,0,0,0,0,False,0
2025-01-08 18:21:33,persegiHijau,242,402,125,114,15,8,17,10,2,2,True,0.26341218095734453
2025-01-08 18:21:33,Fail to pick,242,402,0,0,0,0,0,0,0,0,False,0
2025-01-08 18:21:33,persegiHijau,244,405,127,118,194,8,190,6,4,2,False,0.20105663111249705
2025-01-08 18:21:33,Fail to pick,244,405,0,0,0,0,0,0,0,0,False,0
2025-01-08 18:21:33,persegiHijau,244,403,129,119,134,7,136,7,2,0,True,0.20923427664264663
2025-01-08 18:21:33,Fail to pick,244,403,0,0,0,0,0,0,0,0,False,0
2025-01-08 18:21:33,persegiHijau,241,404,123,117,91,1,86,1,5,0,True,0.2759204326039759
2025-01-08 18:21:33,Fail to pick,241,404,0,0,0,0,0,0,0,0,False,0
2025-01-08 18:21:33,persegiHijau,241,399,125,117,158,22,154,24,4,2,True,0.2628177083222957
2025-01-08 18:21:33,Hijau,241,399,tensor(125.9785),tensor(117.6478),89,22,93,21,4,1,True,0.0
2025-01-08 18:21:33,Fail to pick,241,399,0,0,0,0,0,0,0,0,False,0
2025-01-08 18:21:33,persegiHijau,243,403,128,113,139,27,138,24,1,3,True,0.23888496593810948
2025-01-08 18:21:33,Fail to pick,243,403,0,0,0,0,0,0,0,0,False,0
2025-01-08 18:21:33,persegiHijau,239,403,122,115,55,32,57,31,2,1,True,0.2592946350018669
2025-01-08 18:21:33,Fail to pick,239,403,0,0,0,0,0,0,0,0,False,0
2025-01-08 18:21:34,persegiHijau,217,390,122,117,169,51,172,49,3,2,True,0.3875808720558537
2025-01-08 18:21:34,persegiHijau,232,406,123,116,80,64,76,59,4,5,True,0.4190769953517598
2025-01-08 18:21:34,persegiHijau,233,407,124,114,175,72,170,70,5,2,True,0.3145911863491675
2025-01-08 18:21:34,Fail to pick,233,407,0,0,0,0,0,0,0,0,False,0
2025-01-08 18:21:34,persegiHijau,232,409,126,113,118,31,120,28,2,3,True,0.37291254878058444
2025-01-08 18:21:34,Fail to pick,232,409,0,0,0,0,0,0,0,0,False,0
2025-01-08 18:21:34,persegiHijau,232,410,126,116,24,21,23,17,1,4,True,0.29566286499531824
2025-01-08 18:21:34,Fail to pick,232,410,0,0,0,0,0,0,0,0,False,0
2025-01-08 18:21:34,persegiHijau,227,408,124,114,6,21,5,24,1,3,True,0.24113719688721985
2025-01-08 18:21:34,Fail to pick,227,408,0,0,0,0,0,0,0,0,False,0
2025-01-08 18:21:34,persegiHijau,203,402,123,118,182,35,179,37,3,2,True,0.19700402939770695
2025-01-08 18:21:42,persegiHijau,473,502,117,121,132,20,135,24,3,4,True,0.1869777622363673
2025-01-08 18:21:42,Hijau,473,502,tensor(117.6799),tensor(121.1494),60,43,57,42,3,1,True,0.0
2025-01-08 18:21:43,persegiHijau,497,518,121,121,146,31,147,31,1,0,False,0.10098459674470406
2025-01-08 18:21:43,persegiHijau,504,492,116,113,190,86,190,85,0,1,False,0.2817223082050946
2025-01-08 18:21:43,persegiHijau,508,488,118,119,154,30,155,31,1,1,True,0.1758823923661879
2025-01-08 18:21:43,Fail to pick,508,488,0,0,0,0,0,0,0,0,False,0
2025-01-08 18:21:43,persegiHijau,512,486,118,118,54,46,49,49,5,3,True,0.1023253858346453
2025-01-08 18:21:43,Fail to pick,512,486,0,0,0,0,0,0,0,0,False,0
2025-01-08 18:21:43,persegiHijau,512,482,118,114,70,20,71,16,1,4,True,0.14355490595666784
2025-01-08 18:21:43,Fail to pick,512,482,0,0,0,0,0,0,0,0,False,0
2025-01-08 18:21:43,persegiHijau,528,476,122,112,138,26,140,30,2,4,True,0.11597701778886221
2025-01-08 18:21:43,persegiHijau,504,457,116,116,140,68,139,70,1,2,True,0.2154938713057799
2025-01-08 18:21:43,persegiHijau,519,478,120,114,43,74,46,73,3,1,True,0.20318306972079286
2025-01-08 18:21:43,persegiHijau,518,477,119,112,151,37,154,36,3,1,True,0.2841478776961044
2025-01-08 18:21:43,Fail to pick,518,477,0,0,0,0,0,0,0,0,False,0
2025-01-08 18:21:44,persegiHijau,523,473,122,112,85,6,82,9,3,3,True,0.3958010410545406
2025-01-08 18:21:44,Hijau,523,473,tensor(122.0842),tensor(112.3157),68,48,72,52,4,4,True,0.0
2025-01-08 18:21:44,Fail to pick,523,473,0,0,0,0,0,0,0,0,False,0
2025-01-08 18:21:44,persegiHijau,518,478,121,112,18,35,18,33,0,2,True,0.3659213335638333
2025-01-08 18:21:44,Fail to pick,518,478,0,0,0,0,0,0,0,0,False,0
2025-01-08 18:21:44,persegiHijau,525,478,124,110,92,70,90,71,2,1,True,0.20515782174969105
2025-01-08 18:21:44,Fail to pick,525,478,0,0,0,0,0,0,0,0,False,0
2025-01-08 18:21:44,persegiHijau,532,476,123,115,161,48,158,44,3,4,True,0.11231142315342507
2025-01-08 18:21:44,Fail to pick,532,476,0,0,0,0,0,0,0,0,False,0
2025-01-08 18:21:44,persegiHijau,530,472,123,112,100,16,95,13,5,3,True,0.4025959662821613
2025-01-08 18:21:44,Fail to pick,530,472,0,0,0,0,0,0,0,0,False,0
2025-01-08 18:21:44,persegiHijau,526,470,121,111,88,44,89,42,1,2,True,0.3634027726986745
2025-01-08 18:21:44,Fail to pick,526,470,0,0,0,0,0,0,0,0,False,0
2025-01-08 18:21:44,persegiHijau,518,480,120,109,91,49,92,44,1,5,False,0.28633259865734045
2025-01-08 18:21:44,persegiHijau,532,472,121,110,153,25,155,25,2,0,True,0.1140916888278635
2025-01-08 18:21:44,persegiHijau,520,476,120,111,173,52,176,47,3,5,True,0.4573216372906057
2025-01-08 18:21:44,persegiHijau,534,473,123,111,120,15,116,10,4,5,True,0.14391475643431617
2025-01-08 18:21:45,persegiHijau,534,477,123,109,99,18,101,18,2,0,False,0.341202409128617
2025-01-08 18:21:45,Fail to pick,534,477,0,0,0,0,0,0,0,0,False,0
2025-01-08 18:21:45,persegiHijau,525,477,125,111,137,86,135,83,2,3,True,0.2633239203785114
2025-01-08 18:21:45,Hijau,525,477,tensor(125.2167),tensor(111.4129),67,48,62,49,5,1,True,0.0
2025-01-08 18:21:45,Fail to pick,525,477,0,0,0,0,0,0,0,0,False,0
2025-01-08 18:21:45,persegiHijau,528,476,124,110,78,90,82,92,4,2,False,0.3125416032910159
2025-01-08 18:21:45,Fail to pick,528,476,0,0,0,0,0,0,0,0,False,0
2025-01-08 18:21:45,persegiHijau,525,479,124,111,155,66,152,70,3,4,True,0.31170005930734046
2025-01-08 18:21:45,Fail to pick,525,479,0,0,0,0,0,0,0,0,False,0
2025-01-08 18:21:45,persegiHijau,523,481,123,111,32,13,29,16,3,3,True,0.2178525332670346
2025-01-08 18:21:45,Fail to pick,523,481,0,0,0,0,0,0,0,0,False,0
2025-01-08 18:22:11,persegiHijau,339,190,132,142,31,64,31,65,0,1,True,0.40717989587481607
2025-01-08 18:22:11,Hijau,339,190,tensor(132.7611),tensor(142.1265),147,31,147,30,0,1,True,0.0
2025-01-08 18:22:11,persegiHijau,333,182,132,139,53,90,50,86,3,4,True,0.33010770773293974
2025-01-08 18:22:11,Fail to pick,333,182,0,0,0,0,0,0,0,0,False,0
2025-01-08 18:22:11,persegiHijau,359,175,125,140,81,23,84,26,3,3,True,0.2130545032606047
2025-01-08 18:22:11,persegiHijau,373,142,120,136,113,0,111,-4,2,4,True,0.45609986999818775
2025-01-08 18:22:11,persegiHijau,391,161,120,138,56,61,56,59,0,2,True,0.31962636650288856
2025-01-08 18:22:11,persegiHijau,350,180,128,145,171,55,169,59,2,4,True,0.35983947874945443
2025-01-08 18:22:11,persegiHijau,402,162,121,136,197,86,194,85,3,1,True,0.3805284012005905
2025-01-08 18:22:11,persegiHijau,385,138,119,133,73,68,76,67,3,1,True,0.4808779366448952
2025-01-08 18:22:11,persegiHijau,322,183,128,137,93,77,88,72,5,5,True,0.25570625124023294
2025-01-08 18:22:12,persegiHijau,381,171,118,136,18,27,15,27,3,0,True,0.2719596180194176
2025-01-08 18:22:12,persegiHijau,341,182,127,141,70,77,72,79,2,2,False,0.3979016124535606
2025-01-08 18:22:15,persegiBiru,838,306,127,122,127,73,125,73,2,0,True,0.2341319897734978
2025-01-08 18:22:15,Biru,838,306,tensor(127.9510),tensor(122.2718),115,77,112,73,3,4,True,0.0004987716674804688
2025-01-08 18:22:15,persegiBiru,824,306,128,120,166,68,163,68,3,0,True,0.35517996436507393
2025-01-08 18:22:15,persegiBiru,824,281,124,116,45,60,49,60,4,0,True,0.2903527129295334
2025-01-08 18:22:15,persegiBiru,766,234,123,130,24,36,24,39,0,3,True,0.4870873578635375
2025-01-08 18:22:15,persegiBiru,815,276,127,114,181,38,180,36,1,2,True,0.48587167406408316
2025-01-08 18:22:15,persegiBiru,818,273,127,115,183,84,183,88,0,4,True,0.4427138054539841
2025-01-08 18:22:15,Fail to pick,818,273,0,0,0,0,0,0,0,0,False,0
2025-01-08 18:22:15,persegiBiru,811,264,128,120,160,23,158,20,2,3,True,0.3726798805427912
2025-01-08 18:22:15,Fail to pick,811,264,0,0,0,0,0,0,0,0,False,0
2025-01-08 18:22:16,persegiBiru,830,302,124,124,41,26,43,30,2,4,True,0.13901968642791007
2025-01-08 18:22:16,persegiBiru,799,282,124,124,149,99,152,95,3,4,True,0.4774362586100074
2025-01-08 18:22:16,persegiBiru,830,306,128,124,54,18,49,14,5,4,True,0.48983786614646974
2025-01-08 18:22:17,persegiBiru,811,285,121,126,28,9,28,11,0,2,True,0.29287869985483633
2025-01-08 18:22:17,persegiBiru,813,276,123,124,124,64,127,67,3,3,True,0.26650688662116373
2025-01-08 18:22:17,Fail to pick,813,276,0,0,0,0,0,0,0,0,False,0
2025-01-08 18:22:18,persegiBiru,815,267,125,112,137,55,136,53,1,2,True,0.39393198384642314
2025-01-08 18:22:18,Fail to pick,815,267,0,0,0,0,0,0,0,0,False,0
2025-01-08 18:22:18,persegiBiru,749,244,118,122,150,44,150,47,0,3,True,0.24947745260291596
2025-01-08 18:22:18,persegiBiru,813,270,126,114,169,0,164,-4,5,4,False,0.48446756858143136
2025-01-08 18:22:18,persegiBiru,808,271,126,118,115,25,117,28,2,3,True,0.16622680120525085
2025-01-08 18:22:18,Fail to pick,808,271,0,0,0,0,0,0,0,0,False,0
2025-01-08 18:22:18,persegiBiru,816,268,127,114,126,43,124,39,2,4,True,0.2864036405048497
2025-01-08 18:22:18,Fail to pick,816,268,0,0,0,0,0,0,0,0,False,0
2025-01-08 18:22:18,persegiBiru,809,271,128,116,122,12,122,15,0,3,True,0.25691653608534504
2025-01-08 18:22:18,Fail to pick,809,271,0,0,0,0,0,0,0,0,False,0
2025-01-08 18:22:18,persegiBiru,814,267,124,114,93,35,93,36,0,1,False,0.3768667821134307
2025-01-08 18:22:18,Fail to pick,814,267,0,0,0,0,0,0,0,0,False,0
2025-01-08 18:22:18,persegiBiru,769,225,129,125,95,94,95,91,0,3,False,0.41706106453345904
2025-01-08 18:22:18,Biru,769,225,tensor(129.0023),tensor(125.1884),137,71,136,66,1,5,True,0.0
2025-01-08 18:22:18,persegiBiru,821,268,127,115,74,76,69,77,5,1,True,0.1677941862653436
2025-01-08 18:22:18,persegiBiru,772,234,128,118,19,28,17,25,2,3,True,0.3348970219605849
2025-01-08 18:22:19,persegiBiru,815,266,125,116,185,42,187,38,2,4,True,0.2288615454268571
2025-01-08 18:22:19,persegiBiru,815,266,125,116,138,53,133,52,5,1,True,0.2882070978578593
2025-01-08 18:22:19,Fail to pick,815,266,0,0,0,0,0,0,0,0,False,0
2025-01-08 18:22:19,persegiBiru,816,262,126,116,192,94,189,90,3,4,True,0.3056054351390048
2025-01-08 18:22:19,Fail to pick,816,262,0,0,0,0,0,0,0,0,False,0
2025-01-08 18:22:19,persegiBiru,808,269,126,117,128,51,128,51,0,0,True,0.2782599368436204
2025-01-08 18:22:19,Fail to pick,808,269,0,0,0,0,0,0,0,0,False,0
2025-01-08 18:22:19,persegiBiru,806,271,125,119,60,92,64,90,4,2,True,0.4902078179328815
2025-01-08 18:22:19,Fail to pick,806,271,0,0,0,0,0,0,0,0,False,0
2025-01-08 18:22:19,persegiBiru,772,234,128,127,8,24,4,25,4,1,True,0.37639019525142603
2025-01-08 18:22:19,persegiBiru,814,268,125,118,79,54,78,49,1,5,True,0.49204243680993887
2025-01-08 18:22:19,persegiBiru,817,265,129,121,5,35,0,32,5,3,True,0.13232718835382778
2025-01-08 18:22:19,Fail to pick,817,265,0,0,0,0,0,0,0,0,False,0
2025-01-08 18:22:19,persegiBiru,816,268,127,116,4,90,6,89,2,1,True,0.2770958680959691
2025-01-08 18:22:19,Fail to pick,816,268,0,0,0,0,0,0,0,0,False,0
2025-01-08 18:22:19,persegiBiru,819,262,123,118,125,77,124,74,1,3,True,0.1694585845599486
2025-01-08 18:22:19,Fail to pick,819,262,0,0,0,0,0,0,0,0,False,0
2025-01-08 18:22:20,persegiBiru,807,270,126,118,165,36,164,31,1,5,True,0.29838417441037013
2025-01-08 18:22:20,persegiBiru,813,261,126,120,93,25,91,20,2,5,True,0.36124123762937776
2025-01-08 18:22:20,Fail to pick,813,261,0,0,0,0,0,0,0,0,False,0
2025-01-08 18:22:20,persegiBiru,810,267,125,119,122,91,117,87,5,4,True,0.34983537806675785
2025-01-08 18:22:20,Fail to pick,810,267,0,0,0,0,0,0,0,0,False,0
2025-01-08 18:22:20,persegiBiru,813,269,127,123,59,40,59,39,0,1,True,0.3575532521859496
2025-01-08 18:22:20,Fail to pick,813,269,0,0,0,0,0,0,0,0,False,0
2025-01-08 18:22:20,persegiBiru,813,264,126,124,93,15,97,16,4,1,True,0.2938238110073397
2025-01-08 18:22:20,Fail to pick,813,264,0,0,0,0,0,0,0,0,False,0
2025-01-08 18:22:20,persegiBiru,819,263,126,119,155,81,151,80,4,1,True,0.4576316482536098
2025-01-08 18:22:20,Fail to pick,819,263,0,0,0,0,0,0,0,0,False,0
2025-01-08 18:22:20,persegiBiru,813,268,124,121,89,93,88,89,1,4,True,0.45574500970188525
2025-01-08 18:22:20,Fail to pick,813,268,0,0,0,0,0,0,0,0,False,0
2025-01-08 18:22:20,persegiBiru,813,268,124,121,110,4,110,3,0,1,True,0.3609752992764924
2025-01-08 18:22:20,Fail to pick,813,268,0,0,0,0,0,0,0,0,False,0
2025-01-08 18:22:20,persegiBiru,816,260,126,123,56,41,56,37,0,4,True,0.48499478350321135
2025-01-08 18:22:20,Fail to pick,816,260,0,0,0,0,0,0,0,0,False,0
2025-01-08 18:22:21,persegiBiru,815,266,124,120,2,51,4,52,2,1,True,0.4545780961436411
2025-01-08 18:22:21,Fail to pick,815,266,0,0,0,0,0,0,0,0,False,0
2025-01-08 18:22:21,persegiBiru,820,270,123,118,70,45,72,49,2,4,True,0.42279424255619114
2025-01-08 18:22:21,Fail to pick,820,270,0,0,0,0,0,0,0,0,False,0
2025-01-08 18:22:21,persegiBiru,802,255,126,117,54,91,56,87,2,4,True,0.1843782380171163
2025-01-08 18:22:22,persegiBiru,770,245,137,134,40,43,35,39,5,4,True,0.15432545409102472
2025-01-08 18:57:32,persegiBiru,776,285,122,121,199,67,197,66,2,1,True,0.2640251384095992
2025-01-08 18:57:32,persegiBiru,778,296,121,114,4,53,3,57,1,4,True,0.33025235599777114
2025-01-08 18:57:32,Biru,778,296,tensor(121.1235),tensor(114.3123),117,72,118,67,1,5,True,0.0004982948303222656
2025-01-08 18:57:32,persegiBiru,771,286,121,115,97,3,94,7,3,4,False,0.33642346814197893
2025-01-08 18:57:32,persegiBiru,801,317,124,113,185,56,185,56,0,0,False,0.22568374824053894
2025-01-08 18:57:32,persegiBiru,770,288,121,118,33,68,37,63,4,5,False,0.2747531292949572
2025-01-08 18:57:32,persegiBiru,804,311,124,117,132,89,132,90,0,1,True,0.35705721080250796
2025-01-08 18:57:33,persegiBiru,813,309,123,115,30,74,33,71,3,3,False,0.33459037395689906
2025-01-08 18:57:33,Fail to pick,813,309,0,0,0,0,0,0,0,0,False,0
2025-01-08 18:57:33,persegiBiru,779,295,122,116,19,87,16,86,3,1,True,0.2909003236953698
2025-01-08 18:57:33,Biru,779,295,tensor(122.7524),tensor(116.3703),118,72,115,70,3,2,True,0.0004994869232177734
2025-01-08 18:57:33,persegiBiru,779,297,121,118,107,8,110,6,3,2,True,0.20397905464752641
2025-01-08 18:57:33,Fail to pick,779,297,0,0,0,0,0,0,0,0,False,0
2025-01-08 18:57:33,persegiBiru,779,297,119,118,26,16,30,15,4,1,True,0.36196752404907195
2025-01-08 18:57:33,Fail to pick,779,297,0,0,0,0,0,0,0,0,False,0
2025-01-08 18:57:33,persegiBiru,797,321,125,118,155,31,157,32,2,1,True,0.33263654416125665
2025-01-08 18:57:33,persegiBiru,799,318,124,114,186,39,187,42,1,3,True,0.4607381136432387
2025-01-08 18:57:33,Fail to pick,799,318,0,0,0,0,0,0,0,0,False,0
2025-01-08 18:57:33,persegiBiru,807,317,121,111,170,93,173,88,3,5,True,0.330341444240049
2025-01-08 18:57:33,Fail to pick,807,317,0,0,0,0,0,0,0,0,False,0
2025-01-08 18:57:34,persegiBiru,790,309,125,112,183,41,181,40,2,1,False,0.13247828650976864
2025-01-08 18:57:34,persegiBiru,779,294,120,113,165,41,169,40,4,1,True,0.3911096419429251
2025-01-08 18:57:34,persegiBiru,802,316,122,111,45,15,45,16,0,1,True,0.12879915242183096
2025-01-08 18:57:34,persegiBiru,804,319,123,109,141,50,139,47,2,3,True,0.2517531201757999
2025-01-08 18:57:34,Fail to pick,804,319,0,0,0,0,0,0,0,0,False,0
2025-01-08 18:57:34,persegiBiru,842,298,115,117,94,60,98,55,4,5,True,0.49522745939362045
2025-01-08 18:57:34,Biru,842,298,tensor(115.8212),tensor(117.5737),117,77,114,80,3,3,True,0.0005044937133789062
2025-01-08 18:57:40,persegiBiru,796,312,135,122,4,18,5,21,1,3,True,0.463765265712896
2025-01-08 18:57:40,Biru,796,312,tensor(135.4067),tensor(122.0041),113,73,117,68,4,5,True,0.0
2025-01-08 18:57:40,persegiBiru,799,317,134,124,86,24,83,28,3,4,True,0.29936845893763536
2025-01-08 18:57:40,Fail to pick,799,317,0,0,0,0,0,0,0,0,False,0
2025-01-08 18:57:40,persegiBiru,799,317,137,124,14,69,13,70,1,1,True,0.4554392093991505
2025-01-08 18:57:40,Fail to pick,799,317,0,0,0,0,0,0,0,0,False,0
2025-01-08 18:57:40,persegiBiru,783,354,139,124,139,38,141,41,2,3,True,0.2410912946687055
2025-01-08 18:57:40,persegiBiru,772,337,137,130,173,65,172,62,1,3,True,0.12471924050200336
2025-01-08 18:57:40,persegiBiru,732,296,143,138,49,71,49,66,0,5,True,0.40106195883851303
2025-01-08 18:57:40,persegiBiru,732,304,141,134,17,26,21,24,4,2,True,0.32292741088903143
2025-01-08 18:57:40,Fail to pick,732,304,0,0,0,0,0,0,0,0,False,0
2025-01-08 18:57:40,persegiBiru,782,330,138,124,162,65,162,63,0,2,True,0.10684858023437856
2025-01-08 18:57:40,persegiBiru,776,338,136,125,100,63,97,65,3,2,True,0.29793615915437366
2025-01-08 18:57:40,Fail to pick,776,338,0,0,0,0,0,0,0,0,False,0
2025-01-08 18:57:41,persegiBiru,776,336,137,128,58,48,54,51,4,3,True,0.24710926351777718
2025-01-08 18:57:41,Biru,776,336,tensor(137.1955),tensor(128.3192),106,71,102,72,4,1,True,0.0004994869232177734
2025-01-08 18:57:41,Fail to pick,776,336,0,0,0,0,0,0,0,0,False,0
2025-01-08 18:57:41,persegiBiru,779,335,138,125,57,49,54,53,3,4,False,0.39575512718400974
2025-01-08 18:57:41,Fail to pick,779,335,0,0,0,0,0,0,0,0,False,0
2025-01-08 18:57:41,persegiBiru,775,333,135,128,23,13,23,10,0,3,True,0.45069736224235435
2025-01-08 18:57:41,Fail to pick,775,333,0,0,0,0,0,0,0,0,False,0
2025-01-08 18:57:42,persegiBiru,789,331,138,126,75,47,77,49,2,2,True,0.11298023440940318
2025-01-08 18:57:42,persegiBiru,794,326,136,123,182,46,182,50,0,4,True,0.13013735501254353
2025-01-08 18:57:42,Biru,794,326,tensor(136.9636),tensor(123.7068),109,73,111,71,2,2,True,0.0
2025-01-08 18:57:42,Fail to pick,794,326,0,0,0,0,0,0,0,0,False,0
2025-01-08 18:57:42,persegiBiru,747,275,138,133,176,80,176,79,0,1,True,0.4834181376468356
2025-01-08 18:57:42,persegiBiru,800,316,134,123,11,57,9,58,2,1,True,0.1179831684837168
2025-01-08 18:57:42,persegiBiru,742,284,136,129,128,82,123,79,5,3,True,0.37988509225886125
2025-01-08 18:57:42,persegiBiru,792,312,138,125,175,0,175,-1,0,1,True,0.1470316360206023
2025-01-08 18:57:42,persegiBiru,798,317,136,126,6,12,10,10,4,2,True,0.45184196637489626
2025-01-08 18:57:42,Fail to pick,798,317,0,0,0,0,0,0,0,0,False,0
2025-01-08 18:57:42,persegiBiru,796,315,137,124,171,29,169,26,2,3,True,0.31060113242869225
2025-01-08 18:57:42,Fail to pick,796,315,0,0,0,0,0,0,0,0,False,0
2025-01-08 18:57:42,persegiBiru,796,317,134,124,180,20,183,18,3,2,True,0.4989916832831174
2025-01-08 18:57:42,Fail to pick,796,317,0,0,0,0,0,0,0,0,False,0
2025-01-08 18:57:43,persegiBiru,787,323,138,122,52,64,49,61,3,3,True,0.28738463004261583
2025-01-08 18:57:43,Fail to pick,787,323,0,0,0,0,0,0,0,0,False,0
2025-01-08 18:57:43,persegiBiru,796,319,135,124,154,95,157,93,3,2,True,0.4678211553094348
2025-01-08 18:57:43,Fail to pick,796,319,0,0,0,0,0,0,0,0,False,0
2025-01-08 18:57:43,persegiBiru,800,322,135,125,47,87,43,85,4,2,True,0.25672926761518955
2025-01-08 18:57:43,Biru,800,322,tensor(135.1986),tensor(125.3212),110,74,107,75,3,1,True,0.0
2025-01-08 18:57:43,Fail to pick,800,322,0,0,0,0,0,0,0,0,False,0
2025-01-08 18:57:43,persegiBiru,787,319,137,129,25,37,24,39,1,2,True,0.11018424040690702
2025-01-08 18:57:43,persegiBiru,787,320,135,124,131,94,128,94,3,0,True,0.4226538640500689
2025-01-08 18:57:43,Fail to pick,787,320,0,0,0,0,0,0,0,0,False,0
2025-01-08 18:57:43,persegiBiru,794,316,137,125,177,65,175,62,2,3,True,0.2860482193430358
2025-01-08 18:57:43,Fail to pick,794,316,0,0,0,0,0,0,0,0,False,0
2025-01-08 18:57:43,persegiBiru,795,317,135,123,33,55,30,54,3,1,True,0.36998582775362343
2025-01-08 18:57:43,Fail to pick,795,317,0,0,0,0,0,0,0,0,False,0
2025-01-08 18:57:43,persegiBiru,789,316,141,133,45,20,46,23,1,3,False,0.18053775559574123
2025-01-08 18:57:43,Fail to pick,789,316,0,0,0,0,0,0,0,0,False,0
2025-01-08 18:57:43,persegiBiru,811,325,138,120,94,19,98,17,4,2,True,0.4120560485303063
2025-01-08 18:57:44,persegiBiru,797,320,134,123,48,84,47,83,1,1,True,0.11869497245260363
2025-01-08 18:57:44,persegiBiru,795,313,137,129,135,4,132,6,3,2,True,0.2614008280821925
2025-01-08 18:57:44,Fail to pick,795,313,0,0,0,0,0,0,0,0,False,0
2025-01-08 18:57:44,persegiBiru,795,318,136,125,36,21,35,23,1,2,True,0.38247449305054115
2025-01-08 18:57:44,Fail to pick,795,318,0,0,0,0,0,0,0,0,False,0
2025-01-08 18:57:44,persegiBiru,794,319,132,125,101,50,100,49,1,1,True,0.39173113193690035
2025-01-08 18:57:44,Biru,794,319,tensor(132.6484),tensor(125.9137),111,73,114,72,3,1,True,0.0004987716674804688
2025-01-08 18:57:44,Fail to pick,794,319,0,0,0,0,0,0,0,0,False,0
2025-01-08 18:57:44,persegiBiru,794,315,135,129,60,48,58,47,2,1,True,0.4081886400500999
2025-01-08 18:57:44,Fail to pick,794,315,0,0,0,0,0,0,0,0,False,0
2025-01-08 18:57:44,persegiBiru,736,291,137,131,191,31,193,28,2,3,True,0.4759343530330761
2025-01-08 18:57:44,persegiBiru,747,287,135,127,37,46,41,47,4,1,True,0.21671552840416985
2025-01-08 18:57:44,persegiBiru,754,289,134,126,142,59,145,55,3,4,True,0.3761833757147539
2025-01-08 18:57:44,Fail to pick,754,289,0,0,0,0,0,0,0,0,False,0
2025-01-08 18:57:44,persegiBiru,742,291,133,131,61,12,59,11,2,1,True,0.42961048461706564
2025-01-08 18:57:44,persegiBiru,749,289,132,128,162,92,166,87,4,5,True,0.1060106530962556
2025-01-08 18:57:44,Fail to pick,749,289,0,0,0,0,0,0,0,0,False,0
2025-01-08 18:57:45,persegiBiru,754,286,136,130,195,88,199,85,4,3,True,0.4284165342910634
2025-01-08 18:57:45,Fail to pick,754,286,0,0,0,0,0,0,0,0,False,0
2025-01-08 18:57:45,persegiBiru,753,292,130,124,24,39,23,38,1,1,True,0.3772737174332679
2025-01-08 18:57:45,Fail to pick,753,292,0,0,0,0,0,0,0,0,False,0
2025-01-08 18:57:45,persegiBiru,788,332,136,121,8,11,9,7,1,4,True,0.26469789841057195
2025-01-08 18:57:45,Biru,788,332,tensor(136.0087),tensor(121.2173),107,72,109,72,2,0,True,0.0004987716674804688
2025-01-08 18:57:45,persegiBiru,738,293,133,126,92,39,89,34,3,5,True,0.48102964929656045
2025-01-08 18:57:45,persegiBiru,746,293,129,126,77,36,74,39,3,3,True,0.25090704521377005
2025-01-08 18:57:45,Fail to pick,746,293,0,0,0,0,0,0,0,0,False,0
2025-01-08 18:57:45,persegiBiru,780,320,134,124,128,83,129,79,1,4,True,0.10727467003598329
2025-01-08 18:57:45,persegiBiru,741,292,135,130,45,57,47,60,2,3,True,0.3140748628799737
2025-01-08 18:57:46,persegiBiru,758,292,135,131,116,10,112,10,4,0,True,0.36866778088378394
2025-01-08 18:57:46,Biru,758,292,tensor(135.3312),tensor(131.9745),118,70,115,70,3,0,True,0.0
2025-01-08 18:57:46,persegiBiru,795,321,133,123,168,49,169,52,1,3,True,0.2782401979445682
2025-01-08 18:57:46,persegiBiru,794,328,135,121,2,98,2,101,0,3,True,0.41110406043585457
2025-01-08 18:57:46,Fail to pick,794,328,0,0,0,0,0,0,0,0,False,0
2025-01-08 18:57:46,persegiBiru,783,322,134,122,138,30,141,27,3,3,True,0.2356399629144641
2025-01-08 18:57:46,persegiBiru,793,319,137,127,143,21,147,17,4,4,True,0.4903442818472171
2025-01-08 18:57:47,persegiBiru,794,320,137,124,155,95,155,97,0,2,True,0.41884193539234804
2025-01-08 18:57:47,Fail to pick,794,320,0,0,0,0,0,0,0,0,False,0
2025-01-08 18:57:47,persegiBiru,796,317,137,123,183,83,185,78,2,5,True,0.2367878616766193
2025-01-08 18:57:47,Fail to pick,796,317,0,0,0,0,0,0,0,0,False,0
2025-01-08 18:57:47,persegiBiru,790,321,140,124,75,47,77,47,2,0,True,0.3909573766668908
2025-01-08 18:57:47,Fail to pick,790,321,0,0,0,0,0,0,0,0,False,0
2025-01-08 18:57:53,persegiBiru,809,333,120,102,86,68,90,64,4,4,True,0.3035915640842952
2025-01-08 18:57:53,Biru,809,333,tensor(120.7637),tensor(102.6468),107,74,111,75,4,1,True,0.0005102157592773438
2025-01-08 18:57:53,persegiBiru,796,333,119,103,5,41,7,38,2,3,True,0.39280055012200055
2025-01-08 18:57:53,persegiBiru,800,333,120,103,129,22,130,17,1,5,True,0.4438731712724604
2025-01-08 18:57:53,Fail to pick,800,333,0,0,0,0,0,0,0,0,False,0
2025-01-08 18:57:53,persegiBiru,797,334,119,102,70,22,73,21,3,1,True,0.3922337225686089
2025-01-08 18:57:53,Fail to pick,797,334,0,0,0,0,0,0,0,0,False,0
2025-01-08 18:57:53,persegiBiru,801,328,121,103,78,56,76,58,2,2,False,0.4179381419358802
2025-01-08 18:57:53,Fail to pick,801,328,0,0,0,0,0,0,0,0,False,0
2025-01-08 18:57:53,persegiBiru,800,333,119,104,31,36,26,32,5,4,True,0.23967697698805412
2025-01-08 18:57:53,Fail to pick,800,333,0,0,0,0,0,0,0,0,False,0
2025-01-08 18:57:53,persegiBiru,800,333,119,105,177,65,181,62,4,3,True,0.4023802154316899
2025-01-08 18:57:53,Fail to pick,800,333,0,0,0,0,0,0,0,0,False,0
2025-01-08 18:57:53,persegiBiru,811,338,121,102,120,64,123,68,3,4,True,0.44232850857740225
2025-01-08 18:57:54,persegiBiru,807,336,119,109,8,16,5,13,3,3,True,0.30825213512964017
2025-01-08 18:57:54,Biru,807,336,tensor(119.9431),tensor(109.6588),106,74,107,76,1,2,True,0.0
2025-01-08 18:57:54,Fail to pick,807,336,0,0,0,0,0,0,0,0,False,0
2025-01-08 18:57:54,persegiBiru,810,328,121,107,104,29,103,27,1,2,True,0.49256589347069346
2025-01-08 18:57:54,Fail to pick,810,328,0,0,0,0,0,0,0,0,False,0
2025-01-08 18:58:06,persegiBiru,263,220,121,111,195,5,198,7,3,2,True,0.3521411472268917
2025-01-08 18:58:06,Biru,263,220,tensor(121.4309),tensor(111.4139),138,24,134,26,4,2,True,0.000499725341796875
2025-01-08 18:58:06,persegiBiru,259,219,124,112,54,22,52,19,2,3,True,0.2361119892386314
2025-01-08 18:58:06,Fail to pick,259,219,0,0,0,0,0,0,0,0,False,0
2025-01-08 18:58:06,persegiBiru,278,228,125,113,139,48,142,52,3,4,True,0.2758940928165936
2025-01-08 18:58:06,persegiBiru,275,230,127,111,62,50,59,53,3,3,True,0.218298930908832
2025-01-08 18:58:06,Fail to pick,275,230,0,0,0,0,0,0,0,0,False,0
2025-01-08 18:58:06,persegiBiru,276,230,126,112,18,95,13,94,5,1,False,0.37272325235689063
2025-01-08 18:58:06,Fail to pick,276,230,0,0,0,0,0,0,0,0,False,0
2025-01-08 18:58:07,persegiBiru,276,227,127,115,63,53,59,51,4,2,True,0.2653626362464232
2025-01-08 18:58:07,Fail to pick,276,227,0,0,0,0,0,0,0,0,False,0
2025-01-08 18:58:07,persegiBiru,281,233,125,109,42,96,37,100,5,4,True,0.4523134466163944
2025-01-08 18:58:07,Fail to pick,281,233,0,0,0,0,0,0,0,0,False,0
2025-01-08 18:58:07,persegiBiru,277,235,123,112,119,82,118,84,1,2,False,0.23312136641618875
2025-01-08 18:58:07,Biru,277,235,tensor(123.4858),tensor(112.3359),134,25,133,27,1,2,True,0.0
2025-01-08 18:58:07,Fail to pick,277,235,0,0,0,0,0,0,0,0,False,0
2025-01-08 18:58:07,persegiBiru,275,236,124,115,38,42,39,37,1,5,True,0.1936218027649158
2025-01-08 18:58:07,Fail to pick,275,236,0,0,0,0,0,0,0,0,False,0
2025-01-08 18:58:07,persegiBiru,277,229,126,112,82,58,84,61,2,3,False,0.2926083049719009
2025-01-08 18:58:07,Fail to pick,277,229,0,0,0,0,0,0,0,0,False,0
2025-01-08 18:58:08,persegiBiru,288,231,125,114,154,84,157,83,3,1,True,0.26278839515474034
2025-01-08 18:58:08,persegiBiru,288,231,125,114,91,58,95,58,4,0,True,0.17336424994632033
2025-01-08 18:58:08,Fail to pick,288,231,0,0,0,0,0,0,0,0,False,0
2025-01-08 18:58:08,persegiBiru,281,224,124,115,111,82,109,84,2,2,True,0.4631732101015624
2025-01-08 18:58:08,Fail to pick,281,224,0,0,0,0,0,0,0,0,False,0
2025-01-08 18:58:08,persegiBiru,291,229,122,116,177,90,172,86,5,4,True,0.22930807624652247
2025-01-08 18:58:08,persegiBiru,281,224,120,116,93,2,89,3,4,1,True,0.2748628522318675
2025-01-08 18:58:08,persegiBiru,288,224,124,116,113,55,109,50,4,5,True,0.3416325633392656
2025-01-08 18:58:08,Fail to pick,288,224,0,0,0,0,0,0,0,0,False,0
2025-01-08 18:58:08,persegiBiru,293,216,123,117,67,17,68,15,1,2,True,0.4233960049661004
2025-01-08 18:58:08,Fail to pick,293,216,0,0,0,0,0,0,0,0,False,0
2025-01-08 18:58:08,persegiBiru,286,218,123,114,91,67,92,71,1,4,True,0.18151162029866164
2025-01-08 18:58:08,Biru,286,218,tensor(123.2868),tensor(114.6929),139,26,143,27,4,1,True,0.0004992485046386719
2025-01-08 18:58:08,Fail to pick,286,218,0,0,0,0,0,0,0,0,False,0
2025-01-08 18:58:08,persegiBiru,286,218,128,114,52,24,50,28,2,4,False,0.4831799738078131
2025-01-08 18:58:08,Fail to pick,286,218,0,0,0,0,0,0,0,0,False,0
2025-01-08 18:58:08,persegiBiru,285,218,125,116,136,69,134,68,2,1,True,0.20593059947767853
2025-01-08 18:58:08,Fail to pick,285,218,0,0,0,0,0,0,0,0,False,0
2025-01-08 18:58:09,persegiBiru,292,224,125,114,126,30,130,31,4,1,True,0.4306812390663737
2025-01-08 18:58:09,Fail to pick,292,224,0,0,0,0,0,0,0,0,False,0
2025-01-08 18:58:09,persegiBiru,290,224,127,111,196,7,197,7,1,0,True,0.2454987984964453
2025-01-08 18:58:09,Fail to pick,290,224,0,0,0,0,0,0,0,0,False,0
2025-01-08 18:58:13,persegiBiru,289,229,131,122,7,96,11,97,4,1,True,0.46384220768753004
2025-01-08 18:58:13,Biru,289,229,tensor(131.4504),tensor(122.4391),136,26,140,30,4,4,True,0.0
2025-01-08 18:58:13,Fail to pick,289,229,0,0,0,0,0,0,0,0,False,0
2025-01-08 18:58:13,persegiBiru,252,202,123,124,111,97,107,92,4,5,True,0.2545980118057002
2025-01-08 18:58:13,persegiBiru,291,227,130,121,125,51,120,54,5,3,True,0.16039329489888945
2025-01-08 18:58:13,persegiBiru,298,225,132,116,119,90,119,88,0,2,True,0.44535136568174105
2025-01-08 18:58:13,Fail to pick,298,225,0,0,0,0,0,0,0,0,False,0
2025-01-08 18:58:13,persegiBiru,288,219,128,117,51,49,49,45,2,4,True,0.28742374615235455
2025-01-08 18:58:13,persegiBiru,291,219,126,116,199,85,194,86,5,1,True,0.15308809790391742
2025-01-08 18:58:13,Fail to pick,291,219,0,0,0,0,0,0,0,0,False,0
2025-01-08 18:58:13,persegiBiru,255,191,120,122,100,85,101,87,1,2,True,0.23293793541468844
2025-01-08 18:58:14,persegiBiru,293,213,129,121,165,3,168,3,3,0,True,0.11091855509814189
2025-01-08 18:58:14,Biru,293,213,tensor(129.9571),tensor(121.7148),140,27,135,23,5,4,True,0.0
2025-01-08 18:58:14,persegiBiru,265,195,123,121,135,62,131,61,4,1,True,0.21932083001103186
2025-01-08 18:58:14,persegiBiru,256,192,127,124,182,25,180,20,2,5,True,0.17996325100154698
2025-01-08 18:58:14,Fail to pick,256,192,0,0,0,0,0,0,0,0,False,0
2025-01-08 18:58:15,persegiBiru,265,195,130,117,61,55,56,55,5,0,True,0.44593572329423636
2025-01-08 18:58:15,Fail to pick,265,195,0,0,0,0,0,0,0,0,False,0
2025-01-08 18:58:15,persegiBiru,269,194,127,117,53,10,56,12,3,2,False,0.17627121163284684
2025-01-08 18:58:15,Fail to pick,269,194,0,0,0,0,0,0,0,0,False,0
2025-01-08 18:58:15,persegiBiru,255,190,127,125,33,9,30,9,3,0,True,0.1379657370960914
2025-01-08 18:58:15,persegiBiru,255,190,127,125,156,9,151,6,5,3,True,0.1667635063718537
2025-01-08 18:58:15,Fail to pick,255,190,0,0,0,0,0,0,0,0,False,0
2025-01-08 18:58:15,persegiBiru,261,187,121,125,130,87,134,86,4,1,True,0.3486728206292542
2025-01-08 18:58:15,Fail to pick,261,187,0,0,0,0,0,0,0,0,False,0
2025-01-08 18:58:15,persegiBiru,262,187,125,122,117,22,118,20,1,2,True,0.3262129163104378
2025-01-08 18:58:15,Biru,262,187,tensor(125.1682),tensor(122.9010),148,24,146,20,2,4,True,0.0
2025-01-08 18:58:15,Fail to pick,262,187,0,0,0,0,0,0,0,0,False,0
2025-01-08 18:58:28,persegiBiru,229,500,128,111,32,71,35,71,3,0,True,0.1961634831397063
2025-01-08 18:58:28,Biru,229,500,tensor(128.9931),tensor(111.5909),61,21,65,17,4,4,True,0.0
2025-01-08 18:58:29,persegiBiru,235,493,127,112,120,21,124,20,4,1,True,0.14751653345612614
2025-01-08 18:58:29,Fail to pick,235,493,0,0,0,0,0,0,0,0,False,0
2025-01-08 18:58:29,persegiBiru,250,507,129,108,6,93,3,92,3,1,True,0.3585567659784886
2025-01-08 18:58:29,persegiBiru,245,504,128,108,22,97,18,95,4,2,False,0.12833391258653104
2025-01-08 18:58:29,Fail to pick,245,504,0,0,0,0,0,0,0,0,False,0
2025-01-08 18:58:29,persegiBiru,252,510,129,109,131,75,130,70,1,5,False,0.26347761568363276
2025-01-08 18:58:29,Fail to pick,252,510,0,0,0,0,0,0,0,0,False,0
2025-01-08 18:58:29,persegiBiru,246,507,130,107,49,11,45,12,4,1,True,0.28131289464569753
2025-01-08 18:58:29,Fail to pick,246,507,0,0,0,0,0,0,0,0,False,0
2025-01-08 18:58:29,persegiBiru,257,509,130,106,33,16,36,17,3,1,True,0.3766613999249562
2025-01-08 18:58:29,persegiBiru,248,505,132,108,128,92,130,88,2,4,True,0.3953128187523838
2025-01-08 18:58:29,Fail to pick,248,505,0,0,0,0,0,0,0,0,False,0
2025-01-08 18:58:29,persegiBiru,224,497,126,111,76,57,76,57,0,0,True,0.43136777966171025
2025-01-08 18:58:29,persegiBiru,224,499,124,110,192,56,191,52,1,4,True,0.1931972297605726
2025-01-08 18:58:29,Fail to pick,224,499,0,0,0,0,0,0,0,0,False,0
2025-01-08 18:58:29,persegiBiru,257,510,131,105,33,38,35,36,2,2,True,0.29473885685385703
2025-01-08 18:58:29,Biru,257,510,tensor(131.7621),tensor(105.6894),58,23,53,21,5,2,True,0.0004992485046386719
2025-01-08 18:58:30,persegiBiru,254,513,131,108,4,61,1,63,3,2,True,0.3476280017527994
2025-01-08 18:58:30,Fail to pick,254,513,0,0,0,0,0,0,0,0,False,0
2025-01-08 18:58:30,persegiBiru,251,512,131,105,17,53,15,49,2,4,True,0.22499543158901308
2025-01-08 18:58:30,Fail to pick,251,512,0,0,0,0,0,0,0,0,False,0
2025-01-08 18:58:30,persegiBiru,250,511,131,109,141,24,137,24,4,0,True,0.36457962497756446
2025-01-08 18:58:30,Fail to pick,250,511,0,0,0,0,0,0,0,0,False,0
2025-01-08 18:58:30,persegiBiru,250,515,132,109,47,54,51,49,4,5,True,0.24240761679512401
2025-01-08 18:58:30,Fail to pick,250,515,0,0,0,0,0,0,0,0,False,0
2025-01-08 18:58:30,persegiBiru,252,512,130,110,186,46,185,42,1,4,True,0.3696524021430433
2025-01-08 18:58:30,Fail to pick,252,512,0,0,0,0,0,0,0,0,False,0
2025-01-08 18:58:30,persegiBiru,249,507,131,108,104,71,106,71,2,0,True,0.4700867491052657
2025-01-08 18:58:30,Fail to pick,249,507,0,0,0,0,0,0,0,0,False,0
2025-01-08 18:58:30,persegiBiru,257,508,132,109,66,34,62,35,4,1,True,0.20538476328325828
2025-01-08 18:58:30,Fail to pick,257,508,0,0,0,0,0,0,0,0,False,0
2025-01-08 18:58:30,persegiBiru,221,500,125,112,9,3,6,-2,3,5,True,0.3041049893515706
2025-01-08 18:58:30,persegiBiru,249,513,129,108,104,92,99,88,5,4,True,0.2732178305904944
2025-01-08 18:58:30,persegiBiru,225,494,127,115,68,88,66,83,2,5,True,0.43306562072725674
2025-01-08 18:58:30,Biru,225,494,tensor(127.9533),tensor(115.3338),62,20,60,23,2,3,True,0.0
2025-01-08 18:58:35,persegiBiru,246,512,129,108,194,8,194,9,0,1,True,0.14997658551996063
2025-01-08 18:58:35,Biru,246,512,tensor(129.4023),tensor(108.5750),57,22,61,24,4,2,True,0.0
2025-01-08 18:58:35,persegiBiru,259,509,130,106,129,23,129,25,0,2,True,0.4105287584963616
2025-01-08 18:58:35,persegiBiru,248,513,130,108,157,92,153,96,4,4,True,0.3976209487211618
2025-01-08 18:58:36,persegiBiru,221,498,127,108,71,45,67,43,4,2,True,0.3316241377378766
2025-01-08 18:58:36,persegiBiru,225,496,127,110,24,8,23,6,1,2,True,0.10973684691187834
2025-01-08 18:58:36,Fail to pick,225,496,0,0,0,0,0,0,0,0,False,0
2025-01-08 18:58:36,persegiBiru,247,510,134,111,78,70,76,74,2,4,True,0.15499697306493038
2025-01-08 18:58:36,persegiBiru,238,512,126,110,14,15,10,17,4,2,True,0.19460296792019594
2025-01-08 18:58:36,Biru,238,512,tensor(126.9612),tensor(110.1705),57,22,58,23,1,1,True,0.0
2025-01-08 18:58:36,Fail to pick,238,512,0,0,0,0,0,0,0,0,False,0
2025-01-08 18:58:38,persegiBiru,825,477,125,109,71,82,74,85,3,3,True,0.44568757745359056
2025-01-08 18:58:38,Biru,825,477,tensor(125.4544),tensor(109.1039),67,76,65,77,2,1,True,0.0
2025-01-08 18:58:38,persegiBiru,855,500,120,102,188,39,190,36,2,3,True,0.13997926515976494
2025-01-08 18:58:38,persegiBiru,817,478,122,109,43,64,40,67,3,3,True,0.3265598173113898
2025-01-08 18:58:38,persegiBiru,819,478,121,105,27,91,30,90,3,1,True,0.47630219739001656
2025-01-08 18:58:38,Fail to pick,819,478,0,0,0,0,0,0,0,0,False,0
2025-01-08 18:58:39,persegiBiru,860,501,118,102,9,29,6,31,3,2,True,0.31265874007473016
2025-01-08 18:58:39,Biru,860,501,tensor(118.1067),tensor(102.1261),60,79,57,77,3,2,True,0.0003197193145751953
2025-01-08 18:58:39,persegiBiru,855,494,121,104,38,12,42,8,4,4,True,0.4553652349568853
2025-01-08 18:58:39,Fail to pick,855,494,0,0,0,0,0,0,0,0,False,0
2025-01-08 18:58:39,persegiBiru,856,495,120,98,170,26,169,24,1,2,True,0.32825686253833264
2025-01-08 18:58:39,Fail to pick,856,495,0,0,0,0,0,0,0,0,False,0
2025-01-08 18:58:57,persegiBiru,663,179,132,138,126,35,121,32,5,3,True,0.21634106033868586
2025-01-08 18:58:57,Biru,663,179,tensor(132.8060),tensor(138.1758),150,61,152,60,2,1,True,0.0
2025-01-08 18:58:57,persegiBiru,661,164,136,147,163,99,161,102,2,3,False,0.426627938427495
2025-01-08 18:58:57,persegiBiru,655,181,132,138,178,45,180,40,2,5,True,0.13801891784785292
2025-01-08 18:58:57,persegiBiru,692,191,131,132,185,0,183,1,2,1,True,0.4598548415502314
2025-01-08 18:58:57,persegiBiru,691,199,132,133,99,56,99,51,0,5,True,0.2925185598208396
2025-01-08 18:58:57,Fail to pick,691,199,0,0,0,0,0,0,0,0,False,0
2025-01-08 18:58:58,persegiBiru,717,193,133,134,97,80,101,83,4,3,True,0.18101546307845898
2025-01-08 18:58:58,Biru,717,193,tensor(133.7437),tensor(134.4442),146,66,150,62,4,4,True,0.0
2025-01-08 18:58:58,persegiBiru,703,199,131,130,195,43,192,38,3,5,True,0.2612328515550323
2025-01-08 18:58:58,persegiBiru,692,196,133,133,182,84,183,86,1,2,True,0.3332532636269291
2025-01-08 18:58:58,persegiBiru,704,198,132,129,26,28,21,26,5,2,True,0.3104095619021948
2025-01-08 18:58:58,persegiBiru,664,182,132,132,158,73,155,74,3,1,True,0.30172499806640496
2025-01-08 18:58:58,persegiBiru,667,178,131,129,52,79,52,77,0,2,True,0.26702780855494296
2025-01-08 18:58:58,Fail to pick,667,178,0,0,0,0,0,0,0,0,False,0
2025-01-08 18:58:58,persegiBiru,672,166,133,131,158,71,155,70,3,1,True,0.47061545444217556
2025-01-08 18:58:59,persegiBiru,696,197,129,130,144,44,140,43,4,1,False,0.1948830909511318
2025-01-08 18:58:59,persegiBiru,703,199,130,123,59,62,57,60,2,2,True,0.23943423398924357
2025-01-08 18:58:59,Biru,703,199,tensor(130.5466),tensor(123.9591),144,65,140,62,4,3,True,0.0
2025-01-08 18:58:59,Fail to pick,703,199,0,0,0,0,0,0,0,0,False,0
2025-01-08 18:58:59,persegiBiru,694,196,133,129,80,35,75,30,5,5,False,0.2676440570524471
2025-01-08 18:58:59,Fail to pick,694,196,0,0,0,0,0,0,0,0,False,0
2025-01-08 18:58:59,persegiBiru,696,201,128,128,123,3,124,1,1,2,False,0.34815884874706804
2025-01-08 18:58:59,Fail to pick,696,201,0,0,0,0,0,0,0,0,False,0
2025-01-08 18:58:59,persegiBiru,671,168,134,133,149,16,150,18,1,2,True,0.1911956217167898
2025-01-08 18:58:59,persegiBiru,700,196,135,130,73,47,72,50,1,3,True,0.27357012372424033
2025-01-08 18:58:59,persegiBiru,675,178,135,133,20,8,21,4,1,4,True,0.49617619155341364
2025-01-08 18:59:00,persegiBiru,675,178,136,137,84,93,85,92,1,1,True,0.4470340952582167
2025-01-08 18:59:00,Fail to pick,675,178,0,0,0,0,0,0,0,0,False,0
2025-01-08 18:59:00,persegiBiru,711,207,134,129,41,61,45,60,4,1,True,0.3021256742877233
2025-01-08 18:59:00,Biru,711,207,tensor(134.5786),tensor(129.7860),142,65,138,61,4,4,True,0.0
2025-01-08 18:59:00,persegiBiru,681,176,136,135,77,80,77,81,0,1,True,0.2672944323778671
2025-01-08 18:59:00,persegiBiru,720,205,134,131,191,54,195,54,4,0,False,0.1968525499291372
2025-01-08 18:59:00,persegiBiru,718,199,132,129,13,69,10,66,3,3,True,0.2808764094690416
2025-01-08 18:59:00,Fail to pick,718,199,0,0,0,0,0,0,0,0,False,0
2025-01-08 18:59:00,persegiBiru,680,179,129,133,17,89,20,84,3,5,True,0.26405028663853314
2025-01-08 18:59:00,persegiBiru,697,192,134,131,56,8,53,11,3,3,True,0.22245027603552328
2025-01-08 18:59:00,persegiBiru,696,199,129,126,88,57,84,59,4,2,True,0.15430703880939936
2025-01-08 18:59:00,Fail to pick,696,199,0,0,0,0,0,0,0,0,False,0
